Title,Document Name,Ark Identifier,July,August,September,Total
"Wood (Charles Erskine Scott) and Erskine Wood Family Papers",olpb008woo.xml,80444/xv24292,41,63,57,161
"Stafford (William E.) Archives, Series 1, Sub-Series 3: Documentary Copies of Poems",olpb102sta.xml,80444/xv38864,55,55,30,140
"Ralston Family Collection",olpb142ral.xml,80444/xv22479,38,46,35,119
"Stafford (William E.) Archives, Series 3, Sub-Series 1: General Correspondence",olpb096sta.xml,80444/xv88964,36,30,27,93
"Sheets (Louis Kermit) Collection",olpb006she.xml,80444/xv16773,18,15,53,86
"Albany College (Oregon) Photograph Collection",olpa005alb.xml,80444/xv03429,23,26,19,68
"Nomland (Kemper) Collection",olpb013nom.xml,80444/xv58841,10,22,32,64
"Stafford (William E.) Archives Series 5, Sub-Series 2: Audio Recordings of William Stafford",olpb112sta.xml,80444/xv44949,26,13,24,63
"Poetry Broadside Collection",olpb148bro.xml,80444/xv86520,31,11,17,59
"Ward, Jean M. Collection",olpb160war.xml,80444/xv63909,18,15,21,54
"Stafford (William E.) Archives Series 1, Sub-Series 5: Writings for Public Readings and Workshops",olpb115sta.xml,80444/xv45950,13,20,20,53
"YMCA (Portland, OR) Archives",olpb048ymc.xml,80444/xv26528,13,19,16,48
"Young Women's Christian Association (YWCA) of Portland, Oregon Papers",olpb009ywc.xml,80444/xv57126,10,19,17,46
"Stafford (William E.) Archives",olpb037sta.xml,80444/xv83782,10,23,12,45
"Stafford (William E.) Archives, Series 1, Sub-Series 1: Daily Writing Drafts",olpb103sta.xml,80444/xv29632,19,19,6,44
"Sleeth Family Collection",olpb047sle.xml,80444/xv41986,21,15,6,42
"Pascal, Ernest screenplay",olpb010lew.xml,80444/xv89956,9,4,26,39
"Paper Crane Press Collection",olpb131pap.xml,80444/xv13198,17,8,12,37
"Stafford (William E.) Archives Series 8, Sub-Series 5: Translations of Stafford",olpb116sta.xml,80444/xv83508,17,6,14,37
"Thayer (Lewis and Rachel) Collection",olpb133tha.xml,80444/xv87728,12,18,7,37
"Johnson (Kenneth E.) Collection",olpb032joh.xml,80444/xv55599,11,19,7,37
"Coues-Anderson Manuscript",olpb017cou.xml,80444/xv15064,10,12,12,34
"Blocher (Henry and Mary) Collection",olpb016blo.xml,80444/xv61234,3,13,17,33
"Stafford (William E.) Archives, Series 4, Sub-Series 2: Prints of Photographs by William Stafford",olpb099sta.xml,80444/xv15338,16,9,7,32
"Rutsala, (Vern) Papers",olpb002rut.xml,80444/xv05139,9,7,14,30
"Nazi Germany Propaganda Collection",olpb089naz.xml,80444/xv71340,9,8,10,27
"Stafford (William E.) Archives Series 5, Sub-Series 3: Musical Settings to William Stafford Poetry",olpb113sta.xml,80444/xv87835,11,7,9,27
"Stafford (William E.) Archives Series 8, Sub-Series 1: Books by Stafford in English",olpb097sta.xml,80444/xv69702,13,11,2,26
"Civilian Public Service Camp Newsletter Collection",olpb020cps.xml,80444/xv13354,4,5,17,26
"Oregon Ephemera Collection",olpb090ore.xml,80444/xv05252,7,7,10,24
"Stafford (William E.) Archives, Series 1, Sub-Series 4: Prose Drafts",olpb104sta.xml,80444/xv96258,9,8,7,24
"Marlantes (Karl) Papers",olpb094mar.xml,80444/xv53240,0,7,17,24
"Thompson (Dr. Mary) Diary",olpb003tho.xml,80444/xv39681,8,5,8,21
"Stafford (William E.) Archives, Series 4, Sub-Series 3: Stafford Family Photographs",olpb100sta.xml,80444/xv18041,9,6,6,21
"Impossibilists Publications Collection",olpb030imp.xml,80444/xv53915,14,3,3,20
"Stafford (William E.) Archives Series 3, Sub-Series 3: Civilian Public Service Correspondence",olpb121sta.xml,80444/xv27371,6,5,9,20
"Stafford (William E.) Archives, Series 4, Sub-Series 4: Photographs of William Stafford",olpb101sta.xml,80444/xv24951,9,7,4,20
"Stafford (William E.) Archives Series 2, Sub-Series 2: Promotional Materials and Conference Programs",olpb129sta.xml,80444/xv72360,10,6,4,20
"Allen (Hubert Allison) Collection",olpb060all.xml,80444/xv07052,1,15,4,20
"White (Bill) Lewis and Clark Expedition Bicentennial Collection&gt;",olpb056whi.xml,80444/xv57653,8,8,3,19
"Stafford (Dorothy) Memorabilia Collection",olpb036sta.xml,80444/xv55044,8,6,5,19
"Greene (Clarence Wilson) Administrative Records of Albany College",olpa072gre.xml,80444/xv00881,12,7,0,19
"Odell, Morgan S. Personal Papers",olpb023ode.xml,80444/xv09940,8,5,6,19
"Stafford (William E.) Archives Series 3, Sub-Series 4: Manuscripts Sent to William Stafford by Other Authors",olpb138sta.xml,80444/xv61788,16,2,1,19
"Wilkinson (Alexander Malcolm) Family Bible&gt;",olpb149wil.xml,80444/xv84631,5,8,5,18
"Reeves (Bruce) Collection",olpb028ree.xml,80444/xv47308,5,7,6,18
"Baker (Don) Papers",olpb026bak.xml,80444/xv69021,4,6,6,16
"Stafford (William E.) Archives Series 3, Sub-Series 2: Correspondence with Publishers",olpb098sta.xml,80444/xv51730,6,2,8,16
"Stafford (William E.) Archives Series 5, Sub-Series 1: Video Footage of William Stafford",olpb111sta.xml,80444/xv42868,7,7,2,16
"Bibb (Thomas William) Administrative Records of Albany College",olpa082bib.xml,80444/xv61245,9,6,0,15
"Stafford (William E.) Archives Series 6, Sub-Series 2: Teaching Notecards",olpb118sta.xml,80444/xv19683,3,8,4,15
"Stafford (William E.) Archives Series 9, Sub-Series 1: Pacifism Publications",olpb122sta.xml,80444/xv46139,6,3,6,15
"Swan, James G. Correspondence",olpb022par.xml,80444/xv66027,10,4,1,15
"Stafford (William E.) Archives Series 1, Sub-Series 6: Stafford's Translations of Other Authors",olpb109sta.xml,80444/xv88116,3,6,5,14
"Anderson (Irving) papers",olpb001and.xml,80444/xv72514,2,6,6,14
"Stafford (William E.) Archives Series 6, Sub-Series 1: Syllabi and Handouts",olpb117sta.xml,80444/xv11172,3,6,5,14
"Hamady (Walter) Collection",olpb130ham.xml,80444/xv42379,4,7,3,14
"Prentiss (Arthur M.) collection",olpb050pre.xml,80444/xv21377,4,3,6,13
"Kovalenko (Eugene Nicholas) Papers",olpa011kov.xml,80444/xv17800,8,1,4,13
"Stafford (William E.) Archives Series 10, Sub-Series 1: Biographical Clippings",olpb126sta.xml,80444/xv18905,8,1,4,13
"Stafford (William E.) Archives Series 10, Sub-Series 2: General Biographical",olpb127sta.xml,80444/xv59829,12,0,1,13
"Dunn (Katherine) Collection",olpb033dun.xml,80444/xv17681,3,7,3,13
"Stafford (William E.) Archives Series 8, Sub-Series 2: Books with contributions by Stafford",olpb107sta.xml,80444/xv56744,9,0,3,12
"Lewis and Clark Expedition Government Documents Collection",olpb146lcd.xml,80444/xv31716,8,1,3,12
"Gale (Vi) papers",olpb034gal.xml,80444/xv57040,3,6,3,12
"McCabe (Francis R.) Oregon Wild Flower Notebook&gt;",olpb074mcc.xml,80444/xv02145,6,5,1,12
"Jefferson's Western Explorations Editorial Files",olpb063jef.xml,80444/xv56863,3,4,5,12
"Condit (Elbert Neal) Administrative Records of Albany College",olpa067con.xml,80444/xv73208,3,5,4,12
"Montague (Martha Frances) Scrapbooks",olpa144mon.xml,80444/xv70193,10,2,0,12
"Thaxter (Benjamin A.) Administrative Records of Albany College",olpa092tha.xml,80444/xv55004,9,2,0,11
"Dickens (Charles) Collection",olpb136dic.xml,80444/xv53854,4,3,4,11
"Stafford (William E.) Archives, Series 1, Sub-Series 2: Travel Journals",olpb105sta.xml,80444/xv92858,5,3,3,11
"Lewis & Clark College Special Collections Publications Collection",olpb043ber.xml,80444/xv18945,4,3,4,11
"TTTD Video Productions Collection of Vince Wixon and Mike Markee",olpb021wix.xml,80444/xv48923,1,9,1,11
"Stafford (William E.) Archives Series 8, Sub-Series 3: Periodicals with contributions by Stafford in English",olpb108sta.xml,80444/xv60607,7,3,1,11
"Merchant (Paul) Collection",olpb042mer.xml,80444/xv59060,2,4,5,11
"Markham (Edwin) Collection",olpb018mar.xml,80444/xv47896,9,1,1,11
"Stafford (William E.) Archives Series 8, Sub-Series 6: Criticism of Stafford's Writings",olpb124sta.xml,80444/xv61160,6,2,3,11
"Stafford (William E.) Archives, Series 4, Sub-Series 1: Negatives of Photographs by William Stafford",olpb106sta.xml,80444/xv21301,4,2,4,10
"Mitchell v. U.S. court records",olpb024mit.xml,80444/xv85177,4,2,4,10
"Department of Justice File on Dr. Marie D. Equi",olpb004equ.xml,80444/xv37971,2,4,4,10
"Coffield (Glen) Collection",olpb132cof.xml,80444/xv29583,4,3,3,10
"Watzek (Aubrey R.) Collection",olpb058wat.xml,80444/xv91815,0,4,6,10
"Pallack (Ken) Collection of Karl Marlantes Materials",olpb053pal.xml,80444/xv97439,5,0,4,9
"Gilkey (Gordon) Print Collection",olpb095gil.xml,80444/xv17922,4,3,2,9
"McMillan (John) Diaries",olpb073mcm.xml,80444/xv99044,2,2,5,9
"Diaries of Marion Harriet Crable Bennett and Marion Hope Bennett",olpb049ben.xml,80444/xv07089,6,3,0,9
"Crooks (Harry Means) Administrative Records of Albany College",olpa069cro.xml,80444/xv32940,3,5,1,9
"Japanese American Photo Album",olpb143iss.xml,80444/xv52423,3,2,3,8
"History of the Book: Leaf Collection",olpb075lea.xml,80444/xv36483,4,0,4,8
"Swan (James G.) Collection",olpb153swa.xml,80444/xv35336,5,2,1,8
"International Whaling Commission: Patricia Forkan Collection",olpc051iwc.xml,80444/xv65133,3,1,4,8
"Esta, (Albert Joseph) Collection",olpb025est.xml,80444/xv72524,0,4,4,8
"Emmons (Della Gould) Collection",olpb088emm.xml,80444/xv32275,1,4,3,8
"Montieth (William J.) Administrative Records of Albany College",olpa065mon.xml,80444/xv41415,1,6,1,8
"Olin (Bertel J.) Collection",olpb150oli.xml,80444/xv11553,6,1,1,8
"Lee (Wallace Howe) Administrative Records of Albany College",olpa068lee.xml,80444/xv95123,5,3,0,8
"Stafford (William E.) Archives Series 7, Sub-Series 1: Artifacts Owned by Stafford",olpb119sta.xml,80444/xv89321,4,0,4,8
"Five Seasons Press Collection",olpb085fiv.xml,80444/xv60458,3,3,2,8
"Hart (Edna Ruddick) Correspondence",olpb015har.xml,80444/xv28405,6,0,1,7
"Literature of the Lewis and Clark Expedition (Editorial Files)",olpb064lit.xml,80444/xv86502,1,0,6,7
"Pacific Northwest Postcard Collection",olpb062pos.xml,80444/xv51669,4,0,3,7
"Stafford (William E.) Archives Series 3, Sub-Series 5: Condolence Letters",olpb145sta.xml,80444/xv07644,4,2,1,7
"Petersen (Paulann) Collection",olpb147pet.xml,80444/xv72406,1,2,4,7
"Stafford (William E.) Archives Series 2, Sub-Series 1: Appointment Books",olpb110sta.xml,80444/xv45779,3,3,1,7
"Phelps (J.C.) Collection",olpb157jcp.xml,80444/xv76974,3,2,2,7
"Stafford (William E.) Archives Series 9, Sub-Series 2: Civilian Public Service Subject Files",olpb123sta.xml,80444/xv66592,1,5,1,7
"Oregon Poetic Voices Project Archives",olpb141opv.xml,80444/xv46066,1,6,0,7
"Wallace (Charles Lewis) Collection",olpb081wal.xml,80444/xv61041,2,2,3,7
"Skarsten (M. O.) Publication Files for George Drouillard",olpb012ska.xml,80444/xv50629,2,2,3,7
"Civilian Public Service Camp 56 Oral History Project Records",olpb045usf.xml,80444/xv16964,1,1,4,6
"Stafford (William E.) Archives Series 8, Sub-Series 4: Broadsides Featuring Stafford",olpb120sta.xml,80444/xv36929,3,2,1,6
"Wood (Charles Erskine Scott) Sketchbook",olpb057woo.xml,80444/xv82659,1,2,3,6
"Faulconer (Tracy) Collection",olpb044fau.xml,80444/xv85974,0,0,6,6
"Erodelphian Society Collection",olpa079ero.xml,80444/xv32748,0,2,4,6
"Adair (Benjamin) Account Book",olpb046ada.xml,80444/xv67312,1,0,4,5
"Sempert (Dean A.) Collection",olpa135sem.xml,80444/xv04525,0,2,3,5
"Lampman (Ben Hur) Collection",olpb061lam.xml,80444/xv85870,4,1,0,5
"Glarum, (L. Stanley) Archives",olpb052gla.xml,80444/xv23992,0,2,3,5
"Rougemont Press Collection",olpb086rou.xml,80444/xv23440,5,0,0,5
"Stoner (Elva E.) Herbarium",olpb151sto.xml,80444/xv57196,5,0,0,5
"Deale (Henry Vail) Papers",olpb007dea.xml,80444/xv91326,2,2,1,5
"Northwest Conference Archives",olpb038nwc.xml,80444/xv50854,0,5,0,5
"Pacific Northwest Political Science Association Collection",olpb039psa.xml,80444/xv32345,3,1,1,5
"Kuan, Fan/Guo Xi Hanging Scrolls",olpb162fan.xml,80444/xv26327,0,1,4,5
"Langley Harvey (Manche) Collection",olpb019lan.xml,80444/xv80730,0,1,3,4
"Davis, Charles E. Collection",olpb161dav.xml,80444/xv61386,2,0,2,4
"Wilson (Fred O.) Collection",olpa134wil.xml,80444/xv47915,0,3,1,4
"Chuinard (Eldon) Publication Files for Only One Man Died",olpb014chu.xml,80444/xv91670,0,2,2,4
"Amish Diaries Collection",olpb163ami.xml,80444/xv81225,0,0,4,4
"U.S. Intelligence on the Philippines Collection",olpb154phi.xml,80444/xv61602,0,0,4,4
"Albany College Bookplate Collection",olpa139alb.xml,80444/xv60638,0,0,3,3
"Linn County, Oregon Postcard Collection",olpb158lin.xml,80444/xv13317,3,0,0,3
"Albany College (Oregon) Yearbook Collection",olpa083alb.xml,80444/xv62860,2,0,1,3
"Stafford (William E.) Archives Series 11: Stafford Archives Administrative Files",olpb128sta.xml,80444/xv82003,0,0,3,3
"Baker (Raymond J.) Administrative Records of Albany College",olpa071bak.xml,80444/xv74334,0,3,0,3
"Spokane, Washington Herbarium",olpb152spo.xml,80444/xv04763,2,1,0,3
"Lewis & Clark College Yearbook Collection",olpa084lew.xml,80444/xv69281,2,0,1,3
"Linn (Lewis F.) Letter",olpb059lin.xml,80444/xv61013,0,2,1,3
"Halladay School of Flying Photograph Collection",olpb158hal.xml,80444/xv71932,0,2,1,3
"Miller (O. K.) Correspondence",olpb040mil.xml,80444/xv64086,0,0,2,2
"Hugo (Richard) Collection",olpb140hug.xml,80444/xv24136,0,0,2,2
"Crescent City, California Logging and Mining Photography Collection",olpb054cre.xml,80444/xv66842,2,0,0,2
"Nineteenth Century Political Photograph Collection",olpb155nin.xml,80444/xv15167,0,0,1,1
"Family Farm and Church Account Ledger",olpb041fam.xml,80444/xv68151,0,0,1,1
"Albany College Literary Society Collection",olpa077alb.xml,80444/xv57287,0,0,1,1
"Ramsey (Jarold) Collection",olpb137ram.xml,80444/xv34768,0,0,1,1
"Stafford (William E.) Archives Series 8, Sub-Series 7: One-of-a-Kind Art Books",olpb125sta.xml,80444/xv61074,0,0,1,1
"Williams (Alfred M.) Administrative Records of Albany College",olpa070wil.xml,80444/xv26724,0,0,1,1
"Hampton-Gray (Elisabeth) Collection",olpa091gra.xml,80444/xv08407,1,0,0,1
"Arion Literary Society Collection",olpa078ari.xml,80444/xv71575,0,0,1,1
"Hughes (Ted) Correspondence to Donya Feuer",olpb093hug.xml,80444/xv50601,0,0,1,1
"Rogue River Canyon Lantern Slide Collection",olpb055rog.xml,80444/xv58480,0,0,0,0
"Greetings from Oregon Photograph Collection",olpb159gre.xml,80444/xv66787,0,0,0,0
"Stafford (William E.) Archives Series 5, Sub-Series 4: Audio Recordings of Others Reading Stafford's Poems Poetry",olpb114sta.xml,80444/xv21585,0,0,0,0
"Unknown",olpb038nwc.xml.deleted,80444/xv41888,0,0,0,0
"Wendlick Collection of Portland (Ore.) Photographs",olpb031por.xml,80444/xv01528,0,0,0,0
"Geary (Edward R.) Administrative Records of Albany College",olpa066gea.xml,80444/xv37771,0,0,0,0
"Hesperian Society Collection",olpa080hes.xml,80444/xv94711,0,0,0,0
"Early Oregon Ephemera Collection",olpb076ore.xml,80444/xv62789,0,0,0,0
"Danforth Associate Program Northwest Region Records",olpb027dan.xml,80444/xv38427,0,0,0,0
,,Totals,975,889,906,2770
