Title,Document Name,Ark Identifier,July,August,September,Total
"Hansen (Anne Schmidt) Oral History Interview",opvt251.xml,80444/xv64641,72,92,52,216
"Hansen (Hans Peter) Oral History Interview",opvt051.xml,80444/xv09920,69,89,39,197
"Rasmussen (Martin) Oral History Interview",opvt098-099.xml,80444/xv57800,78,62,36,176
"Rygmyr (Odlaug Hasløy) Oral History Interview",opvt002.xml,80444/xv63614,14,12,120,146
"Tynes (Jens) Oral History Interview",opvt263.xml,80444/xv25311,19,27,87,133
"Foss (Hjarne) Oral History Interview",opvt194.xml,80444/xv52329,26,34,64,124
"Tveter (Hans Jacobsen) Oral History Interview",opvt054.xml,80444/xv08210,43,46,34,123
"Blindheim (Ole Andreas Rasmussen) Oral History Interview",opvt236-237.xml,80444/xv36596,40,48,31,119
"Olsen (Hilda Maria) Oral History Interview",opvt018.xml,80444/xv22575,38,50,23,111
"Ekrem (Anna Georgina Hansen) Oral History Interview",opvt140-141.xml,80444/xv09236,23,50,29,102
"Andersen (Sigrid Marie) Oral History Interview",opvt003.xml,80444/xv96446,34,37,23,94
"Erickson (Selma Inez) Oral History Interview",opvt035-036.xml,80444/xv16076,31,30,30,91
"Gilje (Bertel Pedersen) Oral History Interview",opvt181.xml,80444/xv25995,23,42,19,84
"Storm (Anne Kristine Olsen) Oral History Interview",opvt163.xml,80444/xv66693,26,28,25,79
"Nygaard (Lars Thomas) Oral History Interview",opvt158.xml,80444/xv68403,31,30,18,79
"Johnson, Andrew (Anders Johansson) Oral History Interview",opvt206-207.xml,80444/xv82083,29,30,19,78
"Apalseth (Ida Pauline) Oral History Interview",opvt182.xml,80444/xv58828,29,26,22,77
"Anderson (Inga Karolina Olivia Jensdatter Hole) Oral History Interview",opvt052.xml,80444/xv42752,26,22,29,77
"Riebe (Dagmar Elisabeth Lorentsen) Oral History Interview",opvt118.xml,80444/xv17103,26,26,24,76
"Tobiason (Anna Mykelbust) Oral History Interview",opvt116-117.xml,80444/xv84477,26,16,33,75
"Lovestrand, Astrid Maria Rehn Oral History Interview",opvt254.xml,80444/xv62932,24,14,36,74
"Johnson, Bertil Edward Oral History Interview",opvt043.xml,80444/xv80372,31,26,16,73
"Hopen (Anna Malena) Oral History Interview",opvt113.xml,80444/xv86186,25,15,32,72
"Lina Dahl (Stakset) Oral History Interview",opvt106.xml,80444/xv89265,27,24,20,71
"Isaksen (Olive Margrethe Torgerson) Oral History",opvt027.xml,80444/xv85160,26,20,24,70
"Ohrt (Sigfrid Eidsness) Oral History Interview",opvt258.xml,80444/xv94395,28,18,24,70
"Fet (Peter Laurits) Oral History Interview",opvt264.xml,80444/xv58143,24,29,15,68
"Stuen (Agnes Christine Theodora Hougen) Oral History Interview",opvt034-042.xml,80444/xv83450,23,23,22,68
"Madsen (Frederik Christensen) Oral History Interview",opvt196-197.xml,80444/xv85503,25,26,16,67
"Akre (Elvin Martin) Oral History Interview",opvt044.xml,80444/xv12998,26,20,21,67
"Varney (Emma Mehus) Oral History Interview",opvt059.xml,80444/xv39332,22,21,23,66
"Haug (Olga Karoline Nilsen) Oral History",opvt200.xml,80444/xv50961,25,22,18,65
"Strom (Ralph) Oral History Interview",opvt167.xml,80444/xv98157,20,22,22,64
"Laursen (Anna Johanna Kristina ) Oral History Interview",opvt010.xml,80444/xv25652,22,20,21,63
"Fahl (Hans Johan Fredrik) Oral History Interview Interview",opvt253.xml,80444/xv30099,26,21,16,63
"Peterson (Hans Marius) Oral History Interview",opvt151.xml,80444/xv71823,24,18,21,63
"Nelson (John Edwin) Oral History Interview",opvt067.xml,80444/xv36255,28,19,16,63
"Nielsen (Einer ) Oral History Interview",opvt189.xml,80444/xv88581,27,18,18,63
"Berg, Carl Albin Oral History Interview",opvt171.xml,80444/xv29073,23,22,17,62
"Knudsen (Johanne) Oral History Interview",opvt201.xml,80444/xv83793,21,18,23,62
"Nilsen (Esther Alfrida Lund) Oral History Interview",opvt133.xml,80444/xv12315,26,21,14,61
"Magnusson (Jon and Gudrun) Oral History Interview",opvt202.xml,80444/xv16419,27,16,17,60
"Mork (Ola Martinus) Oral History Interview",opvt282.xml,80444/xv50276,26,16,18,60
"Lillelien (Thor) Oral History Interview",opvt252.xml,80444/xv97473,27,20,13,60
"Aamot (Sigurda Haug) Oral History Interview",opvt078.xml,80444/xv33176,26,17,16,59
"Johnson (Anna Elvira Granlund) Oral History Interview",opvt104.xml,80444/xv23601,22,21,16,59
"Astrid Aase (Astrid Aase) Oral History Interview",opvt260.xml,80444/xv59853,18,19,22,59
"Johnson, Ellen Katarina Eriksson Oral History Interview",opvt025.xml,80444/xv19496,23,21,15,59
"Sortland (Svanhild Johanne Knutsen) Oral History Interview",opvt126.xml,80444/xv81399,18,23,18,59
"Borresen (Wilhelmina Strom) Oral History Interview",opvt220.xml,80444/xv77295,21,19,18,58
"DeRosa (Bergliot Moxness Oliver) Oral History Interview",opvt102-103.xml,80444/xv90974,21,20,17,58
"Sivertson (Olaf) Oral History Interview",opvt063-069.xml,80444/xv37964,26,16,16,58
"Loe (Otto Calvin) Oral History",opvt154.xml,80444/xv70113,23,16,18,57
"Ramstad (Anders William) Oral History Interview",opvt047.xml,80444/xv11288,21,15,21,57
"Foss (Laura Madsen Christianson) Oral History Interview",opvt193.xml,80444/xv19497,22,18,16,56
"Løvoll (Alf Lowell) Oral History Interview",opvt259.xml,80444/xv27020,18,19,19,56
"St. Paul Lutheran Church, Cut Bank, Montana, Records",opvelca7a3_78.xml,80444/xv50308,9,23,24,56
"Hansen (Sylvia Rasmussen) Oral History Interview",opvt248.xml,80444/xv99183,24,14,18,56
"Dahl (Louise (Malla) Amilia Sinland) Oral History Interview",opvt041.xml,80444/xv47540,18,22,16,56
"Larson, Hildur Johansson Oral History Interview",opvt019.xml,80444/xv55406,20,16,20,56
"Langvard (Andreas (Andy) Olia) Oral History Interview",opvt144-145.xml,80444/xv07527,23,17,16,56
"Fredrickson, Sven Fredrick Oral History Interview",opvt119.xml,80444/xv49936,22,16,17,55
"Johnson (Margit Carlsen) Oral History Interview",opvt149.xml,80444/xv05817,17,20,18,55
"Norberg (Jonas Walfred) Oral History Interview",opvt088.xml,80444/xv28388,22,17,16,55
"Nelson (Amanda) Oral History Interview",opvt011.xml,80444/xv58827,21,21,13,55
"Fredrickson (Hans) Oral History Interview",opvt092-093.xml,80444/xv26678,25,17,13,55
"Nelson (Hilma Marie Jacobson) Oral History Interview",opvt233.xml,80444/xv37965,19,13,23,55
"Halseth (Otto Hjalmer) Oral History",opvt120-121.xml,80444/xv82767,22,17,15,54
"Larsen (Clara Beck) Oral History Interview",opvt278.xml,80444/xv51646,22,16,16,54
"Otheim (Olav) Oral History Interview",opvt247.xml,80444/xv66009,27,12,15,54
"Kneeland (Signe Andrea Anderson) Oral History Interview",opvt210.xml,80444/xv47541,20,18,16,54
"Andersen (Alfred Valdemar)Oral History Interview",opvt159.xml,80444/xv01029,21,19,14,54
"Lien (Carl Hans Malus Carlson) Oral History Interview",opvt150.xml,80444/xv38649,22,16,16,54
"Johannsson (Aleph Thorwaldson) Oral History Interview",opvt191.xml,80444/xv54040,24,15,15,54
"Silver (Lena (Oleana) Snartemo) Oral History Interview",opvt244-245.xml,80444/xv33177,26,13,15,54
"Dyrhaug (Agnes Johanna) Oral History Interview",opvt180.xml,80444/xv93369,19,17,18,54
"Heikkala (Eric) Oral History Interview",opvt085.xml,80444/xv62931,18,15,21,54
"Fredricksen (Sam (SÃ¸ren Kristian)) Oral History Interview",opvt218.xml,80444/xv11631,17,17,19,53
"Pederson (Therese Louise Jancen) Oral History Interview",opvt165.xml,80444/xv32493,27,12,14,53
"Alm, (Ivar Gottrid) Oral History Interview",opvt076.xml,80444/xv00344,26,15,12,53
"Malmin (Gunnar Johannes) Oral History Interview",opvt038.xml,80444/xv82082,15,23,15,53
"Nerland (Einar Magnus) Oral History Interview",opvt186.xml,80444/xv90291,21,16,16,53
"Sather (Gunhild Alvhilda Kvingedal) Oral History Interview",opvt190.xml,80444/xv21207,21,13,19,53
"Vanderbilt (Sara Nilsen) Oral History",opvt115.xml,80444/xv51645,22,15,16,53
"Tollefson (Julius Sjønning) Oral History Interview",opvt049-050.xml,80444/xv77294,18,17,18,53
"Haugen (Anna Aunli Lee) Oral History Interview",opvt240-241.xml,80444/xv34887,21,18,14,53
"Holmes (Elias Kristofferson Veholmen) Oral History Interview",opvt152.xml,80444/xv04448,19,19,15,53
"Hopen (Anton Magnus) Oral History Interview",opvt114.xml,80444/xv18813,18,18,16,52
"Hale (Henny Pauline Marie Johannessen) Oral History Interview",opvt146.xml,80444/xv40360,18,19,15,52
"Kofoed (Thorvald Andreas) Oral History Interview",opvt243.xml,80444/xv00345,22,17,13,52
"Flones (Edward) Oral History Interview",opvt109.xml,80444/xv54723,17,17,18,52
"Häggström, Nels Oral History Interview",opvt071.xml,80444/xv01712,15,22,15,52
"Halvorsen (Sverre) Oral History Interview",opvt188.xml,80444/xv55749,26,14,12,52
"Nilsen (Martha Dagsvik) Oral History Interview",opvt232.xml,80444/xv05133,17,13,21,51
"Mjøen (Knute John) Oral History Interview",opvt110.xml,80444/xv87555,22,13,16,51
"Haram (Henry) Oral History Interview",opvt268.xml,80444/xv56434,18,19,14,51
"Kjersem (Ole Johnson) Oral History",opvt269.xml,80444/xv89266,20,14,17,51
"Tjugum (Andrew (Anders) Monsen) Oral History Interview",opvt272.xml,80444/xv87897,14,18,19,51
"Greene (Clara Oleva Josepha Nilsen Heintzelman) Oral History Interview",opvt156.xml,80444/xv35571,16,23,12,51
"Amundsen (Ingrid) Oral History Interview",opvt223.xml,80444/xv08552,15,20,16,51
"Sandback (George Brun) Oral History Interview",opvt155.xml,80444/xv02739,19,16,16,51
"Solvik (Jens) Oral History Interview",opvt215.xml,80444/xv46173,19,14,18,51
"Klakegg (Kristian) Oral History Interview",opvt266-267.xml,80444/xv23602,20,19,12,51
"Eide (Ole Johannes) Oral History Interview",opvt192.xml,80444/xv86871,17,17,17,51
"Saure (Sivert Andreas) Oral History Interview",opvt265.xml,80444/xv90975,18,17,15,50
"Emerson (Christine Slind) Oral History Interview",opvt213.xml,80444/xv80373,19,17,14,50
"Beck (Harold Jarle Beck) Oral History Interview",opvt046.xml,80444/xv78662,18,19,13,50
"Fredricksen (Fredrick) Oral History Interview",opvt169.xml,80444/xv63615,17,15,18,50
"Odmark (Elsie Karlson) Oral History Interview",opvt072-073.xml,80444/xv34544,19,17,14,50
"Larson, Anna Åberg Oral History Interview",opvt026.xml,80444/xv52328,19,18,13,50
"Davidson (Inga Karolina Johanna Brobak) Oral History Interview",opvt127.xml,80444/xv14024,19,18,13,50
"Grytnes (Bersven) Oral History Interview",opvt170.xml,80444/xv96447,14,12,24,50
"Loman, Anna Fisk Beckman Oral History Interview",opvt105.xml,80444/xv56433,19,15,15,49
"Nelson (Ruth Lindberg) Oral History Interview",opvt066.xml,80444/xv03422,21,15,13,49
"Ranney (Freda Ohlsson) Oral History Interview",opvt022-023.xml,80444/xv54039,20,13,16,49
"Gregersen (Inger) Oral History Interview",opvt031.xml,80444/xv50618,18,15,16,49
"Lindhe (Tilla Johanson) Oral History Interview",opvt021.xml,80444/xv20864,19,14,16,49
"Tollefson (Judith) Oral History Interview",opvt053.xml,80444/xv75584,18,12,19,49
"Tranum (Gunnar) Oral History Interview",opvt214.xml,80444/xv13340,20,17,12,49
"Simonseth (Gertrude Sinnes) Oral History Interview",opvt112.xml,80444/xv53013,17,15,17,49
"Petersen (Greta Jensen) Oral History Interview",opvt198-199.xml,80444/xv18128,22,18,9,49
"Olsen (Jonhaga Olea) Oral History Interview",opvt221.xml,80444/xv42753,18,16,15,49
"Strom (Alfred Julius) Oral History Interview",opvt164.xml,80444/xv99866,14,18,16,48
"Anderson (Aletta Josefson) Oral History Interview",opvt004.xml,80444/xv29072,20,16,12,48
"Simonson (Gustav Simon) Oral History Interview",opvt074-075.xml,80444/xv67719,16,16,16,48
"Anderson (Ellen Hoch) Oral History Interview",opvt160.xml,80444/xv33861,16,13,19,48
"Myklebust (Elise) Oral History Interview",opvt262.xml,80444/xv92685,16,15,17,48
"Norwick (Goodman) Oral History Interview",opvt249-250.xml,80444/xv31808,15,17,16,48
"Mork (Helen Nordström) Oral History Interview",opvt281.xml,80444/xv17444,17,18,13,48
"Davidson (Ole Karolius Eide) Oral History",opvt204-205.xml,80444/xv49252,20,14,14,48
"Molund, Elsa Anna Maria Nelsson Oral History Interview",opvt229.xml,80444/xv39675,19,15,14,48
"Breiwick (Thomas Wilhelm Olsen) Oral History Interview",opvt184.xml,80444/xv24285,19,16,13,48
"Kirkemo (Randi Nilsen) Oral History Interview",opvt183.xml,80444/xv91659,16,13,19,48
"Blomquist (Grace Eleanor)Oral History Interview",opvt045.xml,80444/xv45830,20,14,14,48
"Ed (Carl Gustav Edward) Carlson Oral History Interview",opvt096.xml,80444/xv92342,16,16,16,48
"Holmes (Anna Gudrun Hauge) Oral History Interview",opvt153.xml,80444/xv37281,14,21,13,48
"Enwall (Ogie (Aage) Enevoldsen) Oral History Interview",opvt055.xml,80444/xv41043,17,17,14,48
"Sortland (Erling Arthur) Oral History Interview",opvt124-125.xml,80444/xv48225,20,14,14,48
"Krokenes (Magdalena Haug) Oral History Interview",opvt234.xml,80444/xv70797,16,17,15,48
"Oliver (Kole Skaflestad) Oral History Interview",opvt227-228.xml,80444/xv06843,15,13,19,47
"Underle (Magdalene Førland) Oral History Interview",opvt062.xml,80444/xv05132,14,13,20,47
"Garberg (Peder) Oral History Interview",opvt277.xml,80444/xv18814,16,17,14,47
"Berg (Emmy Erickson) Oral History Interview",opvt172.xml,80444/xv61905,19,15,13,47
"Krag (Dagny Fredbjørg Frantzen) Oral History Interview",opvt137.xml,80444/xv10605,14,19,14,47
"Molund (Erik Wilhelm) Oral History Interview",opvt230-231.xml,80444/xv72508,17,14,16,47
"Mattson (Matt Andreas WÃ¦sbotten) Oral History Interview",opvt142.xml,80444/xv42069,19,13,15,47
"Gulhaugen (Theodore) Oral History Interview",opvt037.xml,80444/xv49251,18,15,14,47
"Steel (Signe Linnea Anderson) Oral History Interview",opvt176.xml,80444/xv95078,19,13,14,46
"Handeland (Martha Tweiten) Oral History Interview",opvt107.xml,80444/xv21891,17,17,12,46
"Farestrand (Gerda) Oral History Interview",opvt179.xml,80444/xv60537,19,13,14,46
"Carlson, Signe Ohberg Oral History Interview",opvt009_t024.xml,80444/xv93026,17,17,12,46
"Goodwin (Else) Oral History Interview",opvt216-217.xml,80444/xv79005,20,14,12,46
"Brattain (Gudrun Kvernplassen) Oral History Interview",opvt221-212.xml,80444/xv09921,15,12,18,45
"Sitka Lutheran Church, Sitka, Alaska, Records",opvelca7a1_18.xml,80444/xv29907,9,10,26,45
"Jorgenson (Jorgen Aadneram) Oral History Interview",opvt187.xml,80444/xv22916,16,14,15,45
"Pearson(Alva Paulina Strandell Anderson) Oral History Interview",opvt097.xml,80444/xv24968,17,15,13,45
"Christenson (Lydia Savolainen) Oral History Interview",opvt177.xml,80444/xv27704,20,14,11,45
"Nilsen (Ingolf Kristian) Oral History Interview",opvt257.xml,80444/xv61221,16,16,13,45
"Whitman (Nannie Lundbeck) Oral History Interview",opvt166.xml,80444/xv65325,18,12,15,45
"Hemmestad (Olga Kristine Brodahl) Oral History",opvt256.xml,80444/xv28389,16,16,12,44
"Johnson (Phiea Petersen Stahl) Oral History Interview",opvt238.xml,80444/xv69429,19,12,13,44
"Lundbeck, Emil Oral History Interview",opvt138.xml,80444/xv43437,16,13,15,44
"Buorklund (Frank Björklund) Oral History Interview",opvt279.xml,80444/xv84478,16,15,13,44
"Simonseth (Nels) Oral History Interview",opvt111.xml,80444/xv20181,19,12,13,44
"Nygaard (Dagny Bergitte Unsgaard) Oral History Interview",opvt008.xml,80444/xv60194,14,18,12,44
"Tweiten (Carl Omundson) Oral History Interview",opvt129-130.xml,80444/xv79689,15,15,14,44
"Davidson (Bertha Østby) Oral History Interview",opvt006.xml,80444/xv94736,17,13,14,44
"Blomelie (Nellie Johanneson) Oral History Interview",opvt005.xml,80444/xv61904,15,14,14,43
"Gjelstad (Thora) Oral History Interview",opvt271.xml,80444/xv55065,14,13,16,43
"Nissen (Ole Andreas) Oral History Interview",opvt135-136.xml,80444/xv77979,15,17,11,43
"Peace Lutheran Church, Astoria, Oregon, Records",opvelca7a4_149.xml,80444/xv46582,21,12,10,43
"Duus (Ella Fjermsted) Oral History Interview",opvt012.xml,80444/xv91658,14,12,17,43
"Thompson (Kjell Øvrebo) Oral History Interview",opvt255.xml,80444/xv95763,16,14,13,43
"Garberg (Brynhild Kjøsnes) Oral History Interview",opvt276.xml,80444/xv86187,16,15,12,43
"Hoset (Ole) Oral History Interview",opvt270.xml,80444/xv22232,15,13,15,43
"Forman (Lempi Suaminen) Oral History Interview",opvt020.xml,80444/xv88238,19,13,11,43
"Carlson, Jennie Josefine Brehm Oral History Interview",opvt222.xml,80444/xv75585,19,13,11,43
"Watney (Helga Pederson) Oral History Interview",opvt030.xml,80444/xv17787,16,12,15,43
"Davidson (Odin Jentoft) Oral History Interview",opvt128.xml,80444/xv46857,18,14,11,43
"Danielsen (Peter Geirhart) Oral History Interview",opvt185.xml,80444/xv57117,15,14,13,42
"Lundbeck, Anna Linnea Beck Oral History Interview",opvt139.xml,80444/xv76611,15,13,14,42
"Larsen (Elias) Oral History Interview",opvt084.xml,80444/xv29756,14,15,13,42
"Nilsen (Arvid Jenloft ) Oral History Interview",opvt134.xml,80444/xv45148,15,12,15,42
"Lovrak (Anna Jørgensdatter Tveiten) Oral History Interview",opvt079.xml,80444/xv66008,17,13,12,42
"Johnsen (Magnild) Oral History Interview",opvt209.xml,80444/xv14709,16,14,12,42
"Sundberg (Mattias) Oral History Interview",opvt168.xml,80444/xv30783,15,14,13,42
"Drage (Turi Mikkelsen) Oral History Interview",opvt226.xml,80444/xv74217,15,14,12,41
"Hjortedal (Osten Johannes) Oral History",opvt273.xml,80444/xv20523,15,13,13,41
"First Immanuel Lutheran Church, Portland, Oregon, Records",opvelca7a4_213.xml,80444/xv20379,10,5,26,41
""Viking" med Officerer og Mandskab Scrapbook",opvsiemss16.xml,80444/xv22750,17,13,11,41
"Simonseth (Nels and Gertrude) Oral History Interview",opvt122.xml,80444/xv15393,16,13,12,41
"Lund (Pearl Husby Carlsson Lund) Oral History Interview",opvt007.xml,80444/xv27363,14,12,14,40
"Opsal (Cato Torvald) Oral History Interview",opvt239.xml,80444/xv02055,14,14,12,40
"Hytmo (Guri Olsdatter) Oral History Interview",opvt001.xml,80444/xv30440,14,15,11,40
"Hjortedal (Gjertine Karia Eriksdatter Storebø) Oral History Interview",opvt274.xml,80444/xv53355,14,13,13,40
"Mattson (Emma Severine) Oral History Interview",opvt143.xml,80444/xv74901,14,13,12,39
"Tomsli (Astrid Jerney Sørene) Oral History Interview",opvt090.xml,80444/xv61220,15,12,12,39
"Tveter (John Howard) Oral History Interview",opvt060.xml,80444/xv72507,14,13,12,39
"Petersen (Olivia Karoline Floathe) Oral History",opvt219.xml,80444/xv44463,14,13,12,39
"Johnson (John Johanneson) Oral History Interview",opvt094-095.xml,80444/xv59510,14,13,12,39
"Storwick (Henny Pederson) Oral History Interview",opvt017.xml,80444/xv89948,14,12,13,39
"Nakkerud (Inga Amanda Treland) Oral History Interview",opvt058.xml,80444/xv06500,14,12,12,38
"Johnson (Thelma Irene Underdal) Oral History Interview",opvt039.xml,80444/xv14708,14,13,11,38
"Johnson (Hilma Ludli) Oral History Interview",opvt023.xml,80444/xv86870,15,12,11,38
"Johnson (Olga MedgÃ¥rd) Oral History",opvt235.xml,80444/xv03765,14,13,11,38
"Langland (Karina Abelson) Oral History Interview",opvt013.xml,80444/xv24284,14,12,12,38
"Ballard First Lutheran Church, Seattle, Washington, Records",opvelca7a5_368.xml,80444/xv12188,7,22,9,38
"Kasen (Sigrid Josephine) Oral History Interview",opvt224.xml,80444/xv41384,14,12,11,37
"Salvon (Hilma Tolonen) Oral History Interview",opvt070.xml,80444/xv69086,15,12,8,35
"Melville Lutheran Church, Melville, Montana, Records",opvelca7a3_116.xml,80444/xv16891,9,13,13,35
"Foss Family Collection",opvelca2_10.xml,80444/xv79359,9,15,11,35
"Brevig Memorial Lutheran Church, Brevig Mission, Alaska, Records",opvelca7a1_7.xml,80444/xv70956,9,13,13,35
"Colton Lutheran Church, Colton, Oregon, Records",opvelca7a4_165.xml,80444/xv64736,16,5,12,33
"Immanuel Lutheran Church, Silverton, Oregon, Records",opvelca7a4_239.xml,80444/xv26300,19,6,8,33
"Sippala (Hanna Hekkala) Oral History Interview",opvt087.xml,80444/xv95762,8,13,12,33
"Pedersen (Jenny Larsen) Oral History Interview",opvt147-148.xml,80444/xv73191,17,9,7,33
"Knut Pedersen Haslerud Papers",opvsiemss_34.xml,80444/xv77163,15,9,8,32
"Our Savior's Lutheran Church, Nome, Alaska, Records",opvelca7a1_13.xml,80444/xv80520,6,14,12,32
"Sylliaasen (Bertha Sande) Oral History Interview",opvt242.xml,80444/xv67720,13,12,7,32
"Emanuel Lutheran Church, Ritzville, Washington, Records",opvelca7a5_367.xml,80444/xv01443,17,10,4,31
"Sundvik (Ester Irene ) Oral History Interview",opvt091.xml,80444/xv94052,17,7,7,31
"Hilda Marie Black-- Papers",opvsiemss_23.xml,80444/xv31530,9,17,3,29
"Rinne (Esther Wiirre) Oral History Interview",opvt081.xml,80444/xv31467,8,11,10,29
"Freeborn Lutheran Church, Stanwood, Washington, Records",opvelca7a5_406.xml,80444/xv02935,9,19,0,28
"Bruflot (Arnfinn) Oral History Interview",opvt064-065.xml,80444/xv70796,10,10,7,27
"Ott (Tove Foth Barfod) Oral History Interview",opvt048.xml,80444/xv44120,13,6,8,27
"Michelson (Hilma Kristiina Vanhala) Oral History Interview",opvt016.xml,80444/xv57116,8,9,9,26
"Silverberg (Ina (Aino) Huntos Eriksson) Oral History Interview",opvt083.xml,80444/xv97130,9,9,8,26
"Rinne (Sulo John) Oral History Interview",opvt082.xml,80444/xv64298,8,9,9,26
"Cady (Jack) Papers",opvarch6_6.xml,80444/xv85857,13,7,6,26
"Tollefson Family History",opvsiemss_19.xml,80444/xv74493,3,9,13,25
"Zion Lutheran Church, Medford, Oregon, Records",opvelca7a4_198.xml,80444/xv69354,7,6,11,24
"Wiegman (Eugene) Papers",opvarch2_8.xml,80444/xv88252,12,5,7,24
"Central Lutheran Church, Eugene, Oregon, Records",opvelca7a4_173.xml,80444/xv19876,9,7,7,23
"Trinity Lutheran Church, Gresham, Oregon, Records",opvelca7a4_183.xml,80444/xv88467,13,3,7,23
"Volmer Lutheran Church Church, Dagmar, Montana, Records",opvelca7a3_79.xml,80444/xv37319,2,5,16,23
"Bethany Lutheran Church, Gold Beach, Oregon, Records",opvelca7a4_181.xml,80444/xv37799,7,7,9,23
"Miller (Hilma Laitinen) Oral History Interview",opvt080.xml,80444/xv98840,8,6,8,22
"Glendale Evangelical Lutheran Church, Burien, Washington, Records",opvelca7a5_377.xml,80444/xv83901,1,3,17,21
"Storla Family History",opvsiemss_13.xml,80444/xv75027,7,4,10,21
"Faith Lutheran Church, Bellingham, Washington, Records",opvelca7a5_266.xml,80444/xv23855,4,6,10,20
"Nakkerud (Trygve Bloch) Oral History Interview",opvt057.xml,80444/xv73874,8,6,6,20
"Faith Lutheran Church, Roseburg, Oregon, Records",opvelca7a4_231.xml,80444/xv96249,7,12,0,19
"Eidsvold Lutheran Church, Somers, Montana, Records",opvelca7a3_135.xml,80444/xv95120,9,5,5,19
"Genesee Valley Lutheran Church, Genesee, Idaho, Records",opvelca7a2_35.xml,80444/xv60864,6,12,1,19
"Thornton Lutheran Church, Wales, Alaska, Records",opvelca7a1_22.xml,80444/xv49191,14,2,3,19
"Unknown",opvelca7a5_433.xml,80444/xv92822,12,4,3,19
"Calvary Lutheran Church, Federal Way, Washington, Records",opvelca7a5_298.xml,80444/xv52896,9,2,7,18
"Light of the Cross Lutheran Church, Bothell, Washington, Records",opvelca7a5_270.xml,80444/xv11306,10,6,2,18
"Troy Evangelical Lutheran Church, Troy, Idaho, Records",opvelca7a2_55.xml,80444/xv22833,7,6,5,18
"Hope Lutheran Church, Tacoma, Washington, Records",opvelca7a5_414.xml,80444/xv22686,6,5,7,18
"Edison-Bow Local Histories",opvsiemss_61.xml,80444/xv85610,4,6,8,18
"Central Lutheran Church, Seattle, Washington, Records",opvelca7a5_372.xml,80444/xv36141,14,2,1,17
"Gloria Dei Lutheran Church, Tacoma, Washington, Records",opvelca7a5_413.xml,80444/xv96914,6,5,6,17
"Berggren Family History",opvsiemss_25.xml,80444/xv37103,10,6,1,17
"Trinity Lutheran Church, Parkland, Washington, Records",opvelca7a5_418.xml,80444/xv66091,6,7,3,16
"First Lutheran Church, Astoria, Oregon, Records",opvelca7a4_148.xml,80444/xv37152,7,3,6,16
"Denny Park Lutheran Church, Seattle, Washington, Records",opvelca7a5_373.xml,80444/xv61526,11,2,3,16
"Local Histories: Benton County, Washington (State)",opvnpc1_3.xml,80444/xv13012,15,1,0,16
"Selbu Lutheran Church, La Crosse, Washington, Records",opvelca7a5_321.xml,80444/xv95874,0,7,9,16
"Messiah Lutheran Church, Auburn, Washington, Records",opvelca7a5_257.xml,80444/xv92230,1,6,8,15
"American Lutheran Church, Harlowton, Montana, Records",opvelca7a3_96.xml,80444/xv26855,10,1,4,15
"Celebration Lutheran Church Records",opvelca7a5_254.xml,80444/xv23306,9,2,4,15
"Hope American Lutheran Church, Fallon, Montana, Records",opvelca7a3_84.xml,80444/xv92318,9,2,4,15
"Peace Lutheran Church, Silvana, Washington, Records",opvelca7a5_391.xml,80444/xv02819,7,7,1,15
"Zion Lutheran Church, Kent, Washington, Records",opvelca7a5_316.xml,80444/xv46380,4,5,6,15
"Trinity Lutheran Church, Martinsdale, Montana, Records",opvelca7a3_115.xml,80444/xv43527,3,4,8,15
"Bethany Lutheran Church, Warren, Oregon, Records",opvelca7a4_248.xml,80444/xv47741,5,2,8,15
"Central Lutheran Church, Anchorage, Alaska, Records",opvelca7a1_2-3.xml,80444/xv20318,2,5,8,15
"Zakarius Martin Taftezen Collection",opvsiemss_67.xml,80444/xv81353,8,6,0,14
"Magnolia Lutheran Church, Seattle, Washington, Records",opvelca7a5_381.xml,80444/xv64218,5,4,5,14
"Shishmaref Lutheran Church, Shishmaref, Alaska, Records",opvelca7a1_17.xml,80444/xv01010,7,3,4,14
"Pella Lutheran Church, Sidney, Montana, Records",opvelca7a3_134.xml,80444/xv56161,7,4,3,14
"Emmanuel Lutheran Church, Bremerton, Washington, Records",opvelca7a5_272.xml,80444/xv48092,13,1,0,14
"Sunne Lutheran Church Records",opvelca7_1.xml,80444/xv53028,10,3,1,14
"Sangerfest.Norwegian Singers Association of America. Sangerfest",opvsiemss_40sangerfest.xml,80444/xv20739,10,1,3,14
"Cross of Christ Lutheran Church, Bellevue, Washington, Records",opvelca7a5_260.xml,80444/xv79125,4,7,3,14
"Bethlehem Lutheran Church, Portland, Oregon, Records",opvelca7a4_211.xml,80444/xv45336,5,3,5,13
"Erikson (John and Kristine) Family History",opvsiemss_38.xml,80444/xv78784,11,0,2,13
"Lutheran Church of the Resurrection, Portland, Oregon, Records",opvelca7a4_216.xml,80444/xv85183,9,4,0,13
"Shepherd of the Valley Lutheran Church, Startup, Washington, Records",opvelca7a5_408.xml,80444/xv81774,3,3,7,13
"Christ Lutheran Church, Federal Way, Washington, Records",opvelca7a5_299.xml,80444/xv99340,9,0,4,13
"Ebenezer Lutheran Church, Lake Stevens, Washington, Records",opvelca7a5_323.xml,80444/xv46618,13,0,0,13
"Our Saviour's Lutheran Church, Stanwood, Washington, Records",opvelca7a5_407.xml,80444/xv21636,3,2,8,13
"Shepherd of the Valley Lutheran Church, Boise, Idaho, Records",opvelca7a2_27.xml,80444/xv47753,12,0,1,13
"The Bergström-Ersson Family History",opvsiemss_22.xml,80444/xv26510,6,2,5,13
"Valby Lutheran Church, Ione, Oregon, Records",opvelca7a4_188.xml,80444/xv74993,9,2,2,13
"Edward Emanuel Johnson Collection",opvsiemss_96.xml,80444/xv23117,3,0,9,12
"Emmanuel Lutheran Church, Reardan, Washington, Records",opvelca7a5_361.xml,80444/xv20620,10,2,0,12
"Peace Lutheran Church, Colfax, Washington, Records",opvelca7a5_282.xml,80444/xv20034,7,3,2,12
"Saco Lutheran Church, Saco, Montana, Records",opvelca7a3_129.xml,80444/xv59490,3,3,6,12
"Lord of Life Lutheran Church, North Pole, Alaska, Records",opvelca7a1_14.xml,80444/xv26065,10,2,0,12
"Grace Lutheran Church, Wenatchee, Washington, Records",opvelca7a5_431.xml,80444/xv90106,7,1,4,12
"Atonement Lutheran Church, Newport, Oregon, Records",opvelca7a4_202.xml,80444/xv37072,4,0,8,12
"First Lutheran Church, Miles City, Montana, Records",opvelca7a3_117.xml,80444/xv89523,8,0,4,12
"Faith Lutheran Church, Junction City, Oregon, Records",opvelca7a4_189.xml,80444/xv52801,1,1,10,12
"Fir-Conway Lutheran Church, Mount Vernon, Washington, Records",opvelca7a5_338.xml,80444/xv88528,10,1,1,12
"Galilean Chapel Lutheran Church, Ocean Shores, Washington, Records",opvelca7a5_344.xml,80444/xv35791,9,0,3,12
"HIngham Lutheran Church, Hingham, Montana, Records",opvelca7a3_100.xml,80444/xv30032,7,2,3,12
"Royal Lutheran-United Methodist Joint Ministry Records",opvelca7_2.xml,80444/xv18483,0,2,9,11
"Trinity Lutheran Church, Silverton, Oregon, Records",opvelca7a4_240.xml,80444/xv84130,5,0,6,11
"Trinity Lutheran Church, Lewiston, Idaho, Records",opvelca7a2_42.xml,80444/xv32766,4,5,2,11
"Center for Human Organization (CHOICE), Records",opvarch6_7.xml,80444/xv52341,1,0,10,11
"Salem Lutheran Church, Mount Vernon, Washington, Records",opvelca7a5_340.xml,80444/xv93548,4,4,3,11
"St. Paul Lutheran Church, Fairfield, Montana, Records",opvelca7a3_82.xml,80444/xv10525,6,0,5,11
"Agnus Dei Lutheran Church, Gig Harbor, Washington, Records",opvelca7a5_304.xml,80444/xv21337,6,3,2,11
"Nathanael Lutheran Church, Reserve, Montana, Records",opvelca7a3_125.xml,80444/xv12976,3,3,5,11
"First Lutheran Church, Ketchican, Alaska, Records",opvelca7a1_11.xml,80444/xv33871,1,2,8,11
"Eastvold, Seth C. Papers",opvarchrg2.7.xml,80444/xv36083,0,0,10,10
"Phinney Ridge Lutheran Church, Seattle, Washington, Records",opvelca7a5_384.xml,80444/xv40795,4,3,3,10
"Immanuel Lutheran Church",opvelca7_19.xml,80444/xv16089,0,5,5,10
"Galata Lutheran Church, Galata, Montana, Records",opvelca7a3_85.xml,80444/xv86846,8,1,1,10
"First Lutheran Church, Bothell, Washington, Records",opvelca7a5_269.xml,80444/xv44042,10,0,0,10
"Christ the King Lutheran Church, Tigard, Oregon, Records",opvelca7a4_245.xml,80444/xv89984,8,2,0,10
"First English Lutheran Church, Great Falls, Montana, Records",opvelca7a3_89.xml,80444/xv87667,6,2,2,10
"Redeemer Lutheran Church, Livingston, Montana, Records",opvelca7a3_113.xml,80444/xv62048,3,3,4,10
"Zoar Lutheran Church, Canby, Oregon, Records",opvelca7a4_161.xml,80444/xv17770,3,2,5,10
"Camano Lutheran Church, Camano Island, Washington, Records",opvelca7a5_277.xml,80444/xv70446,5,3,2,10
"First Lutheran Church Records",opvelca7a5_349.xml,80444/xv83853,9,0,1,10
"Christ Lutheran Church, Lakewood, Washington, Records",opvelca7a5_324.xml,80444/xv74926,10,0,0,10
"Our Saviour's Lutheran Church, Cathlamet, Washington, Records",opvelca7a5_279.xml,80444/xv82623,10,0,0,10
"Rydjord (Olaf) Papers",opvsiemss15.xml,80444/xv23059,0,5,5,10
"Holy Spirit Lutheran Church, Kirkland, Washington, Records",opvelca7a5_317.xml,80444/xv30993,1,7,2,10
"First Lutheran Church, Glasgow, Montana, Records",opvelca7a3_86.xml,80444/xv76745,2,2,6,10
"Anderson Bertha (Josephsen) Autobiography",opvsiemss_2.xml,80444/xv07385,6,0,4,10
"Bethany Lutheran Church, Seattle, Washington, Records",opvelca7a5_369.xml,80444/xv49172,5,3,2,10
"Ascension Lutheran Church",opvelca7_11.xml,80444/xv84147,5,4,0,9
"Xavier (Johan Ulrik) Papers",opvarchrg2.4.xml,80444/xv53570,0,8,1,9
"Campus Ministry Records",opvarch1_20.xml,80444/xv11986,2,5,2,9
"First Lutheran Church Records",opvelca7a5_288.xml,80444/xv00323,6,0,3,9
"First Lutheran Church of West Seattle, Seattle, Washington, Records",opvelca7a5_375.xml,80444/xv80471,8,0,1,9
"Muri (Christian J.)Autobiography",opvsiemss_21.xml,80444/xv76052,9,0,0,9
"Central Lutheran Church, Portland, Oregon, Records",opvelca7a4_212.xml,80444/xv96563,5,2,2,9
"Gethsemane Lutheran Church",opvelca7_20.xml,80444/xv91672,4,1,4,9
"Johnson (John August) Papers",opvsiemss_1.xml,80444/xv48921,3,2,4,9
"Peace Lutheran Church, Portland, Oregon, Records",opvelca7a4_220.xml,80444/xv64239,4,0,5,9
"Zion Lutheran Church, Oregon City, Oregon, Records",opvelca7a4_206.xml,80444/xv56008,7,2,0,9
"Elim Lutheran Church, Port Orchard, Washington, Records",opvelca7a5_352.xml,80444/xv18917,8,1,0,9
"St. Peter Lutheran Church, Tillamook, Oregon, Records",opvelca7a4_246.xml,80444/xv60153,1,0,8,9
"Danielson (William N.) Collection",opvsiemss_37.xml,80444/xv69992,7,2,0,9
"Celebration Lutheran Church, Puyallup, Washington, Records",opvelca7a5_358.xml,80444/xv29586,9,0,0,9
"Guide to the Magnar Strand Biography",opvsiemss_5.xml,80444/xv01144,3,2,4,9
"Ascension Lutheran Church, Orofino, Idaho, Records",opvelca7a2_48.xml,80444/xv49969,2,2,5,9
"Brodin Family History",opvsiemss_8.xml,80444/xv78982,3,3,3,9
"Emmanuel Lutheran Church, Tacoma, Washington, Records",opvelca7a5_412.xml,80444/xv76403,0,3,6,9
"St. Luke Lutheran Church, Portland, Oregon, Records",opvelca7a4_225.xml,80444/xv48962,8,1,0,9
"Ascension Lutheran Church, Medford, Oregon, Records",opvelca7a4_197.xml,80444/xv49057,3,5,0,8
"Good Shepherd Lutheran Church, Eugene, Oregon, Records",opvelca7a4_175.xml,80444/xv89822,8,0,0,8
"Saint Paul Lutheran Church, Kodiak, Alaska, Records",opvelca7a1_12.xml,80444/xv32995,1,4,3,8
"Vashon Lutheran Church, Vashon, Washington, Records",opvelca7a5_427.xml,80444/xv33050,1,1,6,8
"Luther Memorial Lutheran Church, Portland, Oregon, Records",opvelca7a4_217.xml,80444/xv65847,1,6,1,8
"Lakeridge Lutheran Church, Seattle, Washington, Records",opvelca7a5_379.xml,80444/xv51794,8,0,0,8
"St. Stephen Lutheran Church, Gladstone, Oregon, Records",opvelca7a4_180.xml,80444/xv14465,8,0,0,8
"Faith Lutheran Church, Leavenworth, Washington, Records",opvelca7a5_325.xml,80444/xv19049,7,0,1,8
"Georg Pederson Papers--the Pederson Saga",opvsiemss_28.xml,80444/xv01446,3,1,4,8
"Jens Fredericksen Svinth Autobiography",opvsiemss_119.xml,80444/xv42266,0,4,4,8
"St. John's Lutheran Church, American Falls, Idaho, Records",opvelca7a2_23.xml,80444/xv36175,4,0,4,8
"Springfield Lutheran Church, Springfield, Oregon, Records",opvelca7a4_242.xml,80444/xv24942,3,5,0,8
"Gold Hill Lutheran Church, Butte, Montana, Records",opvelca7a3_74.xml,80444/xv59661,2,2,4,8
"American Lutheran Church, Turner, Montana, Records",opvelca7a3_138.xml,80444/xv24337,2,0,6,8
"Faith Lutheran Church, Kamiah, Idaho, Records",opvelca7a2_40.xml,80444/xv60000,3,2,3,8
"Baalson Centennial",opvsiemss_17.xml,80444/xv78628,3,0,5,8
"First Lutheran Church, Havre, Montana, Records",opvelca7a3_97.xml,80444/xv22787,1,0,7,8
"Trinity Lutheran Church, Enumclaw, Washington, Records",opvelca7a5_292.xml,80444/xv15158,1,2,5,8
"Hefte Family History",opvsiemss_92.xml,80444/xv78585,1,2,5,8
"Grace Lutheran Church, Corvallis, Oregon, Records",opvelca7a4_169.xml,80444/xv38562,7,0,1,8
"Epiphany Lutheran Church, Valdez, Alaska, Records",opvelca7a1_21.xml,80444/xv38742,7,0,1,8
"Gabriel Aanensen Fedde Autobiography",opvsiemss_127.xml,80444/xv97003,0,2,6,8
"Our Saviour's Lutheran Church, Eugene, Oregon, Records",opvelca7a4_177.xml,80444/xv25109,5,0,3,8
"Bethlehem Lutheran Church, Sedro Wooley, Washington, Records",opvelca7a5_389.xml,80444/xv29553,3,0,4,7
"Grace First Lutheran Church, Bend, Oregon, Records",opvelca7a4_442.xml,80444/xv04833,0,2,5,7
"Cameron Emmanuel Lutheran Church, Kendrick, Idaho, Records",opvelca7a2_41.xml,80444/xv12149,1,1,5,7
"Lemkin (Essay Awards) Collection",opvarch24.8.xml,80444/xv57305,2,3,2,7
"St. John's Lutheran Church, Bellingham, Washington, Records",opvelca7a5_268.xml,80444/xv69110,3,1,3,7
"Gideon Evangelical Lutheran Church, Connell, Washington, Records",opvelca7a5_285.xml,80444/xv87423,7,0,0,7
"St. Luke's American Lutheran Church, Shelby, Montana, Records",opvelca7a3_438.xml,80444/xv89648,1,5,1,7
"Local Histories: Franklin County, Washington (State)",opvnpc1_9.xml,80444/xv29086,7,0,0,7
"Our Redeemer's Lutheran Church, Seattle, Washington, Records",opvelca7a5_383.xml,80444/xv02978,2,2,3,7
"Milwaukie Lutheran Church, Milwaukie, Oregon, Records",opvelca7a4_201.xml,80444/xv16354,0,4,3,7
"Frahm (Frederick) Papers",opvarch6_5.xml,80444/xv31475,3,0,4,7
"Messiah Lutheran Church, Vancouver, Washington, Records",opvelca7a5_424.xml,80444/xv01135,4,0,3,7
"St. Matthew Lutheran Church, Beaverton, Oregon, Records",opvelca7a4_155.xml,80444/xv94973,2,3,2,7
"Trinity Lutheran Church, Lynnwood, Washington, Records",opvelca7a5_331.xml,80444/xv92614,0,0,7,7
"Christ Lutheran Church, Soldotna, Alaska, Records",opvelca7a1_20.xml,80444/xv71081,3,3,1,7
"Pilgrim Lutheran Church Records",opvelca7a5_347.xml,80444/xv90859,6,0,1,7
"Faith Lutheran Church, Albany, Oregon, Records",opvelca7a4_145.xml,80444/xv57662,6,0,1,7
"Columbia College Records",opvarch1_1.xml,80444/xv86884,0,5,2,7
"Lutheran Church of the Master, Pasco, Washington, Records",opvelca7a5_350.xml,80444/xv12014,5,0,2,7
"Messiah Lutheran Church, Red Lodge, Montana, Records",opvelca7a3_439.xml,80444/xv58660,2,5,0,7
"Emanuel Lutheran Church, Cornelius, Oregon, Records",opvelca7a4_168.xml,80444/xv66171,2,1,4,7
"Malta Lutheran Church, Malta, Montana, Records",opvelca7a3_114.xml,80444/xv68368,6,1,0,7
"St. John's Lutheran Church, Great Falls, Montana, Records",opvelca7a3_92.xml,80444/xv77847,7,0,0,7
"Christ the King Lutheran Church, Bozeman, Montana, Records",opvelca7a3_69.xml,80444/xv60470,0,0,7,7
"St. Mark Lutheran Church, Hayden Lake, Idaho, Records",opvelca7a2_36.xml,80444/xv74511,0,0,6,6
"St. Paul Lutheran Church, Ontario, Oregon, Records",opvelca7a4_447.xml,80444/xv43258,1,0,5,6
"Hitler-Jugend, Bildband für die Schulung, records",opvarch6_4_3.xml,80444/xv83806,0,3,3,6
"Guide to the Wilbur Lutheran Church, Wilbur, Washington, Records <date encodinganalog="date" era="ce" calendar="gregorian" normal="1967/2012">1967-2012</date>",opvelca7a5_432.xml,80444/xv90270,0,1,5,6
"Good Shepherd Lutheran Church, Madras, Oregon, Records",opvelca7a4_196.xml,80444/xv71356,3,3,0,6
"West Linn Lutheran Church, West Linn, Oregon, Records",opvelca7a4_249.xml,80444/xv45578,1,4,1,6
"King of Kings Lutheran Church Records",opvelca7_9.xml,80444/xv13698,0,1,5,6
"Our Saviour's Lutheran Church, Box Elder, Montana, Records",opvelca7a3_68.xml,80444/xv77789,5,1,0,6
"Emmanuel Lutheran Church, Shepherd, Montana, Records",opvelca7a3_132.xml,80444/xv53890,4,0,2,6
"King of Glory Lutheran Church, Boise, Idaho, Records",opvelca7a2_25.xml,80444/xv02764,0,0,6,6
"Tree of Life Lutheran Church in Terrace Heights, Yakima, Washington, Records",opvelca7a5_436.xml,80444/xv45431,2,3,1,6
"Northlake Lutheran Church, Kenmore, Washington, Records",opvelca7a5_312.xml,80444/xv48980,5,0,1,6
"Hong, Nils Joseph Records",opvarchrg2.3.xml,80444/xv55987,3,2,1,6
"Holy Trinity Lutheran Church, Ephrata, Washington, Records",opvelca7a5_293.xml,80444/xv64620,0,0,6,6
"Resurrection Lutheran Church, Juneau, Alaska, Records",opvelca7a1_16.xml,80444/xv43881,1,2,3,6
"Browning (Christopher R. Papers)",opvarchrg6.4.2.xml,80444/xv90856,4,0,2,6
"Fir Lawn Lutheran Church, Sweet Home, Oregon, Records",opvelca7a4_244.xml,80444/xv52368,1,0,5,6
"Our Saviour's Lutheran Church, Lebanon, Oregon, Records",opvelca7a4_194.xml,80444/xv27447,3,2,1,6
"Our Redeemer Lutheran Church, Nashua, Montana, Records",opvelca7a3_122.xml,80444/xv60287,0,2,4,6
"Prince of Peace Lutheran Church, Shoreline, Washington, Records",opvelca7a5_386.xml,80444/xv12344,4,0,2,6
"Redeemer Lutheran Church, Boise, Idaho, Records",opvelca7a2_26.xml,80444/xv14611,6,0,0,6
"Calvary Lutheran Church, Grants Pass, Oregon, Records",opvelca7a4_182.xml,80444/xv74032,3,0,3,6
"Zion Lutheran Church, Port Orford, Oregon, Records",opvelca7a4_228.xml,80444/xv57348,1,3,2,6
"First Lutheran Church, Savage, Montana, Records",opvelca7a3_130.xml,80444/xv81921,2,0,4,6
"St. John Lutheran Church, Sprague, Washington, Records",opvelca7a5_405.xml,80444/xv22888,0,0,6,6
"Shepherd of the Valley Lutheran Church, Maple Valley, Washington, Records",opvelca7a5_332.xml,80444/xv42230,6,0,0,6
"Trinity Lutheran Church, McMinnville, Oregon, Records",opvelca7a4_195.xml,80444/xv68353,1,1,4,6
"Devon Lutheran Church, Devon, Montana, Records",opvelca7a3_80.xml,80444/xv76550,4,0,2,6
"Johan Mattson and Family",opvsiemss_14.xml,80444/xv15701,1,1,4,6
"Christ Lutheran Church, Goldendale, Washington, Records",opvelca7a5_452.xml,80444/xv70489,0,0,6,6
"Pacific Lutheran University Honorary Doctorates and Awards Collection",opvarch_26.xml,80444/xv21401,1,2,3,6
"Bethany Lutheran Church, Portland, Oregon, Records",opvelca7a4_209.xml,80444/xv17385,5,0,1,6
"Gloria Dei Lutheran Church, Coos Bay, Oregon, Records",opvelca7a4_166.xml,80444/xv85751,2,0,4,6
"Hope Lutheran Church, Lynden, Washington, Records",opvelca7a5_330.xml,80444/xv92544,4,0,2,6
"First Lutheran Church, Mount Vernon, Washington, Records",opvelca7a5_339.xml,80444/xv38336,5,1,0,6
"Burlington Lutheran Church, Burlington, Washington, Records",opvelca7a5_276.xml,80444/xv21508,2,2,2,6
"First Lutheran Church, South Bend, Washington, Records",opvelca7a5_395.xml,80444/xv56231,3,3,0,6
"Gloria Dei Lutheran Church, Olympia, Washington, Records",opvelca7a5_345.xml,80444/xv26132,2,1,3,6
"American Lutheran Church, Livingston, Montana, Records",opvelca7a3_112.xml,80444/xv86880,3,0,2,5
"Immanuel Lutheran Church, Moses Lake, Washington, Records",opvelca7a5_336.xml,80444/xv85791,4,0,1,5
"American Lutheran Church, Baker, Montana, Records",opvelca7a3_58.xml,80444/xv02960,0,2,3,5
"Christ Lutheran Church, Salem, Oregon, Records",opvelca7a4_232.xml,80444/xv53332,0,2,3,5
"Trinity Lutheran Church, Kirkland, Washington, Records",opvelca7a5_318.xml,80444/xv08615,5,0,0,5
"Grace Lutheran Church, Fairfield, Montana, Records",opvelca7a3_81.xml,80444/xv86840,5,0,0,5
"Zion Lutheran Church, Glendive, Montana, Records",opvelca7a3_87.xml,80444/xv01788,5,0,0,5
"First Lutheran Church, Saint Helens, Oregon, Records",opvelca7a4_243.xml,80444/xv08276,5,0,0,5
"Immanuel Lutheran Church, Absarokee Mont., Records",opvelca7a3_56.xml,80444/xv92916,3,0,2,5
"Local Histories: Adams County, Washington (State)?",opvnpc1_1.xml,80444/xv14724,0,2,3,5
"Immanuel Lutheran Church, Westby, Montana, Records",opvelca7a3_139.xml,80444/xv19787,4,1,0,5
"Atonement Lutheran Church, Beaverton, Oregon, Records",opvelca7a4_152.xml,80444/xv72232,0,1,4,5
"Gethsemane Lutheran Church, Seattle, Washington, Records",opvelca7a5_376.xml,80444/xv54452,5,0,0,5
"Macksburg Lutheran Church, Canby, Oregon, Records",opvelca7a4_160.xml,80444/xv11322,2,0,3,5
"Scandinavian Lutheran Church Records",opvelca7_8.xml,80444/xv81069,4,0,1,5
"St. Mark's Lutheran Church, Portland, Oregon, Records",opvelca7a4_226.xml,80444/xv37905,4,0,1,5
"Peace Lutheran Church",opv7_15.xml,80444/xv85173,0,1,4,5
"Christ the King Lutheran Church, Sumner, Washington, Records",opvelca7a5_409.xml,80444/xv74041,0,0,5,5
"Central Lutheran Church, Spokane, Washington, Records",opvelca7a5_399.xml,80444/xv67971,1,4,0,5
"Our Savior's Lutheran Church, Prineville, Oregon, Records",opvelca7a4_229.xml,80444/xv73263,0,2,3,5
"Gloria Dei Lutheran Church, Lynnwood, Washington, Records",opvelca7a5_252.xml,80444/xv64501,1,2,2,5
"Peace Lutheran Church, Pendleton, Oregon, Records",opvelca7a4_207.xml,80444/xv28344,3,0,2,5
"Local Histories: Clallam County, Washington (State)",opvnpc1_4.xml,80444/xv45843,0,2,3,5
"Emmaus Lutheran Church, Eugene, Oregon, Records",opvelca7a4_174.xml,80444/xv67858,4,1,0,5
"Our Savior Lutheran Church, Issaquah, Washington, Records",opvelca7a5_310.xml,80444/xv25137,2,0,3,5
"Our Savior's Lutheran Church, Chester, Montana, Records",opvelca7a3_75.xml,80444/xv48141,0,3,2,5
"Johnson Family Correspondence",opvsiemss_36.xml,80444/xv42858,5,0,0,5
"First English Lutheran Church, Billings, Montana, Records",opvelca7a3_63.xml,80444/xv30212,0,0,5,5
"New Life Lutheran Church, Florence, Oregon, Records",opvelca7a4_179.xml,80444/xv36114,3,2,0,5
"Grace Lutheran Church, Ryegate, Montana, Records",opvelca7a3_128.xml,80444/xv27593,4,1,0,5
"St. Olaf Lutheran Church, Ledger, Montana, Records",opvelca7a3_110.xml,80444/xv29998,3,0,2,5
"Key Peninsula Lutheran Church, Lakebay, Washington, Records",opvelca7a5_322.xml,80444/xv96325,0,2,3,5
"Thorsteinson Family History",opvsiemss_126.xml,80444/xv10354,3,2,0,5
"Sigdalslaget Album",opvsiemss_10.xml,80444/xv57376,1,2,2,5
"King of Kings Lutheran Church, Milwaukie, Oregon, Records",opvelca7a4_200.xml,80444/xv89093,0,1,4,5
"Spanaway Lutheran Church, Spanaway, Washington, Records",opvelca7a5_397.xml,80444/xv53536,3,0,2,5
"Joy Lutheran Church, Fairbanks, Alaska, Records",opvelca7a1_24.xml,80444/xv10324,5,0,0,5
"Bethlehem Lutheran Church, Spokane, Washington, Records",opvelca7a5_398.xml,80444/xv54626,5,0,0,5
"Dagny Unsgaard Nygaard--Papers",opvsiemss_20.xml,80444/xv32000,0,2,3,5
"Grace Lutheran Church, Sidney, Montana, Records",opvelca7a3_133.xml,80444/xv97668,0,2,3,5
"Jonas Olson Family History",opvsiemss_11.xml,80444/xv71844,0,1,4,5
"St. Mark Lutheran Church, Salem, Oregon, Records",opvelca7a4_237.xml,80444/xv20745,4,0,1,5
"Esther Nelson Berglund Family History",opvsiemss_125.xml,80444/xv16873,3,2,0,5
"Augustana Lutheran Church, Portland, Oregon, Records",opvelca7a4_208.xml,80444/xv30175,0,2,3,5
"Newspaper Clippings Collection",opvsiemss_71.xml,80444/xv93844,5,0,0,5
"Our Saviour's Lutheran Church, Bremerton, Washington, Records",opvelca7a5_274.xml,80444/xv29946,4,1,0,5
"St. Paul Lutheran Church, Ontario, Oregon, Records",opvelca7a4_204.xml,80444/xv75250,0,0,4,4
"Our Saviour's Lutheran Church, Brockton, Montana, Records",opvelca7a3_71.xml,80444/xv10971,0,0,4,4
"Lokensgard Family History",opvsiemss_121.xml,80444/xv97979,2,1,1,4
"First Lutheran Church, Kennewick, Washington, Records",opvelca7a5_313.xml,80444/xv49899,0,0,4,4
"University Lutheran Church, Seattle, Washington, Records",opvelca7a5_388.xml,80444/xv61038,1,3,0,4
"Immanuel Lutheran Church, Joplin, Montana, Records",opvelca7a3_105.xml,80444/xv26504,0,2,2,4
"Good Shepherd Lutheran Church, Albany, Oregon, Records",opvelca7a4_146.xml,80444/xv52853,0,0,4,4
"Peace Lutheran Church, Burns, Oregon, Records",opvelca7a4_159.xml,80444/xv28881,0,4,0,4
"Trinity Lutheran Church, Wibaux, Montana, Records",opvelca7a3_142.xml,80444/xv97177,4,0,0,4
"Albina and Bethesda Lutheran Church Records",opvelca7_5xml.xml,80444/xv16776,1,0,3,4
"Trinity Lutheran Church, Culbertson, Montana, Records",opvelca7a3_77.xml,80444/xv69537,0,1,3,4
"Grace Lutheran Church, Vale, Oregon, Records",opvelca7a4_247.xml,80444/xv78909,3,0,1,4
"Faith Lutheran Church, North Bend, Oregon, Records",opvelca7a4_203.xml,80444/xv94552,0,4,0,4
"Fairbanks Lutheran Church, Fairbanks, Alaska, Records",opvelca7a1_9.xml,80444/xv07351,4,0,0,4
"Emmanuel Lutheran Church, Moscow, Idaho, Records",opvelca7a2_44.xml,80444/xv61770,0,3,1,4
"Zion Lutheran Church, Redmond, Oregon, Records",opvelca7a4_230.xml,80444/xv40655,0,2,2,4
"Peninsula Lutheran Church, Gig Harbor, Washington, Records",opvelca7a5_305.xml,80444/xv02566,4,0,0,4
"Nativity Lutheran Church, Bend, Oregon, Records",opvelca7a4_156.xml,80444/xv62701,2,0,2,4
"Faith Lutheran Church, Salem, Oregon, Records",opvelca7a4_233.xml,80444/xv88534,0,3,1,4
"Family of God Lutheran Church Records",opvelca7_7.xml,80444/xv48240,0,0,4,4
"Schnackenberg, Walter C.papers",opvarchrg6.4.1.xml,80444/xv38012,3,0,1,4
"Holy Trinity Lutheran Church, Port Angeles, Washington, Records",opvelca7a5_351.xml,80444/xv43948,4,0,0,4
"American Lutheran Church, Harlem, Montana, Records",opvelca7a3_95.xml,80444/xv77429,3,0,1,4
"St. John Lutheran Church, Genesee, Idaho, Records",opvelca7a2_34.xml,80444/xv26144,3,0,1,4
"Bethesda Lutheran Church, Eugene, Oregon, Records",opvelca7a4_172.xml,80444/xv13385,1,1,2,4
"Grace Lutheran Church, Bellevue, Washington, Records",opvelca7a5_261.xml,80444/xv37826,0,4,0,4
"Faith Lutheran Church, Redmond, Washington, Records",opvelca7a5_362.xml,80444/xv34872,1,0,3,4
"Good Shepherd Lutheran Church, Polson, Montana, Records",opvelca7a3_440.xml,80444/xv21362,4,0,0,4
"Sunburst Lutheran Church, Sunburst, Montana, Records",opvelca7a3_136.xml,80444/xv35720,0,3,1,4
"Saron Lutheran Church Records",opvelca7a5_309.xml,80444/xv25616,2,2,0,4
"The Luther Memorial Lutheran Church Records",opvelca7_18.xml,80444/xv83466,1,3,0,4
"St. Paul's Lutheran Church, Missoula, Montana, Records",opvelca7a3_121.xml,80444/xv11572,2,0,2,4
"Peace Lutheran Church, Billings, Montana, Records",opvelca7a3_67.xml,80444/xv13793,0,0,4,4
"James Bramblet",opvsiemss_24.xml,80444/xv99841,0,0,4,4
"Christ the Servant Lutheran Church, Bellingham, Washington, Records",opvelca7a5_265.xml,80444/xv21160,0,1,3,4
"Atonement Lutheran Church, Missoula, Montana, Records",opvelca7a3_118.xml,80444/xv10626,3,0,1,4
"Resurrection Lutheran Church, Seward, Alaska, Records",opvelca7a1_15b.xml,80444/xv35140,3,0,1,4
"First Lutheran Church, Poulsbo, Washington, Records",opvelca7a5_355.xml,80444/xv73361,2,2,0,4
"Silverdale Lutheran Church, Silverdale, Washington, Records",opvelca7a5_392.xml,80444/xv27539,0,0,4,4
"Normanna Male Chorus Collection",opvsiemss_41.xml,80444/xv53912,2,0,2,4
"Whitewater Lutheran Church, Whitewater, Montana, Records",opvelca7a3_141.xml,80444/xv55590,2,0,2,4
"Malene Steen Autobiography",opvsiemss_26.xml,80444/xv58221,2,1,1,4
"Our Saviour's Lutheran Church, Sunnyside, Washington, Records",opvelca7a5_411.xml,80444/xv12393,0,2,1,3
"St. Luke's Lutheran Church, Bellevue, Washington, Records",opvelca7a5_263.xml,80444/xv95648,0,3,0,3
"Big Timber Lutheran Church, Big Timber, Montana, Records",opvelca7a3_59.xml,80444/xv16390,0,3,0,3
"University Congregation Pacific Lutheran University, Tacoma, Washington, Records",opvelca7a5_419.xml,80444/xv08792,1,0,2,3
"Our Saviour’s Lutheran Church, Bellingham, Washington, Records",opvelca7a5_267.xml,80444/xv58853,0,3,0,3
"Shepherd of the Hills Lutheran Church, Concrete, Washington, Records",opvelca7a5_284.xml,80444/xv95504,0,0,3,3
"Portsmouth Trinity Lutheran Church, Portland, Oregon, Records",opvelca7a4_222.xml,80444/xv41378,0,2,1,3
"John Storseth Biography",opvsiemss_109.xml,80444/xv44247,0,2,1,3
"Naselle Lutheran Church, Naselle, Washington, Records",opvelca7a5_341.xml,80444/xv87234,2,1,0,3
"Grace Lutheran Church, Des Moines, Washington, Records",opvelca7a5_286.xml,80444/xv52502,0,3,0,3
"Hope Evangelical Lutheran Church, Klamath Falls, Oregon, Records",opvelca7a4_190.xml,80444/xv33370,0,3,0,3
"Kent Lutheran Church, Kent, Washington, Records",opvelca7a5_315.xml,80444/xv45977,1,0,2,3
"Holy Cross Lutheran Church, Salem, Oregon, Records",opvelca7a4_235.xml,80444/xv77145,2,1,0,3
"Lord of Life Lutheran Church, Duvall, Washington, Records",opvelca7a5_287.xml,80444/xv91027,3,0,0,3
"Zion Lutheran Church, Juliaetta, Idaho, Records",opvelca7a2_39.xml,80444/xv74731,0,0,3,3
"Bethlehem Lutheran Church, Marysville, Washington, Records",opvelca7a5_333.xml,80444/xv50497,0,3,0,3
"Lutheran Church of the Redeemer, Chimacum, Washington, Records",opvelca7a5_281.xml,80444/xv71066,0,0,3,3
"Local Histories: Clark County, Washington (State)",opvnpc1_6.xml,80444/xv98173,0,0,3,3
"Immanuel Lutheran Church, Seattle, Washington, Records",opvelca7a5_378.xml,80444/xv99743,1,2,0,3
"Ole Bakken--Autobiography",opvsiemss_18.xml,80444/xv35354,3,0,0,3
"Christ the King Lutheran Church, Milton-Freewater, Oregon, Records",opvelca7a4_199.xml,80444/xv16302,3,0,0,3
"St. Paul of Damascus Lutheran Church, Boring, Oregon, Records",opvelca7a4_158.xml,80444/xv38919,0,1,2,3
"Prince of Peace Lutheran Church, Everett, Washington, Records",opvelca7a5_296.xml,80444/xv99981,0,0,3,3
"Jonas Olof Grafström Collection",opvsiemss_133.xml,80444/xv89031,0,1,2,3
"Local Histories: Kitsap County, Washington (State)",opvnpc1_15.xml,80444/xv26008,2,1,0,3
"Immanuel Lutheran Church, Missoula, Montana, Records",opvelca7a3_119.xml,80444/xv70782,2,1,0,3
"Nils Andersson Emigration Registration Document",opvsiemss_129.xml,80444/xv49050,0,0,3,3
"Messiah Evangelical Lutheran Church, Billings, Montana, Records",opvelca7a3_66.xml,80444/xv18969,0,0,3,3
"United Lutheran Church, Eugene, Oregon, Records",opvelca7a4_178.xml,80444/xv13095,0,0,3,3
"Prince of Peace Lutheran Church, Forks, Washington, Records",opvelca7a5_301.xml,80444/xv17749,0,0,3,3
"St. John's Lutheran Church, Helena, Montana, Records",opvelca7a3_99.xml,80444/xv74328,3,0,0,3
"Mount Si Lutheran Church, North Bend, Washington, Records",opvelca7a5_342.xml,80444/xv26644,2,1,0,3
"Grace Lutheran Church, Mountain Home, Idaho, Records",opvelca7a2_45.xml,80444/xv21911,2,1,0,3
"Christ the Servant Lutheran Church, Lacey, Washington, Records",opvelca7a5_320.xml,80444/xv84939,0,2,1,3
"Salem Lutheran Church, Spokane, Washington, Records",opvelca7a5_402.xml,80444/xv26910,0,0,3,3
"Faith Lutheran Church, Everett, Washington, Records",opvelca7a5_294.xml,80444/xv68283,0,1,2,3
"Anders O. Aasen Biography",opvsiemss_113.xml,80444/xv96612,0,0,3,3
"Gloria Dei Lutheran Church Anchorage, Alaska, Records",opvelca7a1_5.xml,80444/xv91632,0,0,3,3
"Petersburg Lutheran Church, Petersburg, Alaska, Records",opvelca7a1_15.xml,80444/xv64114,1,2,0,3
"Peace Lutheran Church, Puyallup, Washington, Records",opvelca7a5_359.xml,80444/xv24768,0,0,3,3
"Peace Lutheran Church, Otis Orchards, Washington, Records",opvelca7a5_348.xml,80444/xv99972,0,0,3,3
"Light of Life Lutheran Church, Aloha, Oregon, Records",opvelca7a4_147.xml,80444/xv46264,1,0,2,3
"A. B. Moe Autobiography",opvsiemss_27.xml,80444/xv33255,0,2,1,3
"Local Histories: Douglas County, Washington (State)",opvnpc1_8.xml,80444/xv63628,0,0,3,3
"Our Savior's Lutheran Church, Laurel, Montana, Records",opvelca7a3_109.xml,80444/xv14337,0,2,1,3
"Clearbrook Lutheran Church, Lynden, Washington, Records",opvelca7a5_329.xml,80444/xv48348,0,2,1,3
"St. Peter Lutheran Church, Spokane, Washington, Records",opvelca7a5_403.xml,80444/xv15747,0,3,0,3
"Ole Overlie Family History",opvsiemss_81.xml,80444/xv36499,1,2,0,3
"Zion Lutheran Church, Spokane, Washington, Records",opvelca7a5_404.xml,80444/xv73403,2,1,0,3
"Emmanuel Lutheran Church, Willamina, Oregon, Records",opvelca7a4_250.xml,80444/xv50137,2,0,1,3
"Good Shepherd Lutheran Church, Cave Junction, Oregon, Records",opvelca7a4_162.xml,80444/xv34249,0,0,3,3
"Our Savior's Lutheran Church, Salem, Oregon, Records",opvelca7a4_236.xml,80444/xv46405,2,0,1,3
"Gloria Pederson Collection",opvsiemss_68.xml,80444/xv91406,2,0,1,3
"Christian Miller Autobiography, <emph render="italic">Sweet Land</emph>",opvsiemss_49.xml,80444/xv26925,1,1,1,3
"Mount Cross Lutheran Church, University Place, Washington, Records",opvelca7a5_416.xml,80444/xv51876,1,0,2,3
"Faith Lutheran Church, Clatskanie, Oregon, Records",opvelca7a4_164.xml,80444/xv08117,0,0,3,3
"Grace Lutheran Church, Cashmere, Washington, Records",opvelca7a5_278.xml,80444/xv17520,2,0,1,3
"Olaf Gulbrandsen Autograph Album",opvsiemss_132.xml,80444/xv73501,0,0,3,3
"Calvary Lutheran Church, Hillsboro, Oregon, Records",opvelca7a4_186.xml,80444/xv91879,2,0,1,3
"Amazing Grace Lutheran Church, Anchorage, AK Records",opvelca7a1_1.xml,80444/xv55096,0,1,2,3
"Mathilde Hader Autobiography",opvsiemss_32.xml,80444/xv80200,0,0,3,3
"Bethlehem Lutheran Church, Billings, Montana, Records",opvelca7a3_62.xml,80444/xv24990,3,0,0,3
"Our Savior's Lutheran Church, Lake Oswego, Oregon, Records",opvelca7a4_193.xml,80444/xv30227,0,0,2,2
"Faith Lutheran Church, Hamilton, Montana, Records",opvelca7a3_93.xml,80444/xv73495,1,1,0,2
"Holy Trinity Lutheran Church, Mercer Island, Washington, Records",opvelca7a5_334.xml,80444/xv64950,0,0,2,2
"Peace Lutheran Church, Tacoma, Washington, Records",opvelca7a5_417.xml,80444/xv61944,1,0,1,2
"Aasta and Anders Wedding Songbook",opvsiemss_91.xml,80444/xv86004,0,0,2,2
"Trinity Lutheran Church, Pullman, Washington, Records",opvelca7a5_357.xml,80444/xv19717,0,2,0,2
"Anacortes Lutheran Church, Anacortes, Washington, Records",opvelca7a5_253.xml,80444/xv02420,0,2,0,2
"Our Saviour's Lutheran Church, Seaside, Oregon, Records",opvelca7a4_238.xml,80444/xv00588,0,2,0,2
"Grace Lutheran Church, Lewiston, Idaho, Records",opvelca7a2_43.xml,80444/xv35568,2,0,0,2
"Plentywood Lutheran Church, Plentywood, Montana, Records",opvelca7a3_124.xml,80444/xv77764,0,0,2,2
"Clark Fork Lutheran Church, Clark Fork, Idaho, Records",opvelca7a2_29.xml,80444/xv56076,0,2,0,2
"Our Redeemer's Lutheran Church, Helena, Montana, Records",opvelca7a3_98.xml,80444/xv82553,0,0,2,2
"Bethel Chinese Lutheran Church, Seattle, Washington, Records",opvelca7a5_370.xml,80444/xv76211,0,2,0,2
"History of Adelphia College",opvsiemss_76.xml,80444/xv63534,0,1,1,2
"Lord of Life Lutheran Church, Renton, Washington, Records",opvelca7a5_365.xml,80444/xv80435,0,1,1,2
"St. Andrew Lutheran Church, Vancouver, Washington, Records",opvelca7a5_425.xml,80444/xv10632,0,0,2,2
"Unknown",opvelca7a5_434.xml,80444/xv64321,0,1,1,2
"Joliet Lutheran Church, Joliet, Montana, Records",opvelca7a3_103.xml,80444/xv94793,2,0,0,2
"Hope Lutheran Church, Anaconda, Montana, Records",opvelca7a3_57.xml,80444/xv66854,2,0,0,2
"St. James Lutheran Church, Columbus, Montana, Records",opvelca7a3_76.xml,80444/xv33480,0,0,2,2
"Teller Lutheran Church, Teller, Alaska, Records",opvelca7a1_19.xml,80444/xv86941,0,0,2,2
"Evanson, Evan I., Biography",opvsiemss_12.xml,80444/xv52947,0,0,2,2
"Family of God Lutheran Church, Bremerton, Washington, Records",opvelca7a5_273.xml,80444/xv21530,2,0,0,2
"Gunnar and Marie Lund Biographies",opvsiemss_112.xml,80444/xv19525,0,2,0,2
"Ole G. Slind Papers",opvsiemss_66.xml,80444/xv05172,0,2,0,2
"Trinity Lutheran Church, Vancouver, Washington, Records",opvelca7a5_426.xml,80444/xv68734,0,2,0,2
"Zion Lutheran Church, Brockton, Montana, Records",opvelca7a3_72.xml,80444/xv34045,0,1,1,2
"King of Glory Lutheran Church, Billings, Montana, Records",opvelca7a3_65.xml,80444/xv01824,2,0,0,2
"Lutheran Church of the Master, Coeur d'Alene, Idaho, Records",opvelca7a2_30.xml,80444/xv68014,0,0,2,2
"Bethesda Lutheran Church, Mountlake Terrace, Washington, Records",opvelca7a5_337.xml,80444/xv90734,0,0,2,2
"Local Histories: Grant County, Washington (State)",opvnpc1_10.xml,80444/xv61921,0,0,2,2
"First Evangelical Lutheran Church, Idaho Falls, Idaho, Records",opvelca7a2_38.xml,80444/xv91110,0,2,0,2
"Christ Lutheran Church, Aurora, Oregon, Records",opvelca7a4_150.xml,80444/xv18078,0,0,2,2
"Edison Lutheran Church, Bow (Edison), Washington, Records",opvelca7a5_271.xml,80444/xv25042,0,2,0,2
"Hope Lutheran Church, Heppner, Oregon, Records",opvelca7a4_184.xml,80444/xv81268,0,2,0,2
"Arthur Torgerson Family History",opvsiemss_64.xml,80444/xv38214,0,0,2,2
"Messiah Lutheran Church, Spokane, Washington, Records",opvelca7a5_400.xml,80444/xv55371,0,1,1,2
"Faith Lutheran Church, Shelton, Washington, Records",opvelca7a5_390.xml,80444/xv74246,0,0,2,2
"Bethany Lutheran Church, Spanaway, Washington, Records",opvelca7a5_396.xml,80444/xv90921,0,0,2,2
"Emanuel Lutheran Church, Yelm, Washington, Records",opvelca7a5_437.xml,80444/xv17797,1,1,0,2
"Pauline Paulson Hendrickson Biography",opvsiemss_110.xml,80444/xv68197,0,1,1,2
"Faith Lutheran Church",opvelca7_12.xml,80444/xv20877,0,1,1,2
"Gethsemane Lutheran Church, Portland, Oregon, Records",opvelca7a4_214.xml,80444/xv23223,0,0,2,2
"Obituaries Collection",opvsiemss_73.xml,80444/xv84268,1,0,1,2
"Gloria Dei Lutheran Church, Butte, Montana, Records",opvelca7a3_73.xml,80444/xv80209,0,0,2,2
"Educational Policies Committee Records",opvarch3_4_3.xml,80444/xv21220,0,0,2,2
"American Lutheran Church, Richey, Montana, Records",opvelca7a3_126.xml,80444/xv62170,0,0,2,2
"Peder Madsen Genealogical Chart",opvsiemss_97.xml,80444/xv08053,0,1,1,2
"Trinity Lutheran Church, Coeur d'Alene, Idaho, Records",opvelca7a2_31.xml,80444/xv62445,0,0,2,2
""A Dream is a Dream: The Vikings Return!" Article",opvsiemss_128.xml,80444/xv02923,0,0,2,2
"Christ the King Lutheran Church, Snohomish, Washington, Records",opvelca7a5_393.xml,80444/xv33856,0,2,0,2
"American Lutheran Church, Winifred, Montana, Records",opvelca7a3_143.xml,80444/xv32031,2,0,0,2
"Shepherd of the Valley Lutheran Church, Townsend, Montana, Records",opvelca7a3_137.xml,80444/xv76837,0,0,2,2
"Christ Lutheran Church, Walla Walla, Washington, Records",opvelca7a5_429.xml,80444/xv25292,0,0,2,2
""Letters From Norway" Article",opvsiemss_77.xml,80444/xv72631,0,2,0,2
"Grace Lutheran Church, Horseshoe Bend, Idaho, Records",opvelca7a2_37.xml,80444/xv25457,0,0,2,2
"Central Lutheran Church, Bellingham, Washington, Records",opvelca7a5_264.xml,80444/xv94223,2,0,0,2
"Our Savior's Lutheran Church, Broadus, Montana, Records",opvelca7a3_70.xml,80444/xv22174,0,2,0,2
"Good Shepherd Lutheran Church, Veradale (Spokane Valley), Washington, Records",opvelca7a5_428.xml,80444/xv39605,2,0,0,2
"Swedish Order of Valhalla Collection",opvsiemss_51.xml,80444/xv23590,2,0,0,2
"Carl Roan Collection",opvsiemss_70.xml,80444/xv87628,0,0,2,2
"Karl Olsen Collection",opvsiemss_57.xml,80444/xv81762,0,0,2,2
"Cross of Christ Lutheran Church Records",opvelca7_13.xml,80444/xv53709,0,0,2,2
"Svend Svendson Sneve Biography",opvsiemss_111.xml,80444/xv28274,0,2,0,2
"Fifteenth Wisconsin, Translation",opvsiemss_39.xml,80444/xv17059,0,0,2,2
"Abraham Vereide Collection",opvsiemss_114.xml,80444/xv35217,0,1,1,2
"Local Histories: Island County, Washington (State)",opvnpc1_12.xml,80444/xv27719,0,2,0,2
"American Lutheran Church, White Sulphur Springs, Montana, Records",opvelca7a3_140.xml,80444/xv65643,0,0,2,2
"Hope Lutheran Church, Enumclaw, Washington, Records",opvelca7a5_291.xml,80444/xv07720,0,2,0,2
"Faith Lutheran Church, Coquille, Oregon, Records",opvelca7a4_167.xml,80444/xv03485,1,0,1,2
"Highland Lutheran Church, La Center, Washington, Records",opvelca7a5_319.xml,80444/xv40426,0,0,1,1
"Calvary Lutheran Church, Post Falls, Idaho, Records",opvelca7a2_51.xml,80444/xv66629,0,0,1,1
"The Wolltveit-Hagen-Neset Family Collection",opvsiemss_60.xml,80444/xv56512,0,1,0,1
"Bertha Blanche Hall Oles Collection",opvsiemss_124.xml,80444/xv68707,0,1,0,1
"Local Histories: Grays Harbor County, Washington (State)",opvnpc1_11.xml,80444/xv94750,0,0,1,1
"Tweiten, Carl O. Autobiography",opvsiemss_6.xml,80444/xv37527,1,0,0,1
"Hope Lutheran Church, Eagle, Idaho, Records",opvelca7a2_32.xml,80444/xv67465,0,0,1,1
"Queen Anne Lutheran Church, Seattle, Washington, Records",opvelca7a5_387.xml,80444/xv86257,0,1,0,1
"First Lutheran Church, Lambert, Montana, Records",opvelca7a3_108.xml,80444/xv01751,0,0,1,1
"Cross and Crown Lutheran Church, Renton, Washington, Records",opvelca7a5_364.xml,80444/xv97967,0,0,1,1
"Carl Frederick Solberg Papers",opvsiemss_33.xml,80444/xv26293,1,0,0,1
"Mount Carmel Lutheran Church, Portland, Oregon, Records",opvelca7a4_219.xml,80444/xv33544,0,0,1,1
"Cromwell Reunion Memories",opvsiemss_120.xml,80444/xv06201,0,1,0,1
"Our Saviour's Lutheran Church, Arlington, Washington, Records",opvelca7a5_255.xml,80444/xv51565,0,1,0,1
"Trinity Lutheran Church, Nampa, Idaho, Records",opvelca7a2_46.xml,80444/xv27920,0,1,0,1
"Immanuel Lutheran Church, Everson, Washington, Records",opvelca7a5_297.xml,80444/xv64752,1,0,0,1
"Trinity Lutheran Church, Bonners Ferry, Idaho, Records",opvelca7a2_28.xml,80444/xv70153,1,0,0,1
"St. John's Lutheran Church, Helena, Montana, Records",opvelca7a3_437.xml,80444/xv27890,0,0,1,1
"Sammamish Hills Lutheran Church, Sammamish, Washington, Records",opvelca7a5_363.xml,80444/xv21340,0,0,1,1
"Holy Cross Lutheran Church, Bellevue, Washington, Records",opvelca7a5_262.xml,80444/xv94497,0,1,0,1
"St. Andrew Lutheran Church, Beaverton, Oregon, Records",opvelca7a4_154.xml,80444/xv77941,0,1,0,1
"St. Paul Lutheran Church, Quincy, Washington, Records",opvelca7a5_360.xml,80444/xv68597,0,0,1,1
"St. John's Lutheran Church, Nezperce, Idaho, Records",opvelca7a2_47.xml,80444/xv68679,0,0,1,1
"Redeemer Lutheran Church, Portland, Oregon, Records",opvelca7a4_223.xml,80444/xv38662,0,0,1,1
"First Lutheran Church, Wolf Point, Montana, Records",opvelca7a3_144.xml,80444/xv38928,0,0,1,1
"Daughters of Norway Grand Lodge",opvsiemss_45.xml,80444/xv72933,0,0,1,1
"Bethel of Shoreline Lutheran Church, Seattle, Washington, Records",opvelca7a5_371.xml,80444/xv08724,1,0,0,1
"Immanuel Lutheran Church, Grandview, Washington, Records",opvelca7a5_307.xml,80444/xv01354,0,0,1,1
"Scandinavians in Washington's Politics Research Paper Paper",opvsiemss_118.xml,80444/xv00039,0,0,1,1
"Holy Cross Lutheran Church Records",opvelca7a5_295.xml,80444/xv93353,0,0,1,1
"Knut Vaa Papers",opvsiemss_29.xml,80444/xv47055,0,1,0,1
"Emmanuel Lutheran Church, Cornelius, Oregon, Records",opvelca7a4_445.xml,80444/xv93429,0,0,1,1
"Thor Meland Collection",opvsiemss_4.xml,80444/xv47506,0,1,0,1
"Beautiful Savior Lutheran Church, Vancouver, Washington, Records",opvelca7a5_421.xml,80444/xv94918,0,1,0,1
"Christ Lutheran Church, Belfair, Washington, Records",opvelca7a5_259.xml,80444/xv34921,0,1,0,1
"Sons of Norway District 2",opvsiemss_43.xml,80444/xv06643,1,0,0,1
"Grace Lutheran Church, Potlatch, Idaho, Records",opvelca7a2_52.xml,80444/xv29467,0,0,1,1
"American Lutheran Church, Billings, Montana, Records",opvelca7a3_60.xml,80444/xv58947,1,0,0,1
"Kjesrud Family",opvsiemss_31.xml,80444/xv74740,1,0,0,1
"K. Berge Diary",opvsiemss_130.xml,80444/xv24114,0,0,1,1
"Christ Lutheran Church, Libby, Montana, Records",opvelca7a3_111.xml,80444/xv32543,0,0,1,1
"St. Paul Lutheran Church, Colville, Washington, Records",opvelca7a5_283.xml,80444/xv68591,0,1,0,1
"St. James Lutheran Church, Portland, Oregon, Records",opvelca7a4_224.xml,80444/xv41125,0,0,1,1
"Shepherd of the Hills Lutheran Church, Sisters, Oregon, Records",opvelca7a4_241.xml,80444/xv95480,0,1,0,1
"Lutheran Church of Christ the King, Tacoma, Washington, Records",opvelca7a5_415.xml,80444/xv02694,1,0,0,1
"Messiah Lutheran Church, Portland, Oregon, Records",opvelca7a4_218.xml,80444/xv89477,0,0,1,1
"Esther Olson Brissenden Collection",opvsiemss_59.xml,80444/xv25247,0,1,0,1
"Hinsdale Lutheran Church, Hinsdale, Montana, Records",opvelca7a3_101.xml,80444/xv19482,0,0,1,1
"St. Paul Lutheran Church, Portland, Oregon, Records",opvelca7a4_227.xml,80444/xv90557,0,0,1,1
"Faith Lutheran Church, Toppenish, Washington, Records",opvelca7a5_420.xml,80444/xv72662,0,0,1,1
"Bethlehem Lutheran Church, Kalispell, Montana, Records",opvelca7a3_106.xml,80444/xv91622,0,1,0,1
"Our Savior's Lutheran Church, Great Falls, Montana, Records",opvelca7a3_90.xml,80444/xv03063,1,0,0,1
"Good Shepherd Lutheran Church, Pocatello, Idaho, Records",opvelca7a2_50.xml,80444/xv94210,1,0,0,1
"Zion Lutheran Church, Dalles, Oregon, Records",opvelca7a4_171.xml,80444/xv43911,0,0,1,1
"Lord of Life Lutheran Church, Kennewick, Washington, Records",opvelca7a5_314.xml,80444/xv59304,0,0,1,1
"Local Histories: Asotin County, Washington (State)",opvnpc1_2.xml,80444/xv80386,0,0,1,1
"Daughters of Norway Embla Lodge No. 2",opvsiemss_42.xml,80444/xv35314,1,0,0,1
"Simon Johnson Stories",opvsiemss_72.xml,80444/xv98376,1,0,0,1
"Bethel Lutheran Church, Firth, Idaho, Records",opvelca7a2_33.xml,80444/xv69509,0,0,0,0
"Our Savior Lutheran Church, Pinehurst, Idaho, Records",opvelca7a2_49.xml,80444/xv58111,0,0,0,0
"Faith Lutheran Church, Elma, Washington, Records",opvelca7a5_289.xml,80444/xv76501,0,0,0,0
"Zion Lutheran Church, La Grande, Oregon, Records",opvelca7a4_192.xml,80444/xv78030,0,0,0,0
"Our Redeemer Lutheran Church, Eugene, Oregon, Records",opvelca7a4_176.xml,80444/xv47714,0,0,0,0
"Immanuel Lutheran Church, Woodburn, Oregon, Records",opvelca7a4_251.xml,80444/xv59011,0,0,0,0
"Bethel Lutheran Church, Brush Prarie, Washington, Records",opvelca7a5_275.xml,80444/xv42864,0,0,0,0
"Celebration Lutheran Church, East Wenatchee, Washington, Records",opvelca7a5_430.xml,80444/xv62322,0,0,0,0
"Richard D. Scheuerman Papers",opvsiemss_80.xml,80444/xv35867,0,0,0,0
"Central Lutheran Church, Yakima, Washington, Records",opvelca7a5_435.xml,80444/xv92752,0,0,0,0
"Kari Lodvarsdatter Papers",opvsiemss_102.xml,80444/xv65545,0,0,0,0
"First American Lutheran Church, Hardin, Montana, Records",opvelca7a3_94.xml,80444/xv90570,0,0,0,0
"Marvin Johnson Papers",opvsiemss_105.xml,80444/xv42663,0,0,0,0
"Fridtjof Nansen Scrapbook Collection",opvsiemss_94.xml,80444/xv75427,0,0,0,0
"Jansson-Berlin-Johansson Family History",opvsiemss_93.xml,80444/xv03750,0,0,0,0
"Pilgrim Lutheran Church, Portland, Oregon, Records",opvelca7a4_221.xml,80444/xv07037,0,0,0,0
"Vinland Lutheran Church, Poulsbo, Washington, Records",opvelca7a5_356.xml,80444/xv65866,0,0,0,0
"Christ Lutheran Church, Fairbanks, Alaska, Records",opvelca7a1_8.xml,80444/xv87161,0,0,0,0
"Local Histories: Jefferson County, Washington (State)",opvnpc1_13.xml,80444/xv65338,0,0,0,0
"Redeemer Lutheran Church, Great Falls, Montana, Records",opvelca7a3_91.xml,80444/xv36428,0,0,0,0
"Trinity Lutheran Church, Endicott, Washington, Records",opvelca7a5_290.xml,80444/xv46746,0,0,0,0
"Good Hope Lutheran Church, Lind, Washington, Records",opvelca7a5_326.xml,80444/xv03833,0,0,0,0
"Frederick Wilhelm August Poppe Collection",opvsiemss_78.xml,80444/xv55508,0,0,0,0
"Seattle Seamen's Center Records",opvelca6_1.xml,80444/xv24298,0,0,0,0
"Atonement Lutheran Church, Billings, Montana, Records",opvelca7a3_61.xml,80444/xv69274,0,0,0,0
"Christine K. Hansen Biography",opvsiemss_115.xml,80444/xv99050,0,0,0,0
"Creator Lutheran Church, Clackamas, Oregon, Records",opvelca7a4_163.xml,80444/xv65890,0,0,0,0
"Good Shepherd Lutheran Church, Billings, Montana, Records",opvelca7a3_64.xml,80444/xv74011,0,0,0,0
"Hjalmar Björk Collection",opvsiemss_100.xml,80444/xv93435,0,0,0,0
"Lutheran Mission of the San Juan Church, Friday Harbor, Washington, Records",opvelca7a5_303.xml,80444/xv86483,0,0,0,0
"Johanne Jacobsdatter Papers",opvsiemss_83.xml,80444/xv02029,0,0,0,0
"Salvation Army Swedish Songs Collection",opvsiemss_122.xml,80444/xv11563,0,0,0,0
"Maple Leaf Lutheran Church, Seattle, Washington, Records",opvelca7a5_382.xml,80444/xv47961,0,0,0,0
"Nativity Lutheran Church, Renton, Washington, Records",opvelca7a5_366.xml,80444/xv84619,0,0,0,0
"Zion Lutheran Church, Fairview, Montana, Records",opvelca7a3_83.xml,80444/xv47528,0,0,0,0
"Nordstrand School Band Tour Papers",opvsiemss_79.xml,80444/xv69363,0,0,0,0
"Trondsen-Øystad Families Genealogical Chart",opvsiemss_99.xml,80444/xv47750,0,0,0,0
"Grace Lutheran Church Records",opvelca7_14.xml,80444/xv86544,0,0,0,0
"Prince of Life Church, Oregon City, Oregon, Records",opvelca7a4_205.xml,80444/xv33654,0,0,0,0
"Local Histories: Chelan County, Washington (State)",opvnpc1_5.xml,80444/xv78678,0,0,0,0
"John H. Strande Family History",opvsiemss_98.xml,80444/xv06445,0,0,0,0
"First Lutheran Church, Opheim, Montana, Records",opvelca7a3_123.xml,80444/xv47222,0,0,0,0
"Mathilde Kildahl Autograph Book",opvsiemss_69.xml,80444/xv72808,0,0,0,0
"Twin Harbors Lutheran Church, Grayland, Washington, Records",opvelca7a5_308.xml,80444/xv08148,0,0,0,0
"Immanuel Lutheran Church, Vancouver, Washington, Records",opvelca7a5_423.xml,80444/xv85067,0,0,0,0
"Columbia Conference of the Evangelical Lutheran Augustana Synod Records",opvelca_rg3b.xml,80444/xv98239,0,0,0,0
"Nils P. Frostensson Family History",opvsiemss_35.xml,80444/xv40789,0,0,0,0
"Zion Lutheran Church, Roundup, Montana, Records",opvelca7a3_127.xml,80444/xv67636,0,0,0,0
"Good Shepherd Lutheran Church, Snohomish, Washington, Records",opvelca7a5_394.xml,80444/xv33847,0,0,0,0
"John Melvin Moe Papers",opvsiemss_103.xml,80444/xv80908,0,0,0,0
"H. Nielsen Papers",opvsiemss_89.xml,80444/xv02484,0,0,0,0
"Richard Londgren Collection",opvsiemss_58.xml,80444/xv14981,0,0,0,0
"Our Savior Lutheran Church, Twin Falls, Idaho, Records",opvelca7a2_54.xml,80444/xv24859,0,0,0,0
"Christ the King Lutheran Church, Goldendale, Washington, Records",opvelca7a5_306.xml,80444/xv38790,0,0,0,0
"Klamath Lutheran Church, Klamath Falls, Oregon, Records",opvelca7a4_191.xml,80444/xv45700,0,0,0,0
"Trinity Lutheran Church, Hot Springs, Montana, Records",opvelca7a3_102.xml,80444/xv36874,0,0,0,0
"Elsie M. Parkhurst Papers",opvsiemss_85.xml,80444/xv92843,0,0,0,0
"Martin Ulvestad Collection",opvsiemss_101.xml,80444/xv18981,0,0,0,0
"Trinity Lutheran Church, Freeland, Washington, Records",opvelca7a5_302.xml,80444/xv90777,0,0,0,0
"Nils-Harald Papers",opvsiemss_7.xml,80444/xv11862,0,0,0,0
"Hildur Larson Autobiography",opvsiemss_131.xml,80444/xv12753,0,0,0,0
"Svanøe Family History",opvsiemss_95.xml,80444/xv05718,0,0,0,0
"Prince of Peace Lutheran Church, Missoula, Montana, Records",opvelca7a3_120.xml,80444/xv90710,0,0,0,0
"Good Shepherd Lutheran Church, Salem, Oregon, Records",opvelca7a4_234.xml,80444/xv90606,0,0,0,0
"Bethany Lutheran Church, Longview, Washington, Records",opvelca7a5_327.xml,80444/xv03744,0,0,0,0
"Local Histories: Cowlitz County, Washington (State)",opvnpc1_7.xml,80444/xv30796,0,0,0,0
"Eulogy for Matthias Pedersen Øien",opvsiemss_86.xml,80444/xv79415,0,0,0,0
"Christ Lutheran Church, Ferndale, Washington, Records",opvelca7a5_300.xml,80444/xv07305,0,0,0,0
"Kremlin Lutheran Church, Kremlin, Montana, Records",opvelca7a3_107.xml,80444/xv10543,0,0,0,0
"August Merikanto Collection",opvsiemss_63.xml,80444/xv23391,0,0,0,0
"Grace Evangelical Lutheran Church, Port Townsend, Washington, Records",opvelca7a5_354.xml,80444/xv32730,0,0,0,0
"Bethel Lutheran Church, Portland, Oregon, Records",opvelca7a4_210.xml,80444/xv11596,0,0,0,0
"Family of Grace Lutheran Church, Auburn, Washington, Records",opvelca7a5_256.xml,80444/xv87469,0,0,0,0
"Faith Lutheran Church, Seattle, Washington, Records",opvelca7a5_374.xml,80444/xv64776,0,0,0,0
"Scandinavian Materials in Mortvedt Library Research Paper",opvsiemss_117.xml,80444/xv98675,0,0,0,0
"The Gjøa Collection",opvsiemss_62.xml,80444/xv39010,0,0,0,0
"Holy Trinity Lutheran Church, Spokane, Washington, Records",opvelca7a5_401.xml,80444/xv57666,0,0,0,0
"Ulrikka F. Bruun Poetry Collection",opvsiemss_84.xml,80444/xv12826,0,0,0,0
"Holy Trinity Lutheran Church, Portland,Oregon, Records",opvelca7a4_215.xml,80444/xv47341,0,0,0,0
"First Lutheran Church, Sandpoint, Idaho, Records",opvelca7a2_53.xml,80444/xv79238,0,0,0,0
"Eulogy for Jacob D. Jacobsen",opvsiemss_106.xml,80444/xv75924,0,0,0,0
"Prince of Peace Lutheran Church, Seatac, Washington, Records",opvelca7a5_385.xml,80444/xv06704,0,0,0,0
"Shepherd of the Valley Lutheran Church, Beaverton, Oregon, Records",opvelca7a4_153.xml,80444/xv47274,0,0,0,0
"Gina Ruud Anderson Biography",opvsiemss_108.xml,80444/xv79815,0,0,0,0
"Our Redeemer Lutheran Church, Hood River, Oregon, Records",opvelca7a4_187.xml,80444/xv26556,0,0,0,0
"Central Lutheran Church, Morton, Washington, Records",opvelca7a5_335.xml,80444/xv47958,0,0,0,0
"Trinity Lutheran Church, Dallas, Oregon, Records",opvelca7a4_170.xml,80444/xv82043,0,0,0,0
"Broadland Knutzen (Inga) Biography",opvsiemss_3.xml,80444/xv27337,0,0,0,0
"Good Shepherd Lutheran Church,Wasilla, Alaska, Records",opvelca7a1_23.xml,80444/xv53680,0,0,0,0
"Martin Luther Lutheran Church",opvelca7_16.xml,80444/xv17802,0,0,0,0
"Johannes B. Wist Biographical Information",opvsiemss_82.xml,80444/xv64175,0,0,0,0
"Bethany Lutheran Church, Bainbridge Island, Washington, Records",opvelca7a5_258.xml,80444/xv36886,0,0,0,0
"Gull Harbor Lutheran Church, Olympia, Washington, Records",opvelca7a5_346.xml,80444/xv01596,0,0,0,0
"Knud Olsen Hovie Vaccination Certificate",opvsiemss_87.xml,80444/xv18869,0,0,0,0
"Holy Sacrament Lutheran Church Records",opvelca7_6.xml,80444/xv15405,0,0,0,0
"St. Paul's Lutheran Church, Chewelah, Washington, Records",opvelca7a5_280.xml,80444/xv28997,0,0,0,0
"Bethel Lutheran Church, Great Falls, Montana, Records",opvelca7a3_104.xml,80444/xv32669,0,0,0,0
"Olof and Lars Johnson Collection",opvsiemss_65.xml,80444/xv60498,0,0,0,0
"Antoinetta Wilhelmina Nordström Immigration Document",opvsiemss_88.xml,80444/xv72067,0,0,0,0
"Creator Lutheran Church, Sumner, Washington, Records",opvelca7a5_410.xml,80444/xv62112,0,0,0,0
"Family of Christ Lutheran Church, Vancouver, Washington, Records",opvelca7a5_422.xml,80444/xv89373,0,0,0,0
"G. and Klara Holmqvist Correspondence",opvsiemss_104.xml,80444/xv85351,0,0,0,0
"Saint Mark Lutheran Church Anchorage, Alaska, Records",opvelca7a1_6.xml,80444/xv74438,0,0,0,0
"Gloria Dei Lutheran Church, Kelso, Washington, Records",opvelca7a5_311.xml,80444/xv38165,0,0,0,0
"Emanuel Lutheran Church, Blackfoot, Idaho, Records",opvelca7a2_24.xml,80444/xv77157,0,0,0,0
"Eulogy for Sven Oftedal",opvsiemss_107.xml,80444/xv52282,0,0,0,0
"Kinfolk",opvsiemss_75.xml,80444/xv95748,0,0,0,0
"Luther Memorial Lutheran Church, Seattle, Washington, Records",opvelca7a5_380.xml,80444/xv74496,0,0,0,0
"Bethel Lutheran Church, Great Falls, Montana, Records",opvelca7a3_88.xml,80444/xv46868,0,0,0,0
,,Totals,5694,4707,4933,15334
