Title,Document Name,Ark Identifier,July,August,September,Total
"Folk Art of the Oregon Country project records",orflr_ofa79.xml,80444/xv11373,43,40,29,112
"Roberts (Jennifer) Student Folklore Fieldwork Project",orflr_1990_003.xml,80444/xv86486,11,26,39,76
"Gates (Charlene) Student Folklore Fieldwork Project",orflr_1974_061.xml,80444/xv01806,16,12,8,36
"Arnould (Marie) Student Folklore Fieldwork Project",orflr_1990_001.xml,80444/xv43319,6,8,17,31
"Abrams (Elizabeth) Student Folklore Fieldwork Project",orflr_1976_021.xml,80444/xv80117,6,9,9,24
"Student Folklore Fieldwork Project",orflr_1973_125.xml,80444/xv45941,0,16,8,24
"Lakin (Mary Ann) Student Folklore Fieldwork Project",orflr_1993_002.xml,80444/xv91552,4,16,3,23
"Student Folklore Fieldwork Project",orflr_1971_383.xml,80444/xv14324,9,9,4,22
"Gomez (Ingrid) Student Folklore Fieldwork Project",orflr_2010_001.xml,80444/xv29031,2,13,6,21
"Pharris (Kristen L.) Student Folklore Fieldwork Project",orflr_1974_047.xml,80444/xv84805,15,2,4,21
"Student Folklore Fieldwork Project",orflr_1973_256.xml,80444/xv04559,12,7,1,20
"McFarland (Carol) Student Folklore Fieldwork Project",orflr_1981_028.xml,80444/xv37094,12,3,4,19
"Bittner (Julia) Student Folklore Fieldwork Project",orflr_2012_021.xml,80444/xv82888,4,10,4,18
"Roberts (Martha) Student Folklore Fieldwork Project",orflr_1979_039.xml,80444/xv18899,11,6,0,17
"Cellars (Connie) Student Folklore Fieldwork Project",orflr_1975_007.xml,80444/xv87176,5,6,4,15
"Attebery (Bobby) Student Folklore Fieldwork Project",orflr_1971_011.xml,80444/xv80853,13,1,1,15
"Llewellyn (Diane) Student Folklore Fieldwork Project",orflr_1972_129.xml,80444/xv92623,13,2,0,15
"Mauritz (Anita) Student Folklore Fieldwork Project",orflr_1974_031.xml,80444/xv52508,0,8,7,15
"Sengebau (Helen M.) Student Folklore Fieldwork Project",orflr_1980_040.xml,80444/xv34155,5,2,8,15
"Chavez (Pilar) Student Folklore Fieldwork Project",orflr_2012_033.xml,80444/xv91894,5,9,1,15
"Rea (Bonnie Jean) Student Folklore Fieldwork Project",orflr_1993_032.xml,80444/xv08752,11,0,4,15
"Merge (Steve) Student Folklore Fieldwork Project",orflr_1972_192.xml,80444/xv31909,4,4,6,14
"Cover (Ann) Student Folklore Fieldwork Project",orflr_1972_187.xml,80444/xv01757,11,0,3,14
"Harsh (Katie) Student Folklore Fieldwork Project",orflr_2010_018.xml,80444/xv65267,10,0,4,14
"Hoffnagle (John) Student Folklore Fieldwork Project",orflr_1974_003.xml,80444/xv89926,11,1,2,14
"Ramos (Rochelle) Student Folklore Fieldwork Project",orflr_1984_034.xml,80444/xv54589,7,3,4,14
"Jackson (Jeanette) Student Folklore Fieldwork Project",orflr_1972_120.xml,80444/xv78427,10,0,4,14
"Wilmot (Margaret) Student Folklore Fieldwork Project",orflr_1972_158.xml,80444/xv90002,3,9,2,14
"Nisbet (Robert A.) Student Folklore Fieldwork Project",orflr_1986_031.xml,80444/xv67431,8,6,0,14
"Student Folklore Fieldwork Project",orflr_1973_180.xml,80444/xv47192,10,0,4,14
"Slottee (Barbara) Student Folklore Fieldwork Project",orflr_1971_266.xml,80444/xv76666,0,5,9,14
"Bigham (Vange) Student Folklore Fieldwork Project",orflr_1988_003.xml,80444/xv12432,8,0,5,13
"Arabian (Gary) Student Folklore Fieldwork Project",orflr_1974_053.xml,80444/xv34176,8,2,3,13
"Sullivan (Terry D.) Student Folklore Fieldwork Project",orflr_1977_129.xml,80444/xv48031,8,0,5,13
"Yamate (Karen) Student Folklore Fieldwork Project",orflr_1974_305.xml,80444/xv45996,4,3,6,13
"Cetto (Michael) Student Folklore Fieldwork Project",orflr_1977_023.xml,80444/xv08108,4,5,4,13
"Smith (Tom E.) Student Folklore Fieldwork Project",orflr_1974_097.xml,80444/xv43887,9,0,4,13
"Strobel (Laura) Student Folklore Fieldwork Project",orflr_1999_002.xml,80444/xv48587,13,0,0,13
"Rice (Debora) Student Folklore Fieldwork Project",orflr_1976_011.xml,80444/xv26809,11,1,1,13
"Berg (Elaine) Student Folklore Fieldwork Project",orflr_1972_021.xml,80444/xv80227,9,4,0,13
"Alanis (Maria L.) Student Folklore Fieldwork Project",orflr_1974_111.xml,80444/xv84835,10,3,0,13
"Student Folklore Fieldwork Project",orflr_1973_348.xml,80444/xv05697,5,5,3,13
"Fenner (Lisa) Student Folklore Fieldwork Project",orflr_1982_124.xml,80444/xv27865,8,1,4,13
"Harding (Alyson) Student Folklore Fieldwork Project",orflr_2002_019.xml,80444/xv03176,1,5,7,13
"Carney (Christine M.) Student Folklore Fieldwork Project",orflr_1975_082.xml,80444/xv67892,12,0,0,12
"Armstrong (Margaret) Student Folklore Fieldwork Project",orflr_1970_099.xml,80444/xv58447,12,0,0,12
"Student Folklore Fieldwork Project",orflr_1973_316.xml,80444/xv57223,8,0,4,12
"Redpath (Carol) Student Folklore Fieldwork Project",orflr_1970_113.xml,80444/xv35049,9,3,0,12
"Student Folklore Fieldwork Project",orflr_1971_399.xml,80444/xv82299,8,4,0,12
"Lindsley (Wm.) Student Folklore Fieldwork Project",orflr_1986_027.xml,80444/xv94259,6,0,6,12
"Hitt (Christine) Student Folklore Fieldwork Project",orflr_1974_045.xml,80444/xv74630,10,0,2,12
"Anonymous Student Folklore Fieldwork Project",orflr_1969_056.xml,80444/xv91735,9,2,1,12
"Bauman (Mary) Student Folklore Fieldwork Project",orflr_1972_095.xml,80444/xv67840,3,4,5,12
"Spitzer (Sanferd) Student Folklore Fieldwork Project",orflr_1977_053.xml,80444/xv30752,5,0,7,12
"Wong (Abraham) Student Folklore Fieldwork Project",orflr_2003_023.xml,80444/xv78015,2,5,5,12
"Kao (Po-Hsin) Student Folklore Fieldwork Project",orflr_2012_087.xml,80444/xv71856,8,4,0,12
"Boyesen (Barbara) Student Folklore Fieldwork Project",orflr_1972_101.xml,80444/xv43167,9,0,3,12
"Pennell (Summer) Student Folklore Fieldwork Project",orflr_2008_045.xml,80444/xv54846,2,4,6,12
"Limbert (Patrick) Student Folklore Fieldwork Project",orflr_2006_036.xml,80444/xv57107,9,0,3,12
"Otto (Natalie) Student Folklore Fieldwork Project",orflr_2011_029.xml,80444/xv19866,5,5,1,11
"Erickson (Laura Jo) Student Folklore Fieldwork Project",orflr_1982_108.xml,80444/xv68273,8,1,2,11
"Gonzalez (Corina) Student Folklore Fieldwork Project",orflr_2008_195.xml,80444/xv82336,6,3,2,11
"Strobel (Laura) Student Folklore Fieldwork Project",orflr_1997_002.xml,80444/xv13583,0,4,7,11
"Turner (Maura) Student Folklore Fieldwork Project",orflr_2011_038.xml,80444/xv63226,10,1,0,11
"Hemphill (Carol) Student Folklore Fieldwork Project",orflr_1971_205.xml,80444/xv85568,5,1,5,11
"Novak (Judith) Student Folklore Fieldwork Project",orflr_1970_166.xml,80444/xv34317,1,1,9,11
"Johnson (Keith G.) Student Folklore Fieldwork Project",orflr_1977_144.xml,80444/xv56155,10,0,1,11
"Chambers (Lee) Student Folklore Fieldwork Project",orflr_1976_116.xml,80444/xv99597,11,0,0,11
"Erikson (Lois) Student Folklore Fieldwork Project",orflr_1973_037.xml,80444/xv39916,6,1,4,11
"Abrams (Joan) Student Folklore Fieldwork Project",orflr_1972_086.xml,80444/xv89544,5,2,4,11
"Student Folklore Fieldwork Project",orflr_1971_400.xml,80444/xv35083,8,3,0,11
"Anonymous Student Folklore Fieldwork Project",orflr_1971_005.xml,80444/xv32025,3,2,6,11
"Erickson (Mary) Student Folklore Fieldwork Project",orflr_2008_103.xml,80444/xv87841,11,0,0,11
"Berg (Jim) Student Folklore Fieldwork Project",orflr_1969_045.xml,80444/xv87579,9,0,2,11
"Delzell (Rebecca) Student Folklore Fieldwork Project",orflr_1991_033.xml,80444/xv65884,9,2,0,11
"Larson (Krista) Student Folklore Fieldwork Project",orflr_1971_295.xml,80444/xv16595,6,1,4,11
"Gregg (Catherine G.) Student Folklore Fieldwork Project",orflr_1981_024.xml,80444/xv69561,5,6,0,11
"Storey (Howard) Student Folklore Fieldwork Project",orflr_1979_008.xml,80444/xv83316,0,4,6,10
"Blanton (Aaron) Student Folklore Fieldwork Project",orflr_2011_006.xml,80444/xv91784,9,0,1,10
"Johnson (Mira) and Vrtis (Christy) Student Folklore Fieldwork Project",orflr_2009_006.xml,80444/xv42578,10,0,0,10
"Bentley (Alex) Student Folklore Fieldwork Project",orflr_2012_018.xml,80444/xv15103,7,0,3,10
"Meusey (Roberta) Student Folklore Fieldwork Project",orflr_1970_125.xml,80444/xv18835,9,1,0,10
"Anonymous Student Folklore Fieldwork Project",orflr_1971_167.xml,80444/xv74658,7,0,3,10
"Avey (Lynn) Student Folklore Fieldwork Project",orflr_1971_169.xml,80444/xv72900,8,1,1,10
"Crocker (Victoria) Student Folklore Fieldwork Project",orflr_2011_012.xml,80444/xv80142,1,4,5,10
"Kang (Valerie) Student Folklore Fieldwork Project",orflr_1972_043.xml,80444/xv72790,9,1,0,10
"Tompkins (Brian Joseph) Student Folklore Fieldwork Project",orflr_2011_035.xml,80444/xv16580,7,2,1,10
"Kawalczyk (Nancy) Student Folklore Fieldwork Project",orflr_2008_111.xml,80444/xv60726,10,0,0,10
"Student Folklore Fieldwork Project",orflr_1973_142.xml,80444/xv64004,8,0,2,10
"Robison (Brian) Student Folklore Fieldwork Project",orflr_1973_079.xml,80444/xv49783,10,0,0,10
"Kingston (Elizabeth) Student Folklore Fieldwork Project",orflr_1977_034.xml,80444/xv28900,10,0,0,10
"Anderson (Valerie) Student Folklore Fieldwork Project",orflr_1971_160.xml,80444/xv26736,8,1,1,10
"Zumwalt (Shelise) Student Folklore Fieldwork Project",orflr_2010_123.xml,80444/xv83419,0,7,3,10
"Hemphill (Rebecca J.) Student Folklore Fieldwork Project",orflr_1972_164.xml,80444/xv69610,10,0,0,10
"Holliday (Leigh) Student Folklore Fieldwork Project",orflr_2008_171.xml,80444/xv12106,8,0,2,10
"Miller (Francelia) Student Folklore Fieldwork Project",orflr_1985_034.xml,80444/xv28930,10,0,0,10
"Congdon (Kristin) Student Folklore Fieldwork Project",orflr_1981_015.xml,80444/xv38272,10,0,0,10
"Brown (Jordan) Student Folklore Fieldwork Project",orflr_2012_029.xml,80444/xv70132,8,2,0,10
"Couch (Becky A.) Student Folklore Fieldwork Project",orflr_1975_011.xml,80444/xv64056,8,1,0,9
"Kean (Robert Alan) Student Folklore Fieldwork Project",orflr_1976_147.xml,80444/xv97592,2,3,4,9
"Student Folklore Fieldwork Project",orflr_1973_219.xml,80444/xv54135,6,3,0,9
"Gehlert (Ann) Student Folklore Fieldwork Project",orflr_1972_115.xml,80444/xv19403,2,2,5,9
"Calhoun (Seabron) Student Folklore Fieldwork Project",orflr_1974_126.xml,80444/xv91854,9,0,0,9
"Stoican (Mary Ann) Student Folklore Fieldwork Project",orflr_1979_041.xml,80444/xv26239,8,0,1,9
"Troth (Nancy) Student Folklore Fieldwork Project",orflr_1971_092.xml,80444/xv70513,3,4,2,9
"Ufer (Sharon) Student Folklore Fieldwork Project",orflr_1970_118.xml,80444/xv16809,9,0,0,9
"Murray (Heidi) Student Folklore Fieldwork Project",orflr_1986_017.xml,80444/xv89907,3,2,4,9
"Pugh (William White Tison) Student Folklore Fieldwork Project",orflr_1996_006.xml,80444/xv11428,7,2,0,9
"Jones (Cheryl) Student Folklore Fieldwork Project",orflr_1974_153.xml,80444/xv01235,9,0,0,9
"Arnold (Nancy) Student Folklore Fieldwork Project",orflr_1991_034.xml,80444/xv87576,8,1,0,9
"Hartley (Edward) Student Folklore Fieldwork Project",orflr_1996_009.xml,80444/xv86413,9,0,0,9
"Mathis (Jennifer Walton) Student Folklore Fieldwork Project",orflr_1975_184.xml,80444/xv65713,8,0,1,9
"Anonymous Student Folklore Fieldwork Project",orflr_1969_043.xml,80444/xv86758,0,1,8,9
"Wollmuth (Jon C.) Student Folklore Fieldwork Project",orflr_1993_023.xml,80444/xv41644,9,0,0,9
"Hollowen (Douglas) Student Folklore Fieldwork Project",orflr_2008_038.xml,80444/xv94467,9,0,0,9
"Reini (Donna) Student Folklore Fieldwork Project",orflr_1976_072.xml,80444/xv74502,5,0,4,9
"Hazelwood (George) Student Folklore Fieldwork Project",orflr_1981_042.xml,80444/xv94647,9,0,0,9
"Hutchinson (Sarah M.) Student Folklore Fieldwork Project",orflr_2002_038.xml,80444/xv37759,9,0,0,9
"Bucher (Sam) Student Folklore Fieldwork Project",orflr_1988_023.xml,80444/xv63146,8,1,0,9
"Krowartz (Jackie) Student Folklore Fieldwork Project",orflr_1972_125.xml,80444/xv59841,7,2,0,9
"Crawford (J. E.) Student Folklore Fieldwork Project",orflr_1974_229.xml,80444/xv47277,9,0,0,9
"Woerner (Shannon) Student Folklore Fieldwork Project",orflr_2006_054.xml,80444/xv57852,7,0,2,9
"Anderson (Molly) Student Folklore Fieldwork Project",orflr_1986_001.xml,80444/xv28768,9,0,0,9
"Jankowski (Erica) Student Folklore Fieldwork Project",orflr_2002_061.xml,80444/xv84167,8,1,0,9
"Spinelli (Cynthia) Student Folklore Fieldwork Project",orflr_1974_036.xml,80444/xv68920,9,0,0,9
"Backer (John) Student Folklore Fieldwork Project",orflr_1982_101.xml,80444/xv29223,9,0,0,9
"Sher (M. Christine) Student Folklore Fieldwork Project",orflr_2002_089.xml,80444/xv41116,9,0,0,9
"Mikkelsen (Robert D.) Student Folklore Fieldwork Project",orflr_1972_048.xml,80444/xv08242,9,0,0,9
"Whitton (David) Student Folklore Fieldwork Project",orflr_2002_043.xml,80444/xv48657,8,0,0,8
"Cohen (Jil) Student Folklore Fieldwork Project",orflr_1979_028.xml,80444/xv68432,6,1,1,8
"Shanahan (Ariana) Student Folklore Fieldwork Project",orflr_2010_004.xml,80444/xv31143,0,0,8,8
"Alvarado (Karen) Student Folklore Fieldwork Project",orflr_1974_113.xml,80444/xv70245,0,7,1,8
"Goebel (Julie) Student Folklore Fieldwork Project",orflr_1976_015.xml,80444/xv22656,6,2,0,8
"Kao (David) Student Folklore Fieldwork Project",orflr_1981_025.xml,80444/xv48379,8,0,0,8
"Goodman (David) Student Folklore Fieldwork Project",orflr_2010_112.xml,80444/xv07626,6,2,0,8
"Cecile (Dana) Student Folklore Fieldwork Project",orflr_1985_047.xml,80444/xv10284,0,8,0,8
"Student Folklore Fieldwork Project",orflr_1973_118.xml,80444/xv75646,8,0,0,8
"Buck (Caleb) Student Folklore Fieldwork Project",orflr_2002_027.xml,80444/xv37207,8,0,0,8
"Frank (Lori Ann) Student Folklore Fieldwork Project",orflr_1977_153.xml,80444/xv67318,0,1,7,8
"Danielson (Linda L.) Student Folklore Fieldwork Project",orflr_1983_030.xml,80444/xv66046,4,4,0,8
"Christian (Tiffany) Student Folklore Fieldwork Project",orflr_2010_108.xml,80444/xv70584,7,0,1,8
"Sarbour (Mark) Student Folklore Fieldwork Project",orflr_1982_103.xml,80444/xv14263,8,0,0,8
"Student Folklore Fieldwork Project",orflr_1973_344.xml,80444/xv73455,8,0,0,8
"Golding (Luey) Student Folklore Fieldwork Project",orflr_1976_009.xml,80444/xv56170,8,0,0,8
"Eudy (Alexis) Student Folklore Fieldwork Project",orflr_2002_057.xml,80444/xv94317,6,0,2,8
"Student Folklore Fieldwork Project",orflr_1973_156.xml,80444/xv74737,8,0,0,8
"Faught (Rachel) Student Folklore Fieldwork Project",orflr_2011_017.xml,80444/xv95596,7,1,0,8
"Johnson (Richard Gene) Student Folklore Fieldwork Project",orflr_1974_068.xml,80444/xv85629,4,2,2,8
"Student Folklore Fieldwork Project",orflr_1973_124.xml,80444/xv67367,8,0,0,8
"Meng (Nancy) Student Folklore Fieldwork Project",orflr_1981_030.xml,80444/xv48428,6,0,2,8
"Schulz (Elke) Student Folklore Fieldwork Project",orflr_1986_019.xml,80444/xv59429,7,1,0,8
"Hallquist (Elaine) Student Folklore Fieldwork Project",orflr_1973_048.xml,80444/xv87188,8,0,0,8
"Schaeffer (Anne) Student Folklore Fieldwork Project",orflr_1974_180.xml,80444/xv77255,3,4,1,8
"Fox (Daniel M.) Student Folklore Fieldwork Project",orflr_1977_026.xml,80444/xv31796,8,0,0,8
"Arias (Yina) Student Folklore Fieldwork Project",orflr_2012_011.xml,80444/xv00329,0,0,8,8
"Pass (Sarah E.) Student Folklore Fieldwork Project",orflr_2006_037.xml,80444/xv69476,1,2,5,8
"Hopson (Randy) Student Folklore Fieldwork Project",orflr_1974_209.xml,80444/xv80749,0,1,7,8
"Hoder (Melinda) Student Folklore Fieldwork Project",orflr_1990_025.xml,80444/xv37182,0,3,5,8
"Shaumleffel (Virginia) Student Folklore Fieldwork Project",orflr_1981_036.xml,80444/xv54705,3,2,3,8
"Anonymous Student Folklore Fieldwork Project",orflr_1971_162.xml,80444/xv03686,3,3,2,8
"Student Folklore Fieldwork Project",orflr_1973_258.xml,80444/xv10153,8,0,0,8
"Brown (Rodney W.) Student Folklore Fieldwork Project",orflr_1978_003.xml,80444/xv78048,7,1,0,8
"Forrester (Cynthia) Student Folklore Fieldwork Project",orflr_1976_034.xml,80444/xv29321,6,0,2,8
"Rubio (Beatrice L.) Student Folklore Fieldwork Project",orflr_1982_095.xml,80444/xv43139,8,0,0,8
"Cable (Elizabeth Ann) Student Folklore Fieldwork Project",orflr_1987_005.xml,80444/xv09802,3,5,0,8
"Shaw (Matthew) Student Folklore Fieldwork Project",orflr_2010_061.xml,80444/xv86926,0,0,8,8
"McMinn (Peter) Student Folklore Fieldwork Project",orflr_1990_014.xml,80444/xv41070,1,3,4,8
"Bennett (Nancy) Student Folklore Fieldwork Project",orflr_1985_002.xml,80444/xv53646,8,0,0,8
"Saure (Susanne) Student Folklore Fieldwork Project",orflr_1983_009.xml,80444/xv01626,6,1,1,8
"Bates (Patrick) Student Folklore Fieldwork Project",orflr_2012_016.xml,80444/xv59582,8,0,0,8
"Christian (Tiffany) Folklore Terminal Project",orflr_2012_035.xml,80444/xv30490,2,4,2,8
"Rhea (Doris K.) Student Folklore Fieldwork Project",orflr_1985_039.xml,80444/xv63128,0,6,2,8
"Student Folklore Fieldwork Project",orflr_1972_011.xml,80444/xv68765,8,0,0,8
"Johnston (Jeri) Student Folklore Fieldwork Project",orflr_1975_133.xml,80444/xv08453,5,1,2,8
"Serling (Sandi) Student Folklore Fieldwork Project",orflr_1975_190.xml,80444/xv46691,7,0,0,7
"Wraith (Clayton) Student Folklore Fieldwork Project",orflr_2002_076.xml,80444/xv60821,7,0,0,7
"Baars (William A.) Student Folklore Fieldwork Project",orflr_1977_097.xml,80444/xv16574,6,0,1,7
"Ames (Alex) Student Folklore Fieldwork Project",orflr_2002_051.xml,80444/xv09442,2,0,5,7
"Manser (Paula) Student Folklore Fieldwork Project",orflr_1975_031.xml,80444/xv75103,3,2,2,7
"Came (Kirsten) Student Folklore Fieldwork Project",orflr_1991_006.xml,80444/xv28472,3,1,3,7
"Cushing (Caitlin) Student Folklore Fieldwork Project",orflr_2002_078.xml,80444/xv83306,6,1,0,7
"Mayer (Sheila) Student Folklore Fieldwork Project",orflr_1991_016.xml,80444/xv71380,4,3,0,7
"Student Folklore Fieldwork Project",orflr_1973_292.xml,80444/xv72729,4,2,1,7
"McKendry (Margaret) Student Folklore Fieldwork Project",orflr_1971_239.xml,80444/xv99377,0,3,4,7
"Hone (Kim) Student Folklore Fieldwork Project",orflr_1975_095.xml,80444/xv42953,3,1,3,7
"Peruzzo (James) Student Folklore Fieldwork Project",orflr_1990_024.xml,80444/xv51010,4,0,3,7
"Hendry (Christine) Student Folklore Fieldwork Project",orflr_1989_046.xml,80444/xv84924,6,1,0,7
"Owens (Cynthia) Student Folklore Fieldwork Project",orflr_1977_095.xml,80444/xv76431,7,0,0,7
"Jesberg (Elisabeth) Student Folklore Fieldwork Project",orflr_1974_248.xml,80444/xv70993,7,0,0,7
"Jencson (Linda) Student Folklore Fieldwork Project",orflr_1983_006.xml,80444/xv33132,7,0,0,7
"Wilson (Nicole) Student Folklore Fieldwork Project",orflr_2006_040.xml,80444/xv19378,0,0,7,7
"Hogg (Michelle) Student Folklore Fieldwork Project",orflr_1982_033.xml,80444/xv33264,0,7,0,7
"Hakanson (Sasha) Student Folklore Fieldwork Project",orflr_2008_139.xml,80444/xv03701,3,4,0,7
"Hansen (Cory L.) Student Folklore Fieldwork Project",orflr_1984_028.xml,80444/xv52487,7,0,0,7
"Student Folklore Fieldwork Project",orflr_1973_149.xml,80444/xv27551,2,2,3,7
"Havlitschka (Katia) Student Folklore Fieldwork Project",orflr_1983_005.xml,80444/xv94442,7,0,0,7
"Luciano (Jessica) Student Folklore Fieldwork Project",orflr_2004_009.xml,80444/xv22442,2,3,2,7
"Camp (Ian) Student Folklore Fieldwork Project",orflr_1990_006.xml,80444/xv64410,0,5,2,7
"Clopton (Lynn M.) Student Folklore Fieldwork Project",orflr_1975_009.xml,80444/xv72998,7,0,0,7
"Horton (Derek) Student Folklore Fieldwork Project",orflr_1989_021.xml,80444/xv59646,4,3,0,7
"Monda (Joseph Bruce) Student Folklore Fieldwork Project",orflr_1974_270.xml,80444/xv96847,7,0,0,7
"Kettner (Peter) Student Folklore Fieldwork Project",orflr_1993_022.xml,80444/xv02294,6,1,0,7
"Ashford (Karen) Student Folklore Fieldwork Project",orflr_1972_168.xml,80444/xv58700,2,1,4,7
"Weinert (Paul) Student Folklore Fieldwork Project",orflr_2006_030.xml,80444/xv92129,0,4,3,7
"Carr (Revell) Student Folklore Fieldwork Project",orflr_1996_021.xml,80444/xv86791,5,2,0,7
"McLaughlin (Patricia) Student Folklore Fieldwork Project",orflr_1981_048.xml,80444/xv08178,1,1,5,7
"Rothstein (Rosalynn) Student Folklore Fieldwork Project",orflr_2012_076.xml,80444/xv00222,7,0,0,7
"Cook (Kathryn A.) Student Folklore Fieldwork Project",orflr_1972_102.xml,80444/xv21923,7,0,0,7
"Student Folklore Fieldwork Project",orflr_1973_308.xml,80444/xv83212,7,0,0,7
"von Damm (Lia) Student Folklore Fieldwork Project",orflr_1996_010.xml,80444/xv44363,0,3,4,7
"Heuser (Betsy) Student Folklore Fieldwork Project",orflr_1982_112.xml,80444/xv22467,5,0,2,7
"Aus (Laurelin) Student Folklore Fieldwork Project",orflr_2012_013.xml,80444/xv11663,0,0,7,7
"Skade (Patricia) Student Folklore Fieldwork Project",orflr_1975_191.xml,80444/xv32357,7,0,0,7
"Dean (Kevin) Student Folklore Fieldwork Project",orflr_1980_049.xml,80444/xv95266,0,1,6,7
"Wampler (Dave) Student Folklore Fieldwork Project",orflr_1981_054.xml,80444/xv43145,2,2,3,7
"Gay (Peter) Student Folklore Fieldwork Project",orflr_1975_173.xml,80444/xv87432,2,2,3,7
"Douglass (Dennis R.) Student Folklore Fieldwork Project",orflr_1971_329.xml,80444/xv86132,0,0,7,7
"Anonymous Student Folklore Fieldwork Project",orflr_1971_165.xml,80444/xv09341,4,1,2,7
"Morse (Holly Diane) Student Folklore Fieldwork Project",orflr_1975_187.xml,80444/xv66040,0,7,0,7
"King (Nancy) Student Folklore Fieldwork Project",orflr_1971_217.xml,80444/xv85275,7,0,0,7
"Boyd (Nathanial) Student Folklore Fieldwork Project",orflr_2009_005.xml,80444/xv79873,5,0,2,7
"Student Folklore Fieldwork Project",orflr_1973_319.xml,80444/xv27798,7,0,0,7
"Azad (Zahra) Student Folklore Fieldwork Project",orflr_1974_213.xml,80444/xv89767,1,1,5,7
"James (Gypsy) Student Folklore Fieldwork Project",orflr_2012_081.xml,80444/xv96771,7,0,0,7
"Geary (Wendy) Student Folklore Fieldwork Project",orflr_1977_027.xml,80444/xv42910,1,3,3,7
"Johnson (Fletcher H.) Student Folklore Fieldwork Project",orflr_2002_066.xml,80444/xv51440,1,6,0,7
"Loomis (Christine) Student Folklore Fieldwork Project",orflr_1973_061.xml,80444/xv97720,4,1,2,7
"Smith (Regina) Student Folklore Fieldwork Project",orflr_1977_052.xml,80444/xv71652,7,0,0,7
"Ziegler (Andrea) Student Folklore Fieldwork Project",orflr_1989_034.xml,80444/xv49472,3,3,1,7
"Rouzie (Rebecca) Student Folklore Fieldwork Project",orflr_1974_318.xml,80444/xv95513,0,0,7,7
"Lande (Susanne) Student Folklore Fieldwork Project",orflr_1985_026.xml,80444/xv67208,0,0,7,7
"Bacon (Barbara) Student Folklore Fieldwork Project",orflr_1982_001.xml,80444/xv37469,0,4,3,7
"Berg (Elaine) Student Folklore Fieldwork Project",orflr_1972_098.xml,80444/xv03985,0,1,6,7
"Pattison (Michelle) Student Folklore Fieldwork Project",orflr_1984_021.xml,80444/xv45541,1,5,1,7
"Student Folklore Fieldwork Project",orflr_1973_354.xml,80444/xv52581,0,0,7,7
"Adams (Lisa) Student Folklore Fieldwork Project",orflr_2002_007.xml,80444/xv57104,3,0,4,7
"Student Folklore Fieldwork Project",orflr_1971_362.xml,80444/xv77947,6,0,0,6
"Bird (Amanda) Student Folklore Fieldwork Project",orflr_2005_004.xml,80444/xv57827,0,1,5,6
"Student Folklore Fieldwork Project",orflr_1973_350.xml,80444/xv93853,0,0,6,6
"Stepash (Ann) Student Folklore Fieldwork Project",orflr_1977_127.xml,80444/xv62884,6,0,0,6
"Bergstrom (Anna) Student Folklore Fieldwork Project",orflr_2012_019.xml,80444/xv01898,6,0,0,6
"Van Wagoner (Karen) Student Folklore Fieldwork Project",orflr_1976_086.xml,80444/xv73654,4,0,2,6
"Peterson (Daniel) Student Folklore Fieldwork Project",orflr_1975_198.xml,80444/xv44961,0,0,6,6
"Bebernitz (Eric) Student Folklore Fieldwork Project",orflr_2005_011.xml,80444/xv77783,6,0,0,6
"Fraim (Vanessa) Student Folklore Fieldwork Project",orflr_1976_017.xml,80444/xv46820,6,0,0,6
"Marsden (Samantha) Student Folklore Fieldwork Project",orflr_2008_061.xml,80444/xv28558,2,4,0,6
"Llewellyn (Diane) Student Folklore Fieldwork Project",orflr_1972_128.xml,80444/xv74676,1,3,2,6
"Anonymous Student Folklore Fieldwork Project",orflr_1981_004.xml,80444/xv08999,6,0,0,6
"Allen (Jennifer) Student Folklore Fieldwork Project",orflr_1974_112.xml,80444/xv66619,0,0,6,6
"Volger (Courtney) Student Folklore Fieldwork Project",orflr_2011_040.xml,80444/xv46008,0,0,6,6
"Student Folklore Fieldwork Project",orflr_1971_354.xml,80444/xv54837,6,0,0,6
"Hancock (Elizabeth) Student Folklore Fieldwork Project",orflr_2008_215.xml,80444/xv66452,6,0,0,6
"Fox (Molly) Student Folklore Fieldwork Project",orflr_1974_138.xml,80444/xv03158,6,0,0,6
"Munoz (Maureen) Student Folklore Fieldwork Project",orflr_1971_235.xml,80444/xv92443,2,3,1,6
"Sherwood (Sidney Anna) Student Folklore Fieldwork Project",orflr_1971_082.xml,80444/xv52664,2,4,0,6
"Hopkins (Louise) Student Folklore Fieldwork Project",orflr_1971_049.xml,80444/xv70779,6,0,0,6
"Wagar (Arlene) Student Folklore Fieldwork Project",orflr_1976_087.xml,80444/xv47427,6,0,0,6
"Ottosen (JoAnn) Student Folklore Fieldwork Project",orflr_1972_193.xml,80444/xv21630,6,0,0,6
"Strohmeyer (Karen) Student Folklore Fieldwork Project",orflr_1971_268.xml,80444/xv96817,5,0,1,6
"Goddard (Ann) Student Folklore Fieldwork Project",orflr_1975_175.xml,80444/xv27682,4,2,0,6
"Mithen (Wendy) Student Folklore Fieldwork Project",orflr_1976_059.xml,80444/xv96786,2,4,0,6
"Steinbach (Kyle) Student Folklore Fieldwork Project",orflr_2009_003.xml,80444/xv30551,0,0,6,6
"Nash (Victor Thomas) Folklore Thesis",orflr_1975_194.xml,80444/xv96972,4,2,0,6
"York (Ryan) Student Folklore Fieldwork Project",orflr_2004_006.xml,80444/xv76235,6,0,0,6
"Silver (Laura Gay) Student Folklore Fieldwork Project",orflr_1974_011.xml,80444/xv06787,0,0,6,6
"Loff (Sue) Student Folklore Fieldwork Project",orflr_1975_029.xml,80444/xv21719,5,1,0,6
"Yamashita-DeSantis (Zane) Student Folklore Fieldwork Project",orflr_2008_069.xml,80444/xv78414,6,0,0,6
"Harbick (Andrew) Student Folklore Fieldwork Project",orflr_2010_026.xml,80444/xv15643,6,0,0,6
"Supperstein (Brent) Student Folklore Fieldwork Project",orflr_1974_292.xml,80444/xv05154,6,0,0,6
"Kelly (Catalina) Student Folklore Fieldwork Project",orflr_2012_089.xml,80444/xv76904,4,0,2,6
"Shattuck (Jodie) Student Folklore Fieldwork Project",orflr_1971_264.xml,80444/xv16839,0,0,6,6
"Croll (Susan) Student Folklore Fieldwork Project",orflr_1981_017.xml,80444/xv96389,1,0,5,6
"Hoffman (Teresa) Student Folklore Fieldwork Project",orflr_1982_032.xml,80444/xv59054,6,0,0,6
"Nealey (Kathy) Student Folklore Fieldwork Project",orflr_0000_048.xml,80444/xv48342,1,0,5,6
"Skinner (Marcia) Student Folklore Fieldwork Project",orflr_1970_115.xml,80444/xv68130,1,0,5,6
"Reiter (Johnny) Student Folklore Fieldwork Project",orflr_2008_041.xml,80444/xv42453,4,0,2,6
"Wiltz (Sarah) Student Folklore Fieldwork Project",orflr_1980_011.xml,80444/xv76831,0,2,4,6
"Van Atta (Laurie) Student Folklore Fieldwork Project",orflr_1974_105.xml,80444/xv55972,0,4,2,6
"Schriver (Kristen) Student Folklore Fieldwork Project",orflr_1989_030.xml,80444/xv62866,0,2,4,6
"Wehling (Ruth) Student Folklore Fieldwork Project",orflr_1972_155.xml,80444/xv76190,5,0,1,6
"Anbar (Haitham) Student Folklore Fieldwork Project",orflr_2012_008.xml,80444/xv19470,6,0,0,6
"Hinsvark (Susan) Student Folklore Fieldwork Project",orflr_1984_048.xml,80444/xv32147,0,3,3,6
"Ford (Meghan) Student Folklore Fieldwork Project",orflr_2002_005.xml,80444/xv89117,1,1,4,6
"Schaudt (Brian) Student Folklore Fieldwork Project",orflr_2010_100.xml,80444/xv35675,6,0,0,6
"Anderson (Judith) Student Folklore Fieldwork Project",orflr_1971_139.xml,80444/xv97097,0,0,6,6
"Veum (Cynthia) Student Folklore Fieldwork Project",orflr_1992_028.xml,80444/xv76690,0,0,6,6
"Student Folklore Fieldwork Project",orflr_1973_309.xml,80444/xv50439,6,0,0,6
"Gilleran (Paul A.) Student Folklore Fieldwork Project",orflr_1975_018.xml,80444/xv07424,6,0,0,6
"Albright (Chris) Student Folklore Fieldwork Project",orflr_1972_087.xml,80444/xv39157,6,0,0,6
"Student Folklore Fieldwork Project",orflr_1971_391.xml,80444/xv03491,6,0,0,6
"Zumwalt (Shelise M.) Student Folklore Fieldwork Project",orflr_2008_031.xml,80444/xv49789,0,3,3,6
"Horwitz (Andrea) Student Folklore Fieldwork Project",orflr_1974_331.xml,80444/xv64556,2,0,4,6
"Emerson (Amelia) Student Folklore Fieldwork Project",orflr_1974_134.xml,80444/xv34017,0,1,5,6
"Wilson (Susan) Student Folklore Fieldwork Project",orflr_1974_301.xml,80444/xv73577,6,0,0,6
"Spain (Paul) Student Folklore Fieldwork Project",orflr_1977_126.xml,80444/xv17044,6,0,0,6
"Daws (Ann X.) Student Folklore Fieldwork Project",orflr_1971_032.xml,80444/xv37768,0,2,4,6
"Neill (Jim) Student Folklore Fieldwork Project",orflr_1976_064.xml,80444/xv43692,6,0,0,6
"Crisp (Alice) Student Folklore Fieldwork Project",orflr_1981_016.xml,80444/xv17965,2,3,1,6
"(Heinz) Nolan Student Folklore Fieldwork Project",orflr_2012_069.xml,80444/xv50540,0,1,5,6
"Jessup (Kathryn Orme) Student Folklore Fieldwork Project",orflr_1972_040.xml,80444/xv99383,1,0,5,6
"Heidemann (Debbie) Student Folklore Fieldwork Project",orflr_1974_038.xml,80444/xv14846,6,0,0,6
"Craig (Kathleen) Student Folklore Fieldwork Project",orflr_1972_084.xml,80444/xv18539,0,0,5,5
"Hartell (Amy) Student Folklore Fieldwork Project",orflr_2009_009.xml,80444/xv22546,5,0,0,5
"Dinsdale (Grace) Student Folklore Fieldwork Project",orflr_1975_013.xml,80444/xv77395,5,0,0,5
"Ryan (Susan E.) Student Folklore Fieldwork Project",orflr_1974_283.xml,80444/xv44055,0,0,5,5
"Guenzler (Bruce) Student Folklore Fieldwork Project",orflr_1987_021.xml,80444/xv52584,0,0,5,5
"Gornick (Barbara L.) Student Folklore Fieldwork Project",orflr_1971_335.xml,80444/xv68536,0,0,5,5
"Bentz (Lindsey) Student Folklore Fieldwork Project",orflr_2010_051.xml,80444/xv52737,0,0,5,5
"Danielson (Linda L.) Student Folklore Fieldwork Project",orflr_1984_060.xml,80444/xv51681,0,4,1,5
"Turnlund (Paige) Student Folklore Fieldwork Project",orflr_2011_039.xml,80444/xv03259,0,0,5,5
"Battista (Beau) Student Folklore Fieldwork Project",orflr_2012_017.xml,80444/xv24755,0,0,5,5
"Sroge (Roberta) Student Folklore Fieldwork Project",orflr_1974_108.xml,80444/xv21969,0,0,5,5
"Hayden (Sam) Student Folklore Fieldwork Project",orflr_2010_081.xml,80444/xv42736,2,0,3,5
"Hoyle (Rozy) Student Folklore Fieldwork Project",orflr_1977_031.xml,80444/xv88629,4,0,1,5
"Keeton (Kansas) Student Folklore Fieldwork Project",orflr_2010_103.xml,80444/xv21871,5,0,0,5
"Bonner (Shirley D.) Student Folklore Fieldwork Project",orflr_1974_122.xml,80444/xv54306,0,1,4,5
"Clopton (Lynn M.) Student Folklore Fieldwork Project",orflr_1975_008.xml,80444/xv25305,0,0,5,5
"Wright (S. Darlene) Student Folklore Fieldwork Project",orflr_1976_163.xml,80444/xv88235,0,0,5,5
"Marsocci (Raymond) Student Folklore Fieldwork Project",orflr_1988_010.xml,80444/xv98211,5,0,0,5
"Gulliver (William C.) Student Folklore Fieldwork Project",orflr_1972_079.xml,80444/xv13485,3,2,0,5
"Wong (Dale) and (Young) Arlo Student Folklore Fieldwork Project",orflr_1971_279.xml,80444/xv37063,3,1,1,5
"Ensminger (David) Folklore Terminal Project",orflr_2010_111.xml,80444/xv08810,1,0,4,5
"Bakken (Ryan) Student Folklore Fieldwork Project",orflr_2012_015.xml,80444/xv15335,1,0,4,5
"Poizat-Newcomb (Steve) Student Folklore Fieldwork Project",orflr_1995_002.xml,80444/xv16586,5,0,0,5
"Moe (Caitlyn) Student Folklore Fieldwork Project",orflr_2008_116.xml,80444/xv84063,5,0,0,5
"McKinley (Susan) Student Folklore Fieldwork Project",orflr_1972_137.xml,80444/xv38601,5,0,0,5
"Bernstein (Al) Student Folklore Fieldwork Project",orflr_1974_215.xml,80444/xv39172,0,0,5,5
"Durbin (Deborah J.) Student Folklore Fieldwork Project",orflr_1980_022.xml,80444/xv41131,0,0,5,5
"Gandee (Sarah) Student Folklore Fieldwork Project",orflr_1982_110.xml,80444/xv80215,2,1,2,5
"Jackson (Susan Dearborn) Student Folklore Fieldwork Project",orflr_2002_035.xml,80444/xv16912,1,1,3,5
"Demarest (Hannah) Student Folklore Fieldwork Project",orflr_2012_041.xml,80444/xv32208,0,0,5,5
"Krieger (Amanda) Student Folklore Fieldwork Project",orflr_2002_020.xml,80444/xv11618,3,0,2,5
"Sparkman (Teresa) Student Folklore Fieldwork Project",orflr_1974_287.xml,80444/xv87808,2,2,1,5
"Jacobs (David A.) Student Folklore Fieldwork Project",orflr_1987_026.xml,80444/xv52145,5,0,0,5
"Sparkman (Teresa) Student Folklore Fieldwork Project",orflr_1974_288.xml,80444/xv61141,1,1,3,5
"Student Folklore Fieldwork Project",orflr_1973_305.xml,80444/xv44384,0,1,4,5
"Braddock (George W.) Student Folklore Fieldwork Project",orflr_1976_004.xml,80444/xv07479,5,0,0,5
"Branch (Matthew) Student Folklore Fieldwork Project",orflr_2006_002.xml,80444/xv64724,1,4,0,5
"McCarl (Robert) Student Folklore Fieldwork Project",orflr_1969_052.xml,80444/xv23431,2,2,1,5
"Emlen (Lisa) Student Folklore Fieldwork Project",orflr_1984_045.xml,80444/xv04211,5,0,0,5
"Brammer (Shelby) Student Folklore Fieldwork Project",orflr_2010_029.xml,80444/xv16140,0,2,3,5
"Bartee (Paulette) Student Folklore Fieldwork Project",orflr_1971_319.xml,80444/xv81085,0,0,5,5
"Anderson (Alice Leavitt) Student Folklore Fieldwork Project",orflr_1971_316.xml,80444/xv98037,4,1,0,5
"Dunham (Michael) Student Folklore Fieldwork Project",orflr_1981_003.xml,80444/xv65982,0,0,5,5
"Stone (Elizabeth S.) Student Folklore Fieldwork Project",orflr_1997_005.xml,80444/xv32333,5,0,0,5
"Briggs (Kathleen) Student Folklore Fieldwork Project",orflr_1991_001.xml,80444/xv38839,2,3,0,5
"McIntosh (Brenda) Student Folklore Fieldwork Project",orflr_1977_116.xml,80444/xv26794,4,0,1,5
"Monson (Megan) Student Folklore Fieldwork Project",orflr_1980_061.xml,80444/xv69018,3,2,0,5
"Murto (Kenneth) Student Folklore Fieldwork Project",orflr_1972_049.xml,80444/xv61206,3,0,2,5
"Student Folklore Fieldwork Project",orflr_1973_165.xml,80444/xv79339,0,2,3,5
"Piller (Donn) Student Folklore Fieldwork Project",orflr_1972_140.xml,80444/xv36041,0,0,5,5
"Alhadeff (Janice) Student Folklore Fieldwork Project",orflr_1971_156.xml,80444/xv46057,5,0,0,5
"Kromer (Kenneth) Student Folklore Fieldwork Project",orflr_1981_026.xml,80444/xv83898,0,0,5,5
"Spalding (Joel) Student Folklore Fieldwork Project",orflr_1980_043.xml,80444/xv82452,5,0,0,5
"Houn (Wally) Student Folklore Fieldwork Project",orflr_1971_338.xml,80444/xv95455,0,0,5,5
"Radile (David M.) Student Folklore Fieldwork Project",orflr_1989_028.xml,80444/xv82287,0,0,5,5
"Coe (Timothy Charles) Student Folklore Fieldwork Project",orflr_1971_026.xml,80444/xv90155,0,0,5,5
"Overman (John M.) Student Folklore Fieldwork Project",orflr_1974_276.xml,80444/xv64581,1,1,3,5
"Smith (Cynthia) Student Folklore Fieldwork Project",orflr_1973_003.xml,80444/xv24890,5,0,0,5
"Cliff (Janet M.) Student Folklore Fieldwork Project",orflr_1981_014.xml,80444/xv34960,3,2,0,5
"Mattz (Mery) and Partsafas (Vici) Student Folklore Fieldwork Project",orflr_1972_131.xml,80444/xv14410,0,0,5,5
"Anderson (Joan) Student Folklore Fieldwork Project",orflr_1973_009.xml,80444/xv05874,5,0,0,5
"Branch (Matthew) Student Folklore Fieldwork Project",orflr_2005_012.xml,80444/xv65780,3,2,0,5
"Schmidt (Mark W.) Student Folklore Fieldwork Project",orflr_1972_197.xml,80444/xv93457,5,0,0,5
"Ward (Susan) Student Folklore Fieldwork Project",orflr_1975_155.xml,80444/xv60461,1,1,3,5
"Scheer (Stephen R.) Student Folklore Fieldwork Project",orflr_1974_181.xml,80444/xv49432,3,2,0,5
"Johnson (Juli) Student Folklore Fieldwork Project",orflr_1969_010.xml,80444/xv22415,4,1,0,5
"Apostolico (Carol Ann) Student Folklore Fieldwork Project",orflr_2006_014.xml,80444/xv37350,0,0,5,5
"Student Folklore Fieldwork Project",orflr_1973_343.xml,80444/xv40048,5,0,0,5
"Marr (Jane Annette) Student Folklore Fieldwork Project",orflr_1973_065.xml,80444/xv73504,0,4,1,5
"Roderick (Michael) Student Folklore Fieldwork Project",orflr_1993_013.xml,80444/xv84661,0,0,5,5
"Barager (Joann) Student Folklore Fieldwork Project",orflr_1982_102.xml,80444/xv58319,2,0,3,5
"Boucher (Gregory) Student Folklore Fieldwork Project",orflr_2008_164.xml,80444/xv03909,0,1,4,5
"Pair (Bob) Student Folklore Fieldwork Project",orflr_1977_118.xml,80444/xv77917,5,0,0,5
"Hughes (Donna) Student Folklore Fieldwork Project",orflr_1970_124.xml,80444/xv07125,5,0,0,5
"Black (Kathy) Student Folklore Fieldwork Project",orflr_1972_178.xml,80444/xv66390,0,0,5,5
"Gerards (Jan) Student Folklore Fieldwork Project",orflr_1977_139.xml,80444/xv36795,1,2,2,5
"Hanson (Richard J.) Student Folklore Fieldwork Project",orflr_1978_005.xml,80444/xv14392,0,0,5,5
"Mullins (Traci) Student Folklore Fieldwork Project",orflr_1981_031.xml,80444/xv29098,1,0,4,5
"Dietrich (Kira) Student Folklore Fieldwork Project",orflr_2011_015.xml,80444/xv55816,3,2,0,5
"Gallerneaux Brooks (Kristen) Folklore Thesis",orflr_2012_027.xml,80444/xv84417,0,1,4,5
"Hotchkiss (Jeffrey Adam) Student Folklore Fieldwork Project",orflr_2002_030.xml,80444/xv43902,1,1,3,5
"Reed (Vickey) Student Folklore Fieldwork Project",orflr_2002_052.xml,80444/xv02212,0,1,4,5
"Rose (Barry) Student Folklore Fieldwork Project",orflr_1972_058.xml,80444/xv85064,0,0,5,5
"Pakulak (Kay) Student Folklore Fieldwork Project",orflr_1970_111.xml,80444/xv46948,0,0,5,5
"Hook (Tom) Student Folklore Fieldwork Project",orflr_1973_051.xml,80444/xv84649,0,0,5,5
"Soeteber (Kimberly) Student Folklore Fieldwork Project",orflr_1988_017.xml,80444/xv79177,0,0,5,5
"Woodward (Rosemary) Student Folklore Fieldwork Project",orflr_2011_044.xml,80444/xv97073,2,1,2,5
"Barton (Cole) Student Folklore Fieldwork Project",orflr_2011_005.xml,80444/xv32522,5,0,0,5
"Halperin (Marcie) Student Folklore Fieldwork Project",orflr_1972_175.xml,80444/xv73336,5,0,0,5
"Curtis (Donald) Student Folklore Fieldwork Project",orflr_1974_230.xml,80444/xv57785,3,0,2,5
"Bauer (Pam L.) Student Folklore Fieldwork Project",orflr_1980_014.xml,80444/xv13824,1,0,4,5
"Student Folklore Fieldwork Project",orflr_1973_131.xml,80444/xv02557,5,0,0,5
"Bryant (Susan Belinda) Student Folklore Fieldwork Project",orflr_1977_020.xml,80444/xv38949,3,2,0,5
"Anonymous Student Folklore Fieldwork Project",orflr_1971_010.xml,80444/xv51422,0,0,5,5
"Malmberg (Don) Student Folklore Fieldwork Project",orflr_1974_164.xml,80444/xv45669,3,2,0,5
"Anonymous Student Folklore Fieldwork Project",orflr_1971_007.xml,80444/xv80325,5,0,0,5
"Goodman (Julie) Student Folklore Fieldwork Project",orflr_1972_176.xml,80444/xv33010,5,0,0,5
"Gowing (Gwendolyn W.) Student Folklore Fieldwork Project",orflr_1982_082.xml,80444/xv64508,3,0,2,5
"Reynolds (Brittney) Student Folklore Fieldwork Project",orflr_2011_030.xml,80444/xv68624,1,3,1,5
"Student Folklore Fieldwork Project",orflr_1973_263.xml,80444/xv74081,5,0,0,5
"McConnell (Carin) Student Folklore Fieldwork Project",orflr_1974_265.xml,80444/xv83786,0,0,5,5
"Hutson (Kim) Student Folklore Fieldwork Project",orflr_1992_014.xml,80444/xv47180,3,0,2,5
"Broetzmann (Michael) Student Folklore Fieldwork Project",orflr_2008_119.xml,80444/xv10293,2,0,3,5
"Clemen (Robin) Student Folklore Fieldwork Project",orflr_2011_011.xml,80444/xv30514,0,5,0,5
"Clifford (Karen) Student Folklore Fieldwork Project",orflr_1976_134.xml,80444/xv48721,0,2,3,5
"Insley (Chuck) Student Folklore Fieldwork Project",orflr_1972_038.xml,80444/xv75729,0,0,5,5
"Anderson (Heather) Student Folklore Fieldwork Project",orflr_1983_034b.xml,80444/xv36550,0,0,5,5
"Anonymous Student Folklore Fieldwork Project",orflr_0000_003.xml,80444/xv05014,5,0,0,5
"Ousterhout (Jean E.) Student Folklore Fieldwork Project",orflr_1974_275.xml,80444/xv85324,5,0,0,5
"Darnell (Meredith) Student Folklore Fieldwork Project",orflr_2012_040.xml,80444/xv17395,1,1,3,5
"Berg (Elaine) Student Folklore Fieldwork Project",orflr_1972_099.xml,80444/xv54644,4,0,0,4
"Havens (Richard) Student Folklore Fieldwork Project",orflr_1970_106.xml,80444/xv85894,0,0,4,4
"Anonymous Student Folklore Fieldwork Project",orflr_1979_002.xml,80444/xv95718,4,0,0,4
"Student Folklore Fieldwork Project",orflr_1973_116.xml,80444/xv19110,0,0,4,4
"Reinecker (Michael B.) Student Folklore Fieldwork Project",orflr_1976_071.xml,80444/xv33975,1,0,3,4
"Student Folklore Fieldwork Project",orflr_1973_307.xml,80444/xv16934,0,4,0,4
"Thompson (Jennifer) Student Folklore Fieldwork Project",orflr_2010_074.xml,80444/xv44180,0,0,4,4
"Bushey (Jan) Student Folklore Fieldwork Project",orflr_1975_168.xml,80444/xv44839,0,4,0,4
"Page (Kimball) Student Folklore Fieldwork Project",orflr_1971_115.xml,80444/xv20223,0,0,4,4
"Meney (Allan J.) Student Folklore Fieldwork Project",orflr_1976_104.xml,80444/xv66168,0,3,1,4
"Walls (Cheryl) Student Folklore Fieldwork Project",orflr_1979_022.xml,80444/xv84860,0,0,4,4
"Kellar (Barbara J.) Student Folklore Fieldwork Project",orflr_1978_014.xml,80444/xv50167,0,2,2,4
"Weinert (Paul) Student Folklore Fieldwork Project",orflr_2006_003.xml,80444/xv54260,0,3,1,4
"Chester (Katie) Student Folklore Fieldwork Project",orflr_1973_022.xml,80444/xv06030,3,1,0,4
"Helton-Gallagher (Chloe) Student Folklore Fieldwork Project",orflr_2004_011.xml,80444/xv31683,4,0,0,4
"Brunell (Helen) Student Folklore Fieldwork Project",orflr_1975_004.xml,80444/xv43130,4,0,0,4
"Boen (Jeffrey) Student Folklore Fieldwork Project",orflr_2010_091.xml,80444/xv95620,4,0,0,4
"Hogan (Donna) Student Folklore Fieldwork Project",orflr_1972_118.xml,80444/xv66510,0,0,4,4
"Hogan (Kevin) Student Folklore Fieldwork Project",orflr_1976_048.xml,80444/xv16592,4,0,0,4
"Taft (Cason) Student Folklore Fieldwork Project",orflr_2010_062.xml,80444/xv15420,4,0,0,4
"Denison (Judith) Student Folklore Fieldwork Project",orflr_1987_013.xml,80444/xv22012,4,0,0,4
"Oliveira (Colin) Student Folklore Fieldwork Project",orflr_2010_069.xml,80444/xv86553,2,1,1,4
"Zieloney (Ann) Student Folklore Fieldwork Project",orflr_1975_118.xml,80444/xv75476,0,0,4,4
"Callison (Kathie) Student Folklore Fieldwork Project",orflr_1971_325.xml,80444/xv07434,0,0,4,4
"Kempe (Lynnette Marie) Student Folklore Fieldwork Project",orflr_1976_052.xml,80444/xv89978,4,0,0,4
"Knox (Aubrea) Student Folklore Fieldwork Project",orflr_2008_007.xml,80444/xv51776,1,0,3,4
"Junkins (Maggie) Student Folklore Fieldwork Project",orflr_1978_012.xml,80444/xv19448,3,0,1,4
"Hall (Erle) Student Folklore Fieldwork Project",orflr_2000_001.xml,80444/xv16485,0,0,4,4
"Bostock (Cheryl) Student Folklore Fieldwork Project",orflr_1976_013.xml,80444/xv43218,1,2,1,4
"Johnson (Mark A.) Student Folklore Fieldwork Project",orflr_1980_058.xml,80444/xv92816,0,1,3,4
"Zosel (Catherine S.) Student Folklore Fieldwork Project",orflr_1974_095.xml,80444/xv13143,2,0,2,4
"Student Folklore Fieldwork Project",orflr_1972_009.xml,80444/xv13439,1,3,0,4
"Lusk (Rebecca) Student Folklore Fieldwork Project",orflr_2008_090.xml,80444/xv45794,1,3,0,4
"Berry (Beverly A.) Student Folklore Fieldwork Project",orflr_0000_007.xml,80444/xv39248,0,0,4,4
"Romer (Stephen) Student Folklore Fieldwork Project",orflr_1972_147.xml,80444/xv34109,4,0,0,4
"Annus (Marta) Student Folklore Fieldwork Project",orflr_1982_126.xml,80444/xv83920,4,0,0,4
"Valentine (Jerry R.) Student Folklore Fieldwork Project",orflr_1975_052.xml,80444/xv54437,0,0,4,4
"King (Nancy) Student Folklore Fieldwork Project",orflr_1971_057.xml,80444/xv57586,0,0,4,4
"Phillips (Cheryl Lynn) Student Folklore Fieldwork Project",orflr_1978_001.xml,80444/xv69866,1,3,0,4
"Carlson (Katherine Anne) Student Folklore Fieldwork Project",orflr_2008_064.xml,80444/xv50057,4,0,0,4
"Nielsen (Deborah) Student Folklore Fieldwork Project",orflr_1974_033.xml,80444/xv98294,0,4,0,4
"Eagle (Sioux V.H.) Student Folklore Fieldwork Project",orflr_1975_014.xml,80444/xv60812,0,0,4,4
"Hogberg (Linda) Student Folklore Fieldwork Project",orflr_1979_033.xml,80444/xv94085,0,4,0,4
"Anonymous Student Folklore Fieldwork Project",orflr_0000_001.xml,80444/xv28689,0,0,4,4
"Olson (Tristan) Student Folklore Fieldwork Project",orflr_2008_176.xml,80444/xv84335,3,1,0,4
"Feldmann (Justin) Student Folklore Fieldwork Project",orflr_2010_047.xml,80444/xv72949,3,0,1,4
"Hadley (Lynn) Student Folklore Fieldwork Project",orflr_1998_001.xml,80444/xv89981,0,4,0,4
"Denny (David) Student Folklore Fieldwork Project",orflr_1985_013.xml,80444/xv22381,4,0,0,4
"Allers (Nicolette) Student Folklore Fieldwork Project",orflr_2011_001.xml,80444/xv16110,4,0,0,4
"Coleman (Kari) Student Folklore Fieldwork Project",orflr_2010_052.xml,80444/xv77386,1,1,2,4
"Howlett (Kathleen) Student Folklore Fieldwork Project",orflr_1971_051.xml,80444/xv38424,2,1,1,4
"Tapp (John) Student Folklore Fieldwork Project",orflr_1976_157.xml,80444/xv16683,1,1,2,4
"Perry (Melissa) Student Folklore Fieldwork Project",orflr_1974_173.xml,80444/xv25064,0,0,4,4
"Polhemus (Wendy) Student Folklore Fieldwork Project",orflr_1974_204.xml,80444/xv17596,2,2,0,4
"Bostick (Chenoa) Student Folklore Fieldwork Project",orflr_2012_023.xml,80444/xv43399,4,0,0,4
"Freeman (Gail J.) Student Folklore Fieldwork Project",orflr_1991_013.xml,80444/xv22695,0,0,4,4
"Student Folklore Fieldwork Project",orflr_1971_352.xml,80444/xv77453,0,3,1,4
"Stull (Judy) Student Folklore Fieldwork Project",orflr_1971_269.xml,80444/xv90731,0,1,3,4
"Sullivan (Alana) Student Folklore Fieldwork Project",orflr_2006_038.xml,80444/xv80126,0,4,0,4
"Murillo (Jessica) Student Folklore Fieldwork Project",orflr_2008_135.xml,80444/xv32440,3,1,0,4
"Meader (Jennifer Faith) Student Folklore Fieldwork Project",orflr_1999_008.xml,80444/xv15182,3,0,1,4
"Nicholson (Carrie) Student Folklore Fieldwork Project",orflr_2008_108.xml,80444/xv61465,3,0,1,4
"Student Folklore Fieldwork Project",orflr_1972_016.xml,80444/xv56625,2,0,2,4
"Schmitt (Casey) Folklore Thesis",orflr_2008_114.xml,80444/xv51092,1,0,3,4
"McKenzie (Lucile I.) Student Folklore Fieldwork Project",orflr_1983_023.xml,80444/xv26135,0,0,4,4
"Lyle (Jack) Student Folklore Fieldwork Project",orflr_1971_226.xml,80444/xv22692,0,0,4,4
"Wagner (Alexandria) Student Folklore Fieldwork Project",orflr_2008_089.xml,80444/xv61416,0,0,4,4
"Chastain (Stephanie) Student Folklore Fieldwork Project",orflr_1989_015.xml,80444/xv85607,1,0,3,4
"Woodward (Florence) Student Folklore Fieldwork Project",orflr_1980_068.xml,80444/xv48971,0,1,3,4
"Garnier (Oliver) Student Folklore Fieldwork Project",orflr_2012_057.xml,80444/xv69747,2,0,2,4
"Student Folklore Fieldwork Project",orflr_1973_294.xml,80444/xv94717,1,0,3,4
"Lovik (John) Student Folklore Fieldwork Project",orflr_2008_029.xml,80444/xv93957,1,2,1,4
"Russillo (Gina) Student Folklore Fieldwork Project",orflr_2008_132.xml,80444/xv00100,2,0,2,4
"Anderson (Ian) Student Folklore Fieldwork Project",orflr_2012_009.xml,80444/xv96487,0,0,4,4
"Frevert (Katie) Student Folklore Fieldwork Project",orflr_1974_233.xml,80444/xv36935,4,0,0,4
"Lucht (Angela) Student Folklore Fieldwork Project",orflr_1989_022.xml,80444/xv22332,3,1,0,4
"Student Folklore Fieldwork Project",orflr_1973_176.xml,80444/xv28448,1,2,1,4
"Fullerton (Molly) Student Folklore Fieldwork Project",orflr_2011_019.xml,80444/xv00582,4,0,0,4
"Conrad (Allison) and McLean (Scot) Student Folklore Fieldwork Project",orflr_1974_330.xml,80444/xv47399,3,0,1,4
"Ross (Stephen) Student Folklore Fieldwork Project",orflr_2010_084.xml,80444/xv13577,0,0,4,4
"Anonymous Student Folklore Fieldwork Project",orflr_1972_088.xml,80444/xv09222,0,0,4,4
"Kraft (Wayne) Student Folklore Fieldwork Project",orflr_1972_124.xml,80444/xv67221,0,2,2,4
"Danielson (Linda L.) Student Folklore Fieldwork Project",orflr_1971_031.xml,80444/xv54763,0,0,4,4
"Anonymous Student Folklore Fieldwork Project",orflr_1989_040.xml,80444/xv59890,4,0,0,4
"Nelson (Diane) Student Folklore Fieldwork Project",orflr_1975_072.xml,80444/xv91421,0,0,4,4
"Richardson (Robin) Student Folklore Fieldwork Project",orflr_1972_146.xml,80444/xv38153,4,0,0,4
"Padgett (Rose) Student Folklore Fieldwork Project",orflr_2010_115.xml,80444/xv89367,0,3,1,4
"Smyth (Joyce) Student Folklore Fieldwork Project",orflr_1977_125.xml,80444/xv30548,1,3,0,4
"Rapp (Christy) Student Folklore Fieldwork Project",orflr_1991_018.xml,80444/xv41006,4,0,0,4
"Berkley (Jane) Student Folklore Fieldwork Project",orflr_1979_026.xml,80444/xv60974,3,1,0,4
"Simpson (John A.) Student Folklore Fieldwork Project",orflr_1984_053.xml,80444/xv83621,0,0,4,4
"Anonymous Student Folklore Fieldwork Project",orflr_1971_008.xml,80444/xv63867,4,0,0,4
"Coleman (Lionel) Student Folklore Fieldwork Project",orflr_1970_193.xml,80444/xv53625,0,1,3,4
"Hoffman (Elizabeth L.) Student Folklore Fieldwork Project",orflr_1991_039.xml,80444/xv98251,2,0,2,4
"Bennehoff (Bert W.) and Brooks (Diane C.) Student Folklore Fieldwork Project",orflr_1971_173.xml,80444/xv96176,4,0,0,4
"Stone (John S.) Student Folklore Fieldwork Project",orflr_1971_297.xml,80444/xv71295,0,4,0,4
"House (Seymour B.) Student Folklore Fieldwork Project",orflr_1975_023.xml,80444/xv90118,4,0,0,4
"Parkinson (Barbara) Student Folklore Fieldwork Project",orflr_1988_014.xml,80444/xv77490,3,1,0,4
"Halpert (Diana) Student Folklore Fieldwork Project",orflr_1987_023.xml,80444/xv77151,4,0,0,4
"Lowrie (John Arthur) Student Folklore Fieldwork Project",orflr_1980_033.xml,80444/xv94375,3,0,1,4
"Olson (Ted M.) Student Folklore Fieldwork Project",orflr_1974_313.xml,80444/xv30084,0,0,4,4
"Neeley (Kathy) Student Folklore Fieldwork Project",orflr_0000_054.xml,80444/xv67535,3,0,1,4
"Hewitt (Dana) Student Folklore Fieldwork Project",orflr_2010_044.xml,80444/xv60263,3,0,1,4
"Thanos (Karen) Student Folklore Fieldwork Project",orflr_1974_090.xml,80444/xv02239,0,0,4,4
"Januik (Michael) Student Folklore Fieldwork Project",orflr_1975_025.xml,80444/xv38629,0,0,4,4
"Logan (Jan) Student Folklore Fieldwork Project",orflr_1982_034.xml,80444/xv16259,0,0,4,4
"Briggs (Kathleen) Student Folklore Fieldwork Project",orflr_1992_022.xml,80444/xv09625,1,3,0,4
"Thomas (Elizabeth R.) Student Folklore Fieldwork Project",orflr_2003_009.xml,80444/xv50436,0,2,2,4
"Student Folklore Fieldwork Project",orflr_1973_346.xml,80444/xv52593,0,0,4,4
"Azad (Zahra) Student Folklore Fieldwork Project",orflr_1975_076.xml,80444/xv55426,0,2,2,4
"Exley (Barbara) Student Folklore Fieldwork Project",orflr_2012_050.xml,80444/xv03051,1,3,0,4
"Barry (Brian C.) Student Folklore Fieldwork Project",orflr_1977_018.xml,80444/xv82653,3,0,0,3
"Mendelson (Tamara Beth) Student Folklore Fieldwork Project",orflr_1979_037.xml,80444/xv15518,1,2,0,3
"Adams (Linda J.) Student Folklore Fieldwork Project",orflr_1970_137.xml,80444/xv80770,0,0,3,3
"Marquart (Leilani) Student Folklore Fieldwork Project",orflr_1972_167.xml,80444/xv94812,0,0,3,3
"McEldowney (Scott) Student Folklore Fieldwork Project",orflr_1976_063.xml,80444/xv81860,3,0,0,3
"Apfelbeck (Paul) Student Folklore Fieldwork Project",orflr_1985_001.xml,80444/xv50817,0,3,0,3
"Thornton (Peter) Student Folklore Fieldwork Project",orflr_1982_040.xml,80444/xv74938,0,0,3,3
"Davis-Larry (Sherisa) Student Folklore Fieldwork Project",orflr_2008_125.xml,80444/xv02038,0,2,1,3
"Dahlen (Nicholas) Student Folklore Fieldwork Project",orflr_2008_049.xml,80444/xv92422,0,2,1,3
"Fredrickson (Jan) Student Folklore Fieldwork Project",orflr_1969_009.xml,80444/xv63024,1,1,1,3
"Bruner (Reba) Student Folklore Fieldwork Project",orflr_1970_195.xml,80444/xv25256,0,2,1,3
"Lund (Jeanette) Student Folklore Fieldwork Project",orflr_1974_261.xml,80444/xv70294,0,3,0,3
"Biggs (Karen E.) Student Folklore Fieldwork Project",orflr_1977_019.xml,80444/xv32177,1,1,1,3
"Smith (Clayton Campbell) Student Folklore Fieldwork Project",orflr_1976_079.xml,80444/xv40393,3,0,0,3
"Hubbard (Anne Spencer) Student Folklore Fieldwork Project",orflr_1971_284.xml,80444/xv23519,0,0,3,3
"Student Folklore Fieldwork Project",orflr_1973_329.xml,80444/xv54989,2,1,0,3
"Stahr (Lorraine M.) Student Folklore Fieldwork Project",orflr_1976_126.xml,80444/xv49459,0,0,3,3
"Beggs (Sheila) Student Folklore Fieldwork Project",orflr_1988_002.xml,80444/xv51779,2,0,1,3
"Barnum (Sherryl) Student Folklore Fieldwork Project",orflr_1974_099.xml,80444/xv88778,3,0,0,3
"Davis (Deborah Darlene) Student Folklore Fieldwork Project",orflr_1977_006.xml,80444/xv82339,0,0,3,3
"Krauss (Margaret) Student Folklore Fieldwork Project",orflr_1977_110.xml,80444/xv54650,3,0,0,3
"Reed (Suzanne) Student Folklore Fieldwork Project",orflr_2010_117.xml,80444/xv95108,1,2,0,3
"Senate (Breanna J.) Student Folklore Fieldwork Project",orflr_2010_010.xml,80444/xv51943,0,0,3,3
"Minor (Alan J.) Student Folklore Fieldwork Project",orflr_1971_231.xml,80444/xv85458,1,0,2,3
"McComb (Janet) Student Folklore Fieldwork Project",orflr_1977_043.xml,80444/xv95608,0,0,3,3
"Daniel (Maia) Student Folklore Fieldwork Project",orflr_2008_157.xml,80444/xv79061,0,3,0,3
"Bending (David) Student Folklore Fieldwork Project",orflr_1976_024.xml,80444/xv98519,0,3,0,3
"Beavers (Lou Ella) Student Folklore Fieldwork Project",orflr_1974_016.xml,80444/xv57150,3,0,0,3
"Elliot (Kelsey) Student Folklore Fieldwork Project",orflr_2012_048.xml,80444/xv21200,0,0,3,3
"Wilson (Alisa) Student Folklore Fieldwork Project",orflr_1986_036.xml,80444/xv26416,2,1,0,3
"Filomeo (Ashleigh) Student Folklore Fieldwork Project",orflr_2002_091.xml,80444/xv41555,0,3,0,3
"Student Folklore Fieldwork Project",orflr_1971_346.xml,80444/xv82379,1,1,1,3
"Vik (Linda) Student Folklore Fieldwork Project",orflr_1991_020.xml,80444/xv70904,1,2,0,3
"Kirilov (Kalin Stanchev) Student Folklore Fieldwork Project",orflr_2003_028.xml,80444/xv62161,2,1,0,3
"Laport (Sarah) Student Folklore Fieldwork Project",orflr_2002_050.xml,80444/xv77505,2,0,1,3
"Rattenborg (Barbara) Student Folklore Fieldwork Project",orflr_1989_029.xml,80444/xv58697,0,0,3,3
"Rogers (Mallory) Student Folklore Fieldwork Project",orflr_2012_071.xml,80444/xv70239,1,1,1,3
"Rouzie (Rebecca) Student Folklore Fieldwork Project",orflr_1987_211.xml,80444/xv23504,3,0,0,3
"Daugherty (Judith) Student Folklore Fieldwork Project",orflr_1971_327.xml,80444/xv43630,0,0,3,3
"Chambers (Lee F.) Student Folklore Fieldwork Project",orflr_1976_117.xml,80444/xv99984,3,0,0,3
"Hosler (Jamie) Student Folklore Fieldwork Project",orflr_1986_034.xml,80444/xv58193,3,0,0,3
"Lichtenstein (Carol) Student Folklore Fieldwork Project",orflr_1994_009.xml,80444/xv17761,0,0,3,3
"Owens (Janet S.) Student Folklore Fieldwork Project",orflr_1973_074.xml,80444/xv86508,2,0,1,3
"Olds (Pam) Student Folklore Fieldwork Project",orflr_1974_074.xml,80444/xv56637,3,0,0,3
"Lyngdal (Paula) Student Folklore Fieldwork Project",orflr_1974_263.xml,80444/xv46939,3,0,0,3
"Schadegg (Denise) Student Folklore Fieldwork Project",orflr_1977_094.xml,80444/xv95541,3,0,0,3
"DuRocher (J.) Student Folklore Fieldwork Project",orflr_1991_011.xml,80444/xv55587,0,0,3,3
"Shipley (Geoff) Student Folklore Fieldwork Project",orflr_2002_083.xml,80444/xv72195,0,0,3,3
"Student Folklore Fieldwork Project",orflr_1971_369.xml,80444/xv50445,0,2,1,3
"Lindquist (Kristen) Student Folklore Fieldwork Project",orflr_1991_038.xml,80444/xv07180,1,0,2,3
"Anonymous Student Folklore Fieldwork Project",orflr_1982_045.xml,80444/xv11199,0,3,0,3
"Student Folklore Fieldwork Project",orflr_1973_155.xml,80444/xv67419,3,0,0,3
"Schewe (Eva) Student Folklore Fieldwork Project",orflr_2010_075.xml,80444/xv02078,1,1,1,3
"Anderson (Nancy E.) Student Folklore Fieldwork Project",orflr_1974_052.xml,80444/xv52392,0,3,0,3
"DeRoss (Clif) Student Folklore Fieldwork Project",orflr_2010_009.xml,80444/xv65298,3,0,0,3
"Bourget (William) Student Folklore Fieldwork Project",orflr_2012_024.xml,80444/xv36633,1,0,2,3
"Foster (Terry N.) Student Folklore Fieldwork Project",orflr_1972_031.xml,80444/xv56619,1,0,2,3
"Fidel (Steve) Student Folklore Fieldwork Project",orflr_1981_021.xml,80444/xv99911,1,0,2,3
"Donaldson (Alice) Student Folklore Fieldwork Project",orflr_1973_034.xml,80444/xv87463,1,1,1,3
"Leitz (Kari) Student Folklore Fieldwork Project",orflr_1977_038.xml,80444/xv99551,0,3,0,3
"Student Folklore Fieldwork Project",orflr_1971_375.xml,80444/xv47167,3,0,0,3
"Hatfield (Joseph) Student Folklore Fieldwork Project",orflr_2006_026.xml,80444/xv55926,3,0,0,3
"Lindsley (William) Student Folklore Fieldwork Project",orflr_1991_040.xml,80444/xv24380,0,2,1,3
"Student Folklore Fieldwork Project",orflr_1973_101.xml,80444/xv75469,0,2,1,3
"O'Dell (Diane) Student Folklore Fieldwork Project",orflr_1971_074.xml,80444/xv65985,0,3,0,3
"Student Folklore Fieldwork Project",orflr_1973_192.xml,80444/xv92935,1,1,1,3
"Zauner (Dave) Student Folklore Fieldwork Project",orflr_1984_038.xml,80444/xv31628,0,0,3,3
"Hildenbrand (Rebecca L.) Student Folklore Fieldwork Project",orflr_1971_337.xml,80444/xv67333,3,0,0,3
"Clark (Maleah) Student Folklore Fieldwork Project",orflr_1993_014.xml,80444/xv37277,0,0,3,3
"Saito (Jan) Student Folklore Fieldwork Project",orflr_1974_178.xml,80444/xv71783,0,1,2,3
"Cooney (Christopher) Student Folklore Fieldwork Project",orflr_1974_312.xml,80444/xv48135,0,2,1,3
"Sabin (Douglas E.) Student Folklore Fieldwork Project",orflr_1974_177.xml,80444/xv78765,0,0,3,3
"Dole (Jessica) Student Folklore Fieldwork Project",orflr_1973_033.xml,80444/xv02673,3,0,0,3
"Bowen (Kelsey) Student Folklore Fieldwork Project",orflr_2012_025.xml,80444/xv71530,1,0,2,3
"Fordham (Laura) Student Folklore Fieldwork Project",orflr_2012_056.xml,80444/xv15008,1,1,1,3
"Kohl (Mary B.) Student Folklore Fieldwork Project",orflr_1976_054.xml,80444/xv21545,0,3,0,3
"Wilkinson (Megan M.) Student Folklore Fieldwork Project",orflr_2002_054.xml,80444/xv11224,0,0,3,3
"Carlascio (Michael) Student Folklore Fieldwork Project",orflr_1975_005.xml,80444/xv76864,0,0,3,3
"Salladay (Victoria) Student Folklore Fieldwork Project",orflr_1970_128.xml,80444/xv12072,0,0,3,3
"Student Folklore Fieldwork Project",orflr_1971_389.xml,80444/xv76785,0,3,0,3
"Bailey (Lora) Student Folklore Fieldwork Project",orflr_2002_046.xml,80444/xv60717,3,0,0,3
"Totten (Kelley) Folklore Thesis",orflr_2010_113.xml,80444/xv70846,1,1,1,3
"Ikeda (Alain) Student Folklore Fieldwork Project",orflr_2012_078.xml,80444/xv60064,3,0,0,3
"Hoffman (Elizabeth) Student Folklore Fieldwork Project",orflr_1988_007.xml,80444/xv00314,0,0,3,3
"Garman (Mandy) Student Folklore Fieldwork Project",orflr_2003_013.xml,80444/xv64126,3,0,0,3
"Renner (Eric) Student Folklore Fieldwork Project",orflr_2004_020.xml,80444/xv34167,0,0,3,3
"Seumalo (Laneia) Student Folklore Fieldwork Project",orflr_2004_004.xml,80444/xv45590,0,1,2,3
"Hoyt (Emily) Student Folklore Fieldwork Project",orflr_2010_060.xml,80444/xv85125,0,1,2,3
"Ralphs (Nannette) Student Folklore Fieldwork Project",orflr_2010_007.xml,80444/xv02685,0,3,0,3
"Rolston (Edith) Student Folklore Fieldwork Project",orflr_1972_057.xml,80444/xv73318,0,0,3,3
"Jones (Suzi) Student Folklore Fieldwork Project",orflr_1972_122.xml,80444/xv12609,1,2,0,3
"Student Folklore Fieldwork Project",orflr_1973_106.xml,80444/xv11471,0,0,3,3
"Kane (Eric) Student Folklore Fieldwork Project",orflr_2010_066.xml,80444/xv87258,0,0,3,3
"Jorgensen (Karla) Student Folklore Fieldwork Project",orflr_1971_215.xml,80444/xv93218,3,0,0,3
"Hener (Stefan) Student Folklore Fieldwork Project",orflr_1988_006.xml,80444/xv78500,2,0,1,3
"Mills (Amy) Student Folklore Fieldwork Project",orflr_2001_001.xml,80444/xv87854,0,0,3,3
"Moore (Deborah Jane) Student Folklore Fieldwork Project",orflr_1974_271.xml,80444/xv53237,2,1,0,3
"Britton (Paul) Student Folklore Fieldwork Project",orflr_2008_033.xml,80444/xv72088,2,1,0,3
"Drake (Andy) Student Folklore Fieldwork Project",orflr_2011_016.xml,80444/xv94656,3,0,0,3
"Student Folklore Fieldwork Project",orflr_1973_226.xml,80444/xv75860,0,3,0,3
"Harrington (Teresa) Student Folklore Fieldwork Project",orflr_1995_004.xml,80444/xv93878,0,3,0,3
"Andujar (Michelle) Student Folklore Fieldwork Project",orflr_2012_010.xml,80444/xv71105,1,2,0,3
"McCleary (Amy) Student Folklore Fieldwork Project",orflr_1988_027.xml,80444/xv20217,0,0,3,3
"Keeler (Jill) Student Folklore Fieldwork Project",orflr_1980_059.xml,80444/xv41622,0,1,2,3
"Ray (Jenny Wickett) Student Folklore Fieldwork Project",orflr_1982_090.xml,80444/xv75698,1,0,2,3
"Kane (Marilyn) Student Folklore Fieldwork Project",orflr_1973_055.xml,80444/xv95852,1,2,0,3
"Linman (Jeffrey T.) Student Folklore Fieldwork Project",orflr_1977_113.xml,80444/xv08850,0,0,3,3
"Barclift (Angela Joy) Student Folklore Fieldwork Project",orflr_2010_086.xml,80444/xv50045,2,1,0,3
"Schmitt (Casey) Student Folklore Fieldwork Project",orflr_2008_115.xml,80444/xv71585,0,0,3,3
"Valenga (Marta E.) Student Folklore Fieldwork Project",orflr_1997_019.xml,80444/xv30557,3,0,0,3
"Otte (Martha) Student Folklore Fieldwork Project",orflr_1974_171.xml,80444/xv92163,1,0,2,3
"Student Folklore Fieldwork Project",orflr_1973_200.xml,80444/xv13174,3,0,0,3
"Laing (Stephanie) Student Folklore Fieldwork Project",orflr_1988_009.xml,80444/xv12091,0,1,2,3
"MacCormack (Linda) Student Folklore Fieldwork Project",orflr_1974_071.xml,80444/xv69857,0,3,0,3
"Avery (Tracy) Student Folklore Fieldwork Project",orflr_1975_067.xml,80444/xv09948,3,0,0,3
"Field (Gregory) Student Folklore Fieldwork Project",orflr_1975_172.xml,80444/xv02108,0,1,2,3
"Student Folklore Fieldwork Project",orflr_1971_357.xml,80444/xv65502,0,2,1,3
"Student Folklore Fieldwork Project",orflr_1973_236.xml,80444/xv35348,0,0,3,3
"Gilman (Lisa) Student Folklore Fieldwork Project",orflr_1991_002.xml,80444/xv45666,0,3,0,3
"Student Folklore Fieldwork Project",orflr_1973_197.xml,80444/xv69329,2,0,1,3
"Bahl (Anke) Student Folklore Fieldwork Project",orflr_1992_024.xml,80444/xv61129,0,3,0,3
"Hyland (Justin) Student Folklore Fieldwork Project",orflr_2002_008.xml,80444/xv65310,1,2,0,3
"Horgan (Margo) Student Folklore Fieldwork Project",orflr_1974_246.xml,80444/xv98458,3,0,0,3
"Fahey (Paula) Student Folklore Fieldwork Project",orflr_1980_025.xml,80444/xv29394,0,3,0,3
"Azad (Zahra) Student Folklore Fieldwork Project",orflr_1975_075.xml,80444/xv30978,1,1,1,3
"Student Folklore Fieldwork Project",orflr_1971_393.xml,80444/xv60382,0,0,3,3
"Hollowell (Kevin) Student Folklore Fieldwork Project",orflr_1977_030.xml,80444/xv80422,1,1,1,3
"Rust (Stephen) and Donnets (Olga) Student Folklore Fieldwork Project",orflr_2007_007.xml,80444/xv27075,3,0,0,3
"Lamb (Martha) Student Folklore Fieldwork Project",orflr_1977_111.xml,80444/xv87820,0,2,1,3
"Leavitt (Nancy B.) Student Folklore Fieldwork Project",orflr_1975_136.xml,80444/xv04074,3,0,0,3
"Webster (Dawn) Student Folklore Fieldwork Project",orflr_1975_117.xml,80444/xv27694,1,1,1,3
"Parkinson (Barbara) Student Folklore Fieldwork Project",orflr_1992_019.xml,80444/xv21621,0,1,2,3
"Bigelow (Michelle) Student Folklore Fieldwork Project",orflr_1991_036.xml,80444/xv22311,1,0,2,3
"Rico (Sabrina) Student Folklore Fieldwork Project",orflr_1976_075.xml,80444/xv53991,1,2,0,3
"Barnum (Alexander) Student Folklore Fieldwork Project",orflr_2008_117.xml,80444/xv99514,0,0,3,3
"Richardson (Jenny) Student Folklore Fieldwork Project",orflr_1973_077.xml,80444/xv26620,0,0,3,3
"Mikesell (Tamea) Student Folklore Fieldwork Project",orflr_1972_133.xml,80444/xv59390,0,1,2,3
"Selby (Brandy) Student Folklore Fieldwork Project",orflr_2010_080.xml,80444/xv45999,3,0,0,3
"Gonzales (Emilio) Student Folklore Fieldwork Project",orflr_2010_049.xml,80444/xv34411,0,3,0,3
"Carlstedt (Misha) Student Folklore Fieldwork Project",orflr_2002_053.xml,80444/xv66867,0,0,3,3
"Swindle (John) Student Folklore Fieldwork Project",orflr_1974_188.xml,80444/xv78686,3,0,0,3
"Daley (Mary Ellen) Student Folklore Fieldwork Project",orflr_1989_005.xml,80444/xv89910,1,2,0,3
"Twitty (Chris) Student Folklore Fieldwork Project",orflr_1974_193.xml,80444/xv65292,1,1,1,3
"Hills (Kenda) Student Folklore Fieldwork Project",orflr_1974_063.xml,80444/xv85830,0,0,3,3
"Maricle (Chelsea) Student Folklore Fieldwork Project",orflr_2002_060.xml,80444/xv07965,0,0,3,3
"Preble (Kipp) Student Folklore Fieldwork Project",orflr_1972_142.xml,80444/xv55706,0,0,3,3
"Rush (Nina) Student Folklore Fieldwork Project",orflr_2010_098.xml,80444/xv76879,1,0,2,3
"Clarke (Phoebe) and Lindquist (Diana) Student Folklore Fieldwork Project",orflr_1975_083.xml,80444/xv02969,0,2,1,3
"Klingenberg (Randy) Student Folklore Fieldwork Project",orflr_1977_035.xml,80444/xv58270,0,3,0,3
"Schnackenberg (Mike) Student Folklore Fieldwork Project",orflr_1981_052.xml,80444/xv29107,0,2,1,3
"Mack (Donovan L.) Student Folklore Fieldwork Project",orflr_1972_081.xml,80444/xv60711,3,0,0,3
"Agard (Carol) Student Folklore Fieldwork Project",orflr_1974_013.xml,80444/xv60519,0,3,0,3
"Earley (Laura) Student Folklore Fieldwork Project",orflr_1981_020.xml,80444/xv54824,3,0,0,3
"Stirling (Karon) Student Folklore Fieldwork Project",orflr_1977_005.xml,80444/xv68716,0,3,0,3
"Ayers (A. Grove) Student Folklore Fieldwork Project",orflr_1986_002.xml,80444/xv46197,0,1,2,3
"Doak (Deanne) Student Folklore Fieldwork Project",orflr_1977_025.xml,80444/xv22375,0,0,3,3
"Jackson (Susan) Student Folklore Fieldwork Project",orflr_1992_001.xml,80444/xv96661,3,0,0,3
"Fenwick (Lloyd J.) Student Folklore Fieldwork Project",orflr_1972_161.xml,80444/xv93423,3,0,0,3
"Student Folklore Fieldwork Project",orflr_1971_377.xml,80444/xv98153,0,1,2,3
"Dare (Jennifer K.) Student Folklore Fieldwork Project",orflr_2004_014.xml,80444/xv62396,1,2,0,3
"Lee (Jessica K.) Student Folklore Fieldwork Project",orflr_2008_001.xml,80444/xv30297,0,3,0,3
"Eskes (Nora) Student Folklore Fieldwork Project",orflr_1974_137.xml,80444/xv73446,0,0,3,3
"Cobb (Debbie) Student Folklore Fieldwork Project",orflr_1973_027.xml,80444/xv52130,1,2,0,3
"Proett (David M.) Student Folklore Fieldwork Project",orflr_1975_040.xml,80444/xv83822,0,1,2,3
"Poole (Deborah J.) Student Folklore Fieldwork Project",orflr_1984_022.xml,80444/xv20428,3,0,0,3
"O'Brien (Kathleen) Student Folklore Fieldwork Project",orflr_1976_065.xml,80444/xv58343,0,0,3,3
"Smiley (Barbara) Student Folklore Fieldwork Project",orflr_1975_046.xml,80444/xv75186,1,2,0,3
"Buckmister (Amanda) Student Folklore Fieldwork Project",orflr_2008_156.xml,80444/xv55136,3,0,0,3
"Wheatley (Raymond) Student Folklore Fieldwork Project",orflr_1984_037.xml,80444/xv47604,0,0,3,3
"Anonymous Student Folklore Fieldwork Project",orflr_1971_317.xml,80444/xv09506,0,0,3,3
"You (Ziying) Student Folklore Fieldwork Project",orflr_2008_058.xml,80444/xv69372,0,0,3,3
"Whitney (Elizabeth) Student Folklore Fieldwork Project",orflr_1982_119.xml,80444/xv07986,0,3,0,3
"Fields (Cody) Student Folklore Fieldwork Project",orflr_2010_020.xml,80444/xv25622,0,0,2,2
"Blomberg (Daniel) Student Folklore Fieldwork Project",orflr_1971_175.xml,80444/xv02279,0,1,1,2
"Shrock (John) Student Folklore Fieldwork Project",orflr_1973_083.xml,80444/xv18771,2,0,0,2
"Holten (Sue) Student Folklore Fieldwork Project",orflr_1976_144.xml,80444/xv26791,0,0,2,2
"Johnson (Richard Gene) Student Folklore Fieldwork Project",orflr_1974_152.xml,80444/xv97244,0,0,2,2
"Swarengin (Stephen M.) Student Folklore Fieldwork Project",orflr_1972_153.xml,80444/xv23730,0,0,2,2
"Bizzell (Rachel) Student Folklore Fieldwork Project",orflr_1990_005.xml,80444/xv22726,0,0,2,2
"Berkeley (Pepper Patricia) Student Folklore Fieldwork Project",orflr_1986_003.xml,80444/xv69952,0,0,2,2
"Cogswell (Megan) Student Folklore Fieldwork Project",orflr_1989_043.xml,80444/xv38150,1,1,0,2
"Student Folklore Fieldwork Project",orflr_1973_317.xml,80444/xv86599,0,0,2,2
"Armstrong (Julie) Student Folklore Fieldwork Project",orflr_1993_004.xml,80444/xv85382,2,0,0,2
"Student Folklore Fieldwork Project",orflr_1973_275.xml,80444/xv08013,1,0,1,2
"Weber (Christine) Student Folklore Fieldwork Project",orflr_1982_009.xml,80444/xv36764,2,0,0,2
"Fields (Leslie Leyland) Student Folklore Fieldwork Project",orflr_1984_046.xml,80444/xv36672,0,1,1,2
"Anonymous Student Folklore Fieldwork Project",orflr_2010_092.xml,80444/xv63696,0,2,0,2
"Student Folklore Fieldwork Project",orflr_1973_337.xml,80444/xv93243,0,0,2,2
"Widenhouse (Peggy) Student Folklore Fieldwork Project",orflr_1974_102.xml,80444/xv03836,0,0,2,2
"Hinman (Laura) Student Folklore Fieldwork Project",orflr_2010_005.xml,80444/xv95788,1,0,1,2
"Rea (Caley) Student Folklore Fieldwork Project",orflr_2008_153.xml,80444/xv20700,0,0,2,2
"Eidson (Gloria) Student Folklore Fieldwork Project",orflr_1980_004.xml,80444/xv95520,0,2,0,2
"Shafer (Sheila Noreen) Student Folklore Fieldwork Project",orflr_1980_066.xml,80444/xv61459,0,0,2,2
"Townsend (Corie L.) Student Folklore Fieldwork Project",orflr_2008_182.xml,80444/xv84411,0,0,2,2
"Stephens (Paul L.) Student Folklore Fieldwork Project",orflr_1970_130.xml,80444/xv75418,1,0,1,2
"Robbins (Chahaylie) Student Folklore Fieldwork Project",orflr_2010_057.xml,80444/xv37481,0,0,2,2
"Bax (Ryan) Student Folklore Fieldwork Project",orflr_2010_089.xml,80444/xv47967,0,1,1,2
"Chester (Ashleigh) Student Folklore Fieldwork Project",orflr_2002_081.xml,80444/xv12957,0,0,2,2
"Johnson (Kim) Student Folklore Fieldwork Project",orflr_2002_080.xml,80444/xv41564,0,0,2,2
"Student Folklore Fieldwork Project",orflr_1973_243.xml,80444/xv97058,0,2,0,2
"Crowell (Virginia) Student Folklore Fieldwork Project",orflr_1980_020.xml,80444/xv76715,0,0,2,2
"Busch (Anthony) Student Folklore Fieldwork Project",orflr_1973_019.xml,80444/xv10867,1,1,0,2
"Waldstein (Caroline) Student Folklore Fieldwork Project",orflr_1974_093.xml,80444/xv97982,0,0,2,2
"Arce (Ross) Student Folklore Fieldwork Project",orflr_2008_127.xml,80444/xv87847,2,0,0,2
"Stewart (Camille) Student Folklore Fieldwork Project",orflr_1977_128.xml,80444/xv12258,2,0,0,2
"Sargent (Kimberly) Student Folklore Fieldwork Project",orflr_1987_047.xml,80444/xv44277,1,0,1,2
"Student Folklore Fieldwork Project",orflr_1973_230.xml,80444/xv41561,2,0,0,2
"Student Folklore Fieldwork Project",orflr_1971_380.xml,80444/xv40060,2,0,0,2
"Anonymous Student Folklore Fieldwork Project",orflr_1973_011.xml,80444/xv05273,2,0,0,2
"Bell (Gary) Student Folklore Fieldwork Project",orflr_1972_097.xml,80444/xv56149,0,0,2,2
"Fisher (Bre) Student Folklore Fieldwork Project",orflr_1993_015.xml,80444/xv84750,0,2,0,2
"Bjornn (Bria Elizabeth) Student Folklore Fieldwork Project",orflr_2010_099.xml,80444/xv99499,2,0,0,2
"DeCourcey (Jeanne) Student Folklore Fieldwork Project",orflr_1970_101.xml,80444/xv50927,0,0,2,2
"Student Folklore Fieldwork Project",orflr_1973_143.xml,80444/xv74111,2,0,0,2
"Aaron (James K.) Student Folklore Fieldwork Project",orflr_1971_154.xml,80444/xv63986,0,0,2,2
"Howald (Heather) Student Folklore Fieldwork Project",orflr_2003_001.xml,80444/xv90899,0,2,0,2
"Glidden (Corey Michael) Student Folklore Fieldwork Project",orflr_2006_016.xml,80444/xv76342,1,1,0,2
"Schroeder (Lynn) Student Folklore Fieldwork Project",orflr_1978_016.xml,80444/xv79315,0,0,2,2
"Hubbard (Anne) Student Folklore Fieldwork Project",orflr_1971_148.xml,80444/xv15344,0,1,1,2
"Sprick (Carol) Student Folklore Fieldwork Project",orflr_1972_059.xml,80444/xv91302,0,0,2,2
"Mercer (Christy) Student Folklore Fieldwork Project",orflr_2002_063.xml,80444/xv56460,2,0,0,2
"Student Folklore Fieldwork Project",orflr_1973_257.xml,80444/xv48312,1,1,0,2
"McLaughlin (Patricia) Student Folklore Fieldwork Project",orflr_1988_024.xml,80444/xv29791,0,0,2,2
"Fairchild (Effie) and Westfall (Donald F.) Student Folklore Fieldwork Project",orflr_1970_102.xml,80444/xv49481,2,0,0,2
"McCaffrey (Richard) Student Folklore Fieldwork Project",orflr_1985_033.xml,80444/xv52719,0,1,1,2
"Yamahiro (Sara Kaye) Student Folklore Fieldwork Project",orflr_1980_012.xml,80444/xv37060,0,0,2,2
"Steele (Karen) Student Folklore Fieldwork Project",orflr_1972_151.xml,80444/xv73034,1,1,0,2
"Azad (Zahra) Student Folklore Fieldwork Project",orflr_1974_054.xml,80444/xv76940,1,1,0,2
"Smiley (Barbara) Student Folklore Fieldwork Project",orflr_1975_045.xml,80444/xv19976,0,2,0,2
"Hesselgrave (Jessica) Student Folklore Fieldwork Project",orflr_2008_081.xml,80444/xv71606,0,2,0,2
"Safranski (Mary E.) Student Folklore Fieldwork Project",orflr_1985_040.xml,80444/xv86953,0,0,2,2
"McDaniel (Nancy) Student Folklore Fieldwork Project",orflr_1974_266.xml,80444/xv97445,2,0,0,2
"Klass (Kayla) Student Folklore Fieldwork Project",orflr_1994_005.xml,80444/xv66369,2,0,0,2
"Cook (Paul Darwin) Student Folklore Fieldwork Project",orflr_1982_027.xml,80444/xv41061,0,2,0,2
"Jorgensen (John) Student Folklore Fieldwork Project",orflr_2012_085.xml,80444/xv22891,0,0,2,2
"Ahn (Glenda) Student Folklore Fieldwork Project",orflr_1984_010.xml,80444/xv57992,0,0,2,2
"Allen (Michael L.) Student Folklore Fieldwork Project",orflr_1980_013.xml,80444/xv20245,0,2,0,2
"Anonymous Student Folklore Fieldwork Project",orflr_1979_001.xml,80444/xv28506,0,0,2,2
"Anderson (Judith) Student Folklore Fieldwork Project",orflr_1971_301.xml,80444/xv15954,0,0,2,2
"Boehm (Thomas A.) Student Folklore Fieldwork Project",orflr_1971_322.xml,80444/xv46975,0,0,2,2
"Hedges (Madison) Student Folklore Fieldwork Project",orflr_2008_068.xml,80444/xv95169,2,0,0,2
"Mitchell (Thomas J.) Student Folklore Fieldwork Project",orflr_1974_210.xml,80444/xv44775,0,0,2,2
"Bucher (Sam) Student Folklore Fieldwork Project",orflr_1988_022.xml,80444/xv06964,0,2,0,2
"Steele (Karen) Student Folklore Fieldwork Project",orflr_1972_152.xml,80444/xv34426,0,0,2,2
"Nakajima (Setsuko) Student Folklore Fieldwork Project",orflr_1983_026.xml,80444/xv35372,0,1,1,2
"Student Folklore Fieldwork Project",orflr_1973_345.xml,80444/xv62524,2,0,0,2
"Wells (Janet) Student Folklore Fieldwork Project",orflr_1985_052.xml,80444/xv76669,0,0,2,2
"McCollum (Paul) Student Folklore Fieldwork Project",orflr_2002_082.xml,80444/xv94342,0,1,1,2
"Bostwick (Julia) Student Folklore Fieldwork Project",orflr_1975_081.xml,80444/xv60446,0,2,0,2
"Hand (Jonathan) Student Folklore Fieldwork Project",orflr_2002_026.xml,80444/xv90762,0,0,2,2
"Rookey (Helen) Student Folklore Fieldwork Project",orflr_1974_176.xml,80444/xv83425,0,0,2,2
"Student Folklore Fieldwork Project",orflr_1973_246.xml,80444/xv93399,0,2,0,2
"Student Folklore Fieldwork Project",orflr_1973_291.xml,80444/xv62280,0,2,0,2
"Young (Lynn) Student Folklore Fieldwork Project",orflr_1972_083.xml,80444/xv25344,0,0,2,2
"Rabun (Sheila) Student Folklore Fieldwork Project",orflr_2010_116a.xml,80444/xv03463,0,2,0,2
"Allegretto (Mary Ann) Student Folklore Fieldwork Project",orflr_1973_006.xml,80444/xv76770,2,0,0,2
"Ernst (Bill) Student Folklore Fieldwork Project",orflr_1974_135.xml,80444/xv42495,0,2,0,2
"LeFevre (Heather) Student Folklore Fieldwork Project",orflr_2008_140.xml,80444/xv05291,0,2,0,2
"Kesey (Caleb) Student Folklore Fieldwork Project",orflr_2012_091.xml,80444/xv85604,2,0,0,2
"Jones (Kristin) Student Folklore Fieldwork Project",orflr_2012_083.xml,80444/xv71084,0,0,2,2
"Joyce (Norma) Student Folklore Fieldwork Project",orflr_1976_145.xml,80444/xv10012,2,0,0,2
"Danowski (Tom) Student Folklore Fieldwork Project",orflr_1982_028.xml,80444/xv98422,1,0,1,2
"Enriquez (Agustin F.) Student Folklore Fieldwork Project",orflr_1975_171.xml,80444/xv57519,1,1,0,2
"Wilson (Theresa) Student Folklore Fieldwork Project",orflr_1975_057.xml,80444/xv90563,0,0,2,2
"Nakata (Nancy) Student Folklore Fieldwork Project",orflr_1970_052.xml,80444/xv57760,0,0,2,2
"Nicholson (Jeffrey D.) Student Folklore Fieldwork Project",orflr_1982_035.xml,80444/xv17376,2,0,0,2
"Rowe (Dale) Student Folklore Fieldwork Project",orflr_1974_282.xml,80444/xv94049,0,0,2,2
"Katzenmeyer (Desirhea) Student Folklore Fieldwork Project",orflr_2008_094.xml,80444/xv65274,2,0,0,2
"Manser (Paula) Student Folklore Fieldwork Project",orflr_1975_030.xml,80444/xv14389,2,0,0,2
"Read (Danette) Student Folklore Fieldwork Project",orflr_1987_043.xml,80444/xv80999,0,0,2,2
"Cluff (Marion Elizabeth) Student Folklore Fieldwork Project",orflr_1972_186.xml,80444/xv46386,0,0,2,2
"Reading (Joe) Student Folklore Fieldwork Project",orflr_1974_080.xml,80444/xv49569,0,0,2,2
"Merrill (Jamison) Student Folklore Fieldwork Project",orflr_2010_063.xml,80444/xv19021,0,0,2,2
"Lum (Jacqueline) Student Folklore Fieldwork Project",orflr_1981_046.xml,80444/xv36209,1,1,0,2
"Decker (Jeffrey L.) Student Folklore Fieldwork Project",orflr_1977_149.xml,80444/xv26840,0,2,0,2
"Pilorget (Dillon) Student Folklore Fieldwork Project",orflr_2010_095.xml,80444/xv17645,0,2,0,2
"Nash (Victor Thomas) Student Folklore Fieldwork Project",orflr_1970_127.xml,80444/xv95404,0,1,1,2
"Williams (Winston R.) Student Folklore Fieldwork Project",orflr_1977_151.xml,80444/xv42602,0,1,1,2
"Knapp (Mary) Student Folklore Fieldwork Project",orflr_1971_120.xml,80444/xv08468,0,0,2,2
"Savage (Sharon) Student Folklore Fieldwork Project",orflr_1974_104.xml,80444/xv65548,1,0,1,2
"Dierking (Sue) Student Folklore Fieldwork Project",orflr_1979_029.xml,80444/xv18652,0,0,2,2
"Adams (Susan) Student Folklore Fieldwork Project",orflr_1975_073.xml,80444/xv73239,2,0,0,2
"You (Ziying) Folklore Thesis",orflr_2009_002.xml,80444/xv97747,2,0,0,2
"Cooley (Sarah) Student Folklore Fieldwork Project",orflr_2002_062.xml,80444/xv97509,2,0,0,2
"Apperson (April) Student Folklore Fieldwork Project",orflr_1972_181.xml,80444/xv37326,0,1,1,2
"Neff (James) Student Folklore Fieldwork Project",orflr_1975_146.xml,80444/xv01339,2,0,0,2
"Mains (Todd) Student Folklore Fieldwork Project",orflr_1974_107.xml,80444/xv25381,1,0,1,2
"Lung (Julie) Student Folklore Fieldwork Project",orflr_1974_262.xml,80444/xv21289,2,0,0,2
"Parish (Steven M.) Student Folklore Fieldwork Project",orflr_1977_083.xml,80444/xv07940,2,0,0,2
"Dorritie (Daniel) Student Folklore Fieldwork Project",orflr_1972_108.xml,80444/xv31756,0,2,0,2
"Williamson (Samuel Hart) and Kontny (Sarah E.) Student Folklore Fieldwork Project",orflr_1977_008.xml,80444/xv88491,1,1,0,2
"Student Folklore Fieldwork Project",orflr_1973_172.xml,80444/xv79333,0,0,2,2
"Sather (Deborah) and Petre (Candace) Student Folklore Fieldwork Project",orflr_1972_149.xml,80444/xv72732,0,0,2,2
"Student Folklore Fieldwork Project",orflr_1973_260.xml,80444/xv63342,0,0,2,2
"Torrence (Alfred K.) Student Folklore Fieldwork Project",orflr_1976_085.xml,80444/xv82836,0,0,2,2
"Hoyt (Mike) Student Folklore Fieldwork Project",orflr_1974_247.xml,80444/xv31448,0,0,2,2
"Wright (Sonia) Student Folklore Fieldwork Project",orflr_1982_093.xml,80444/xv10974,1,1,0,2
"Spellman (Carol) Student Folklore Fieldwork Project",orflr_2002_092.xml,80444/xv94860,2,0,0,2
"Hatch (Rachel) Student Folklore Fieldwork Project",orflr_2010_056.xml,80444/xv57684,1,1,0,2
"Mills (John Mark) Student Folklore Fieldwork Project",orflr_1977_009.xml,80444/xv54190,0,0,2,2
"Christenson (Karen J.) Student Folklore Fieldwork Project",orflr_1974_223.xml,80444/xv40243,1,0,1,2
"Barry (Lois) Student Folklore Fieldwork Project",orflr_1974_116.xml,80444/xv54272,0,0,2,2
"Bassett (Judy) Student Folklore Fieldwork Project",orflr_1974_117.xml,80444/xv13427,2,0,0,2
"Abernathy (Lynn Ann) Student Folklore Fieldwork Project",orflr_1983_037.xml,80444/xv22998,0,2,0,2
"Adams (Dani) Student Folklore Fieldwork Project",orflr_2008_205.xml,80444/xv98260,2,0,0,2
"Park (William N.) Student Folklore Fieldwork Project",orflr_1972_053.xml,80444/xv01022,0,0,2,2
"Greene (John) Student Folklore Fieldwork Project",orflr_1977_075.xml,80444/xv54370,0,2,0,2
"Anonymous Student Folklore Fieldwork Project",orflr_1971_302.xml,80444/xv63262,0,2,0,2
"Azad (Zahra) Student Folklore Fieldwork Project",orflr_1974_014.xml,80444/xv78778,1,1,0,2
"Lindsey (Peter) Student Folklore Fieldwork Project",orflr_1971_062.xml,80444/xv19302,1,0,1,2
"Ishibashi (Dane Yoshio) Student Folklore Fieldwork Project",orflr_2008_143.xml,80444/xv41140,0,2,0,2
"Student Folklore Fieldwork Project",orflr_1973_163.xml,80444/xv69818,0,0,2,2
"Toohey (Stephanie) Student Folklore Fieldwork Project",orflr_1988_018.xml,80444/xv69839,0,0,2,2
"Bow (James) Student Folklore Fieldwork Project",orflr_1971_019.xml,80444/xv59359,2,0,0,2
"Abele (Deborah) Student Folklore Fieldwork Project",orflr_1982_003.xml,80444/xv07492,2,0,0,2
"Kleiner (Judith L.) Student Folklore Fieldwork Project",orflr_1973_056.xml,80444/xv81390,0,2,0,2
"Boyes (Michael) Student Folklore Fieldwork Project",orflr_1974_124.xml,80444/xv14932,0,1,1,2
"Gallerneaux Brooks (Kristen) Student Folklore Fieldwork Project",orflr_2010_126.xml,80444/xv93688,0,0,2,2
"Dewey (Claire) Student Folklore Fieldwork Project",orflr_2008_076.xml,80444/xv17214,1,0,1,2
"Burn (George) Student Folklore Fieldwork Project",orflr_1972_024.xml,80444/xv67968,0,2,0,2
"Student Folklore Fieldwork Project",orflr_1973_298.xml,80444/xv82058,0,2,0,2
"Baum (Cassandra) Student Folklore Fieldwork Project",orflr_2008_147.xml,80444/xv20721,0,0,2,2
"Holmer (Monica) Student Folklore Fieldwork Project",orflr_2010_027.xml,80444/xv63195,2,0,0,2
"Kephart (Robin) Student Folklore Fieldwork Project",orflr_1974_250.xml,80444/xv33456,1,0,1,2
"Ritter (Karla) Student Folklore Fieldwork Project",orflr_1981_049.xml,80444/xv51193,1,1,0,2
"Jackson (Nancy) Student Folklore Fieldwork Project",orflr_1982_121.xml,80444/xv34539,0,0,2,2
"Bock (Laura) Student Folklore Fieldwork Project",orflr_0000_008.xml,80444/xv07800,1,0,1,2
"Jernstedt (Meredith) Student Folklore Fieldwork Project",orflr_1975_066.xml,80444/xv63647,0,0,2,2
"Thompson (Alex) Student Folklore Fieldwork Project",orflr_2008_141.xml,80444/xv28601,0,0,2,2
"Weatherly (Michelle) Student Folklore Fieldwork Project",orflr_1977_136.xml,80444/xv19949,0,2,0,2
"Seeley (Margaret) Student Folklore Fieldwork Project",orflr_1978_011.xml,80444/xv34454,0,2,0,2
"Leslie (Hannah) Student Folklore Fieldwork Project",orflr_2012_100.xml,80444/xv08798,0,2,0,2
"Booth (Jeanette) Student Folklore Fieldwork Project",orflr_1971_177.xml,80444/xv68908,1,1,0,2
"Gabriel (Daphne) Student Folklore Fieldwork Project",orflr_2001_008.xml,80444/xv61132,1,0,1,2
"Ingram (Elwanda Deloris) Student Folklore Fieldwork Project",orflr_1976_112.xml,80444/xv36663,0,1,1,2
"Student Folklore Fieldwork Project",orflr_1973_300.xml,80444/xv72549,1,0,1,2
"Bachmann (Krista) Student Folklore Fieldwork Project",orflr_2008_165.xml,80444/xv68191,2,0,0,2
"DeMoll (Christie) Student Folklore Fieldwork Project",orflr_1974_231.xml,80444/xv59402,0,0,2,2
"Farr (Gail) Student Folklore Fieldwork Project",orflr_1972_159.xml,80444/xv90679,1,1,0,2
"Barry (Sheramy Nell) Student Folklore Fieldwork Project",orflr_1975_079.xml,80444/xv01007,0,0,2,2
"Fax (David) Student Folklore Fieldwork Project",orflr_1999_006.xml,80444/xv23233,0,2,0,2
"Loeb (Deborah) Student Folklore Fieldwork Project",orflr_1987_031.xml,80444/xv29357,0,1,1,2
"Dolan (Katherine) Student Folklore Fieldwork Project",orflr_2008_209.xml,80444/xv21267,0,2,0,2
"Hall (Janie) and Shaw (Janice) Student Folklore Fieldwork Project",orflr_1974_326.xml,80444/xv09112,0,2,0,2
"Bahm (Doyle A.) Student Folklore Fieldwork Project",orflr_1974_115.xml,80444/xv99884,0,0,2,2
"Knox (Carol) Student Folklore Fieldwork Project",orflr_1977_036.xml,80444/xv22305,1,1,0,2
"Hafer (Barbara) Student Folklore Fieldwork Project",orflr_1974_241.xml,80444/xv04226,1,0,1,2
"Fiedler (Mary) Student Folklore Fieldwork Project",orflr_2004_001.xml,80444/xv95382,0,2,0,2
"Mead (Susan Annette) Student Folklore Fieldwork Project",orflr_1977_063.xml,80444/xv47500,0,2,0,2
"Student Folklore Fieldwork Project",orflr_1971_358.xml,80444/xv72628,0,0,2,2
"Lathrop (Suellyn) Student Folklore Fieldwork Project",orflr_1985_028.xml,80444/xv82971,0,0,2,2
"Paugh (Shirley) Student Folklore Fieldwork Project",orflr_1980_051.xml,80444/xv85903,0,0,2,2
"Bokich (Robb) Student Folklore Fieldwork Project",orflr_1974_017.xml,80444/xv03326,0,0,2,2
"Blatter (Edi Alfred) Student Folklore Fieldwork Project",orflr_1977_070.xml,80444/xv81982,2,0,0,2
"Pearce (Barb) Student Folklore Fieldwork Project",orflr_1974_076.xml,80444/xv95239,0,2,0,2
"Saichek (Lisa) Student Folklore Fieldwork Project",orflr_1978_009.xml,80444/xv85586,0,0,2,2
"Salihovic (Amra) Student Folklore Fieldwork Project",orflr_2008_189.xml,80444/xv70724,1,1,0,2
"Brown (Jonathan) Student Folklore Fieldwork Project",orflr_2012_030.xml,80444/xv24526,0,0,2,2
"Student Folklore Fieldwork Project",orflr_1975_154.xml,80444/xv26211,2,0,0,2
"Woodworth (Chelsea) Student Folklore Fieldwork Project",orflr_2010_048.xml,80444/xv29733,0,0,2,2
"Spiering (John A.) Student Folklore Fieldwork Project",orflr_1971_084.xml,80444/xv54470,0,0,2,2
"Student Folklore Fieldwork Project",orflr_1971_345.xml,80444/xv34616,1,1,0,2
"Wilson (Steve) Student Folklore Fieldwork Project",orflr_1971_105.xml,80444/xv52969,0,0,2,2
"Friedman (Jeff) Student Folklore Fieldwork Project",orflr_1979_004.xml,80444/xv61660,0,0,2,2
"Vanvalkenburgh (Jef) Student Folklore Fieldwork Project",orflr_1976_160.xml,80444/xv85430,2,0,0,2
"Currie (Keith) Student Folklore Fieldwork Project",orflr_1972_103.xml,80444/xv54016,0,0,2,2
"Linnertz (Duane) Student Folklore Fieldwork Project",orflr_1973_059.xml,80444/xv62084,0,1,1,2
"Student Folklore Fieldwork Project",orflr_1973_229.xml,80444/xv76696,0,0,2,2
"Gillan (Mary Meredith) Student Folklore Fieldwork Project",orflr_1974_141.xml,80444/xv64456,2,0,0,2
"Gillespie (David L.) Student Folklore Fieldwork Project",orflr_1975_126.xml,80444/xv35772,1,0,1,2
"Poizat-Newcomb (Steve) Student Folklore Fieldwork Project",orflr_1994_002.xml,80444/xv84637,0,0,2,2
"Lord (Lydia) Student Folklore Fieldwork Project",orflr_1977_004.xml,80444/xv70434,1,0,1,2
"Student Folklore Fieldwork Project",orflr_1972_008.xml,80444/xv30590,0,0,2,2
"Sipe (Melissa) Student Folklore Fieldwork Project",orflr_2008_032.xml,80444/xv09661,1,1,0,2
"Bowers (Jonathan O.) Student Folklore Fieldwork Project",orflr_2008_015.xml,80444/xv94967,0,2,0,2
"Wysong (Mary) Student Folklore Fieldwork Project",orflr_1973_098.xml,80444/xv39593,1,0,1,2
"Wimer (Stephanie) Student Folklore Fieldwork Project",orflr_1974_302.xml,80444/xv73156,1,0,1,2
"Kutay (Kurt) Student Folklore Fieldwork Project",orflr_1974_316.xml,80444/xv65374,0,2,0,2
"Youngmayr (Mary Jo) Student Folklore Fieldwork Project",orflr_1971_124.xml,80444/xv65994,2,0,0,2
"Graeney (Ellen M.) Student Folklore Fieldwork Project",orflr_2008_018.xml,80444/xv91860,2,0,0,2
"Thompson (Donald Eugene) Student Folklore Fieldwork Project",orflr_2008_113.xml,80444/xv67565,0,2,0,2
"Oliver (Madeline) Student Folklore Fieldwork Project",orflr_2008_187.xml,80444/xv31784,2,0,0,2
"Fortier (Alan) Student Folklore Fieldwork Project",orflr_1976_035.xml,80444/xv42282,1,1,0,2
"Winston (Harold Harry) Student Folklore Fieldwork Project",orflr_1976_089.xml,80444/xv39239,0,0,2,2
"Simons (Martin) Student Folklore Fieldwork Project",orflr_1974_087.xml,80444/xv39596,0,0,2,2
"Dobbs (Brian R.) Student Folklore Fieldwork Project",orflr_1975_085.xml,80444/xv60061,0,2,0,2
"Prentiss (Alexandra) Student Folklore Fieldwork Project",orflr_1971_077.xml,80444/xv55105,0,1,1,2
"Student Folklore Fieldwork Project",orflr_1973_190.xml,80444/xv26046,0,1,1,2
"Johnson (TeeDee B.) Student Folklore Fieldwork Project",orflr_1972_189.xml,80444/xv49035,0,0,2,2
"Nielsen (Debbie) Student Folklore Fieldwork Project",orflr_1983_008.xml,80444/xv16735,0,2,0,2
"Anonymous Student Folklore Fieldwork Project",orflr_1969_044.xml,80444/xv38430,0,0,2,2
"Putnam (Dawn) Student Folklore Fieldwork Project",orflr_1993_005.xml,80444/xv55261,0,2,0,2
"Dowell (Sara) Student Folklore Fieldwork Project",orflr_1976_031.xml,80444/xv83950,0,2,0,2
"Topkis (Karly) Student Folklore Fieldwork Project",orflr_2008_192.xml,80444/xv76461,0,2,0,2
"Horn (Greta) Student Folklore Fieldwork Project",orflr_1971_209.xml,80444/xv00762,2,0,0,2
"Student Folklore Fieldwork Project",orflr_1973_129.xml,80444/xv57778,0,2,0,2
"Student Folklore Fieldwork Project",orflr_1973_339.xml,80444/xv10522,0,2,0,2
"Murrell (Richard J.) Student Folklore Fieldwork Project",orflr_1978_015.xml,80444/xv14587,0,2,0,2
"Kropf (Rosemary) Student Folklore Fieldwork Project",orflr_1974_026.xml,80444/xv10800,0,2,0,2
"Beard (Lawrence) Student Folklore Fieldwork Project",orflr_1977_069.xml,80444/xv18072,1,1,0,2
"Sharp (Nora) Student Folklore Fieldwork Project",orflr_2008_210.xml,80444/xv89797,0,2,0,2
"Wrancy (Jan) Student Folklore Fieldwork Project",orflr_1976_092.xml,80444/xv82061,0,0,2,2
"Milkovich (Erica) Student Folklore Fieldwork Project",orflr_2005_008.xml,80444/xv84985,0,1,1,2
"Joy (Cathy) Student Folklore Fieldwork Project",orflr_1976_050.xml,80444/xv74798,1,0,1,2
"Safranski (Beth) Student Folklore Fieldwork Project",orflr_1989_010.xml,80444/xv05798,2,0,0,2
"Manville (Margaret) Student Folklore Fieldwork Project",orflr_1973_063.xml,80444/xv37258,2,0,0,2
"Bierly (Alec) Student Folklore Fieldwork Project",orflr_2010_028.xml,80444/xv09146,0,0,2,2
"Barrett (Stephanie) Student Folklore Fieldwork Project",orflr_1973_014.xml,80444/xv49008,0,0,2,2
"Swartz (Erin) Student Folklore Fieldwork Project",orflr_2011_033.xml,80444/xv20712,2,0,0,2
"Weatherly (Donna) Student Folklore Fieldwork Project",orflr_1975_157.xml,80444/xv16644,0,0,2,2
"Marden (Robert) Student Folklore Fieldwork Project",orflr_1973_064.xml,80444/xv72427,1,1,0,2
"Runckel (Christopher W.) Student Folklore Fieldwork Project",orflr_1972_148.xml,80444/xv56234,2,0,0,2
"Marker (Daniel) Student Folklore Fieldwork Project",orflr_2002_067.xml,80444/xv39804,0,0,2,2
"Arnesen (Jason) Student Folklore Fieldwork Project",orflr_2003_025.xml,80444/xv89114,0,2,0,2
"Gillette (Nancy) Student Folklore Fieldwork Project",orflr_1975_174.xml,80444/xv28677,0,0,2,2
"Ceciliani (Cole) Student Folklore Fieldwork Project",orflr_2012_032.xml,80444/xv01242,0,1,1,2
"Sloan (Valerie) Student Folklore Fieldwork Project",orflr_1980_009.xml,80444/xv23321,2,0,0,2
"Leo (Greg) Student Folklore Fieldwork Project",orflr_1972_165.xml,80444/xv71820,0,2,0,2
"Bently (Christine) Student Folklore Fieldwork Project",orflr_1973_015.xml,80444/xv94848,0,0,2,2
"Bowyer (Rhonda) Student Folklore Fieldwork Project",orflr_1972_100.xml,80444/xv93078,0,0,2,2
"White (Kimberly Ann Kennedy) Student Folklore Fieldwork Project",orflr_1997_018.xml,80444/xv86499,1,0,1,2
"Mayne (Marta J.) Student Folklore Fieldwork Project",orflr_1978_006.xml,80444/xv74612,0,0,2,2
"Anonymous Student Folklore Fieldwork Project",orflr_1984_006.xml,80444/xv11148,0,1,1,2
"Johnson (Greg) Student Folklore Fieldwork Project",orflr_1971_054.xml,80444/xv67086,0,0,2,2
"Kay (Christine) Student Folklore Fieldwork Project",orflr_1980_006.xml,80444/xv73291,0,0,2,2
"Haefliger (William C.) Student Folklore Fieldwork Project",orflr_1975_020.xml,80444/xv74157,2,0,0,2
"Student Folklore Fieldwork Project",orflr_1973_174.xml,80444/xv02639,0,2,0,2
"Nerenberg (Jon) Student Folklore Fieldwork Project",orflr_1977_159.xml,80444/xv13873,0,0,2,2
"Mock (Rita M.) Student Folklore Fieldwork Project",orflr_1976_109.xml,80444/xv16311,0,0,2,2
"Keller (Johanna) Student Folklore Fieldwork Project",orflr_1970_108.xml,80444/xv63140,0,2,0,2
"Mooney (F. Bentley III) Student Folklore Fieldwork Project",orflr_1982_088.xml,80444/xv57690,1,0,1,2
"Moore (Hannah B.) Student Folklore Fieldwork Project",orflr_2008_055.xml,80444/xv75958,0,0,2,2
"Siebert (Frederic) Student Folklore Fieldwork Project",orflr_1985_042.xml,80444/xv47955,2,0,0,2
"Korns (Charles) Student Folklore Fieldwork Project",orflr_1987_029.xml,80444/xv59985,0,0,2,2
"Morrell (Mark) Student Folklore Fieldwork Project",orflr_1971_127.xml,80444/xv03192,2,0,0,2
"Lafeman (Jan) Student Folklore Fieldwork Project",orflr_1984_017.xml,80444/xv16699,0,0,2,2
"Student Folklore Fieldwork Project",orflr_1972_012.xml,80444/xv24145,2,0,0,2
"Bohannon (Kimberly Marshall) Student Folklore Fieldwork Project",orflr_2004_022.xml,80444/xv64422,0,2,0,2
"Student Folklore Fieldwork Project",orflr_1971_396.xml,80444/xv08486,1,1,0,2
"Student Folklore Fieldwork Project",orflr_1973_262.xml,80444/xv95697,0,0,2,2
"Vincent (Patti) Student Folklore Fieldwork Project",orflr_1974_092.xml,80444/xv92492,1,0,1,2
"Guralnick (Dena M.) Student Folklore Fieldwork Project",orflr_2008_003.xml,80444/xv36581,0,2,0,2
"Wergeland (Kari) Student Folklore Fieldwork Project",orflr_1984_058.xml,80444/xv36453,0,1,1,2
"Kerr (Nat) Student Folklore Fieldwork Project",orflr_1974_251.xml,80444/xv62881,0,0,2,2
"Newton (Carol) Student Folklore Fieldwork Project",orflr_1977_013.xml,80444/xv72061,0,0,2,2
"Healy (Elise) Student Folklore Fieldwork Project",orflr_1977_029.xml,80444/xv36013,1,1,0,2
"Nichols (Peggy) Student Folklore Fieldwork Project",orflr_1972_051.xml,80444/xv36709,0,0,2,2
"Marx (Alice) Student Folklore Fieldwork Project",orflr_1991_028.xml,80444/xv43646,0,1,1,2
"Clawson (Riley) Student Folklore Fieldwork Project",orflr_2008_035.xml,80444/xv73922,0,0,2,2
"Eddins (Paul) Student Folklore Fieldwork Project",orflr_1980_057.xml,80444/xv29342,0,1,1,2
"Miranda (Felicia) Student Folklore Fieldwork Project",orflr_1974_269.xml,80444/xv90332,1,0,1,2
"Gates (Charlene) Student Folklore Fieldwork Project",orflr_1978_018.xml,80444/xv19036,0,1,1,2
"Student Folklore Fieldwork Project",orflr_1973_349.xml,80444/xv83038,2,0,0,2
"Estep (Susan) Student Folklore Fieldwork Project",orflr_1989_037.xml,80444/xv79913,2,0,0,2
"Moura (Joan) Student Folklore Fieldwork Project",orflr_1980_062.xml,80444/xv14691,2,0,0,2
"Slovenz (Madeline) Student Folklore Fieldwork Project",orflr_1985_055.xml,80444/xv21090,0,2,0,2
"Laney (Otis) Student Folklore Fieldwork Project",orflr_2010_059.xml,80444/xv06536,0,0,2,2
"DeMec (Anna) Student Folklore Fieldwork Project",orflr_2008_082.xml,80444/xv61151,0,0,2,2
"Bucknum (William) Student Folklore Fieldwork Project",orflr_2002_015.xml,80444/xv11801,0,2,0,2
"Lank (Ryan) Student Folklore Fieldwork Project",orflr_2012_097.xml,80444/xv42001,2,0,0,2
"Tenney (Barbara) Student Folklore Fieldwork Project",orflr_1976_082.xml,80444/xv15463,0,0,1,1
"Ennis (Laura) Student Folklore Fieldwork Project",orflr_1991_004.xml,80444/xv04019,1,0,0,1
"Bordelon (Suzanne) Student Folklore Fieldwork Project",orflr_1994_001.xml,80444/xv91363,0,1,0,1
"Mittendorf (Tom) Student Folklore Fieldwork Project",orflr_1976_105.xml,80444/xv19732,0,1,0,1
"Dean (Kevin) Student Folklore Fieldwork Project",orflr_1980_003.xml,80444/xv63549,0,0,1,1
"Anderson (Mary Jane) Student Folklore Fieldwork Project",orflr_1974_051.xml,80444/xv46054,0,0,1,1
"Hargreaves (Lena) Student Folklore Fieldwork Project",orflr_1986_011.xml,80444/xv29043,1,0,0,1
"Ficklin (Benjamin) Student Folklore Fieldwork Project",orflr_2011_018.xml,80444/xv83529,0,1,0,1
"Boak (John) Student Folklore Fieldwork Project",orflr_1974_217.xml,80444/xv19454,0,0,1,1
"Hoverter (Dick) Student Folklore Fieldwork Project",orflr_1974_064.xml,80444/xv89077,0,0,1,1
"Dorsey (Sabrina) Student Folklore Fieldwork Project",orflr_1979_030.xml,80444/xv89205,0,1,0,1
"Duhaime (Mary) Student Folklore Fieldwork Project",orflr_1975_163.xml,80444/xv68902,1,0,0,1
"Bent (Becky), Fairbanks (Joan), and Grobe (Valerie) Student Folklore Fieldwork Project",orflr_1971_017.xml,80444/xv93664,0,0,1,1
"Student Folklore Fieldwork Project",orflr_1973_363.xml,80444/xv15332,0,0,1,1
"Stanwood (John) Student Folklore Fieldwork Project",orflr_1974_324.xml,80444/xv56970,0,1,0,1
"Johansen (Carol) Student Folklore Fieldwork Project",orflr_1974_067.xml,80444/xv37677,1,0,0,1
"Losco (Rosanne A.) Student Folklore Fieldwork Project",orflr_1975_098.xml,80444/xv52026,0,1,0,1
"Wiskersham (Sara) Student Folklore Fieldwork Project",orflr_2011_042.xml,80444/xv87683,0,1,0,1
"Marple (Nick) Student Folklore Fieldwork Project",orflr_2003_015.xml,80444/xv93911,0,1,0,1
"Spooner (Valerie) Student Folklore Fieldwork Project",orflr_2010_040.xml,80444/xv38076,1,0,0,1
"Al-Muhaifeed (Noor) Student Folklore Fieldwork Project",orflr_2010_106.xml,80444/xv90313,0,0,1,1
"Hou (Xueyuan) Student Folklore Fieldwork Project",orflr_2008_037.xml,80444/xv84277,0,1,0,1
"Anonymous Student Folklore Fieldwork Project",orflr_1971_009.xml,80444/xv15679,0,1,0,1
"Woelbing (Annemieke) Student Folklore Fieldwork Project",orflr_2011_043.xml,80444/xv31533,0,0,1,1
"Student Folklore Fieldwork Project",orflr_1971_384.xml,80444/xv13418,0,1,0,1
"Gibbens (Rory) Student Folklore Fieldwork Project",orflr_2012_059.xml,80444/xv77038,0,1,0,1
"Arkin (Lisa C.) and Smith (Marian) Student Folklore Fieldwork Project",orflr_2002_037.xml,80444/xv97656,1,0,0,1
"Babcock (Christine) Student Folklore Fieldwork Project",orflr_1972_017.xml,80444/xv73233,0,0,1,1
"Musgrove (Rebecca) Student Folklore Fieldwork Project",orflr_1977_082.xml,80444/xv28326,0,1,0,1
"Conyers (Liana) Student Folklore Fieldwork Project",orflr_2012_036.xml,80444/xv41183,0,0,1,1
"Ericksen (Robert) Student Folklore Fieldwork Project",orflr_1987_016.xml,80444/xv42044,0,0,1,1
"McClellan (Megan) Student Folklore Fieldwork Project",orflr_2004_008.xml,80444/xv16027,0,1,0,1
"Lary (Amber) Student Folklore Fieldwork Project",orflr_2012_098.xml,80444/xv54559,0,0,1,1
"Knight (Tanis) Student Folklore Fieldwork Project",orflr_1975_135.xml,80444/xv59109,0,1,0,1
"Spohn (Andrew) Student Folklore Fieldwork Project",orflr_2006_034.xml,80444/xv55511,0,1,0,1
"Kropf (Joan) Student Folklore Fieldwork Project",orflr_1972_044.xml,80444/xv46749,1,0,0,1
"Student Folklore Fieldwork Project",orflr_1973_128.xml,80444/xv49877,0,0,1,1
"Northwest Folklore Symposium Student Folklore Fieldwork Project",orflr_1982_097.xml,80444/xv55978,0,0,1,1
"Hoder (Melinda) Student Folklore Fieldwork Project",orflr_1988_020.xml,80444/xv03939,0,0,1,1
"Loh (Rodney) Student Folklore Fieldwork Project",orflr_1985_031.xml,80444/xv51083,0,1,0,1
"Morris (DeAnna M.) Student Folklore Fieldwork Project",orflr_2008_043.xml,80444/xv81027,0,1,0,1
"Storey (Benjamin Ryan) Student Folklore Fieldwork Project",orflr_2004_005.xml,80444/xv71859,0,0,1,1
"Austin (Marty) Student Folklore Fieldwork Project",orflr_1971_012.xml,80444/xv40539,0,1,0,1
"Dunstan (Steve) Student Folklore Fieldwork Project",orflr_1971_149.xml,80444/xv16610,0,0,1,1
"Schmidt (Alix) Student Folklore Fieldwork Project",orflr_2006_044.xml,80444/xv03863,1,0,0,1
"Student Folklore Fieldwork Project",orflr_1973_126.xml,80444/xv58251,0,1,0,1
"Dong (Sally) Student Folklore Fieldwork Project",orflr_1974_232.xml,80444/xv56549,0,1,0,1
"Johnson (Thomas) Student Folklore Fieldwork Project",orflr_1980_029.xml,80444/xv54791,0,0,1,1
"Student Folklore Fieldwork Project",orflr_1973_139.xml,80444/xv47009,0,0,1,1
"Lockett (LaLita Annette) Student Folklore Fieldwork Project",orflr_1985_029.xml,80444/xv91720,1,0,0,1
"Notari (Giulia) Student Folklore Fieldwork Project",orflr_2008_177.xml,80444/xv48834,0,0,1,1
"Wallmark (Cathie) Student Folklore Fieldwork Project",orflr_1971_274.xml,80444/xv07836,1,0,0,1
"Pinto (Lucinda) Student Folklore Fieldwork Project",orflr_1974_328.xml,80444/xv36740,0,1,0,1
"Busby (Jennifer C.) Student Folklore Fieldwork Project",orflr_2008_040.xml,80444/xv48083,1,0,0,1
"Cochran (Ellen) Student Folklore Fieldwork Project",orflr_2008_019.xml,80444/xv68048,1,0,0,1
"Ale (Leroy) Student Folklore Fieldwork Project",orflr_1989_001.xml,80444/xv92279,0,0,1,1
"DeShincoe (Litany) Student Folklore Fieldwork Project",orflr_2012_043.xml,80444/xv90432,0,0,1,1
"Walt (Joan) Student Folklore Fieldwork Project",orflr_1973_093.xml,80444/xv65734,0,1,0,1
"Fritz (Ellen) Student Folklore Fieldwork Project",orflr_1971_141.xml,80444/xv21441,0,1,0,1
"Danner (Breena) Student Folklore Fieldwork Project",orflr_2012_039.xml,80444/xv78265,0,0,1,1
"Goss (Stu) Student Folklore Fieldwork Project",orflr_2008_044.xml,80444/xv12310,0,0,1,1
"Collins (Katherine) Student Folklore Fieldwork Project",orflr_2008_101.xml,80444/xv35842,0,1,0,1
"Haley (Ken) Student Folklore Fieldwork Project",orflr_1976_046.xml,80444/xv70761,0,1,0,1
"Wagner (James) Student Folklore Fieldwork Project",orflr_1971_098.xml,80444/xv87945,0,0,1,1
"Black (Tim) Student Folklore Fieldwork Project",orflr_1976_025.xml,80444/xv11358,0,0,1,1
"Soltman (Mary) Student Folklore Fieldwork Project",orflr_1974_185.xml,80444/xv22558,0,0,1,1
"Student Folklore Fieldwork Project",orflr_1973_188.xml,80444/xv85995,0,1,0,1
"Thorton (Tracy) Student Folklore Fieldwork Project",orflr_1998_030.xml,80444/xv39993,0,1,0,1
"Baker (Michael) Student Folklore Fieldwork Project",orflr_2010_064.xml,80444/xv96578,0,0,1,1
"Pollock (Jake) Student Folklore Fieldwork Project",orflr_2008_056.xml,80444/xv04614,1,0,0,1
"McChesney (Bill) Student Folklore Fieldwork Project",orflr_1981_027.xml,80444/xv33728,0,0,1,1
"Youngren (Mary Ann) Student Folklore Fieldwork Project",orflr_1971_290.xml,80444/xv04602,0,0,1,1
"Woodard (Cokey Ann) Student Folklore Fieldwork Project",orflr_1976_090.xml,80444/xv73513,0,0,1,1
"Tobiassen (Lane) Student Folklore Fieldwork Project",orflr_1984_056.xml,80444/xv34582,1,0,0,1
"Luke (Nicole) Student Folklore Fieldwork Project",orflr_2004_016.xml,80444/xv65661,1,0,0,1
"Student Folklore Fieldwork Project",orflr_1973_238.xml,80444/xv59445,0,1,0,1
"Thanos (Karen) Student Folklore Fieldwork Project",orflr_1975_113.xml,80444/xv52542,1,0,0,1
"Anhaltzer (Carrie L.) Student Folklore Fieldwork Project",orflr_1982_079.xml,80444/xv78927,0,0,1,1
"Ostrom (Karl) Student Folklore Fieldwork Project",orflr_1992_020.xml,80444/xv99255,0,0,1,1
"Plummer (Carol) Student Folklore Fieldwork Project",orflr_1971_076.xml,80444/xv25912,1,0,0,1
"Rasmussen (Cathy) Student Folklore Fieldwork Project",orflr_1977_119.xml,80444/xv66271,0,0,1,1
"Shoup (Becky) Student Folklore Fieldwork Project",orflr_1974_182.xml,80444/xv75048,0,1,0,1
"Stevenson (Gail) Student Folklore Fieldwork Project",orflr_2003_027.xml,80444/xv02883,0,1,0,1
"Currans (Elizabeth) Student Folklore Fieldwork Project",orflr_1998_004.xml,80444/xv23638,1,0,0,1
"Keizur (Julia Dawson) Student Folklore Fieldwork Project",orflr_1971_341.xml,80444/xv61492,0,0,1,1
"Schuck (Catherine) Student Folklore Fieldwork Project",orflr_1972_177.xml,80444/xv65786,0,1,0,1
"Bennett (Kelsey) Student Folklore Fieldwork Project",orflr_2010_033.xml,80444/xv19024,0,0,1,1
"Mallery (Stephen) Student Folklore Fieldwork Project",orflr_1982_116.xml,80444/xv35781,0,1,0,1
"Paddison (Dean) Student Folklore Fieldwork Project",orflr_1974_172.xml,80444/xv47100,0,0,1,1
"Drawhorn (Katy) Student Folklore Fieldwork Project",orflr_2012_044.xml,80444/xv54940,1,0,0,1
"McCaskill (Kenneth) Student Folklore Fieldwork Project",orflr_1974_264.xml,80444/xv63870,0,1,0,1
"Mihelic (Joseph) Student Folklore Fieldwork Project",orflr_2008_186.xml,80444/xv83267,0,1,0,1
"Koehler (Ruth B.) Student Folklore Fieldwork Project",orflr_1976_053.xml,80444/xv45123,0,1,0,1
"Wagman (Elaine) Student Folklore Fieldwork Project",orflr_1977_134.xml,80444/xv07955,0,0,1,1
"Meader (Jennifer F.) Student Folklore Fieldwork Project",orflr_1996_000.xml,80444/xv68176,0,1,0,1
"West (Linda) Student Folklore Fieldwork Project",orflr_1975_058.xml,80444/xv46688,0,0,1,1
"Schaake (Sally) Student Folklore Fieldwork Project",orflr_1974_084.xml,80444/xv03839,1,0,0,1
"Farris (Timothy) Student Folklore Fieldwork Project",orflr_1972_111.xml,80444/xv05511,1,0,0,1
"Hilton (Pamela) Student Folklore Fieldwork Project",orflr_1979_024.xml,80444/xv58273,0,0,1,1
"Berg (Andrea) Student Folklore Fieldwork Project",orflr_1976_095.xml,80444/xv54995,0,0,1,1
"Michaelson (Karen) Student Folklore Fieldwork Project",orflr_1989_009.xml,80444/xv97625,0,1,0,1
"McKinney (Shane Earl) Student Folklore Fieldwork Project",orflr_1997_009.xml,80444/xv08703,1,0,0,1
"Isenberg (Sara) Student Folklore Fieldwork Project",orflr_1974_150.xml,80444/xv08544,1,0,0,1
"Meaney (Mary Kay) Student Folklore Fieldwork Project",orflr_1975_100.xml,80444/xv71734,0,1,0,1
"Hanlon (Suzanne) Student Folklore Fieldwork Project",orflr_1982_031.xml,80444/xv04010,0,0,1,1
"Handke (Allison) Student Folklore Fieldwork Project",orflr_2008_199.xml,80444/xv11071,1,0,0,1
"Dugan (Christopher) Student Folklore Fieldwork Project",orflr_1982_030.xml,80444/xv47702,0,1,0,1
"Glazer (Peter Kendall) Student Folklore Fieldwork Project",orflr_1974_109.xml,80444/xv68621,0,0,1,1
"Weiner (Laura) Student Folklore Fieldwork Project",orflr_1981_055.xml,80444/xv53347,1,0,0,1
"Scruby (Lisa) Student Folklore Fieldwork Project",orflr_1984_024.xml,80444/xv52127,1,0,0,1
"Nelson (Erik P.) Student Folklore Fieldwork Project",orflr_1981_033.xml,80444/xv46978,0,0,1,1
"Daun (Garrett Taylor) Student Folklore Fieldwork Project",orflr_2006_010.xml,80444/xv75167,0,0,1,1
"Student Folklore Fieldwork Project",orflr_1973_328.xml,80444/xv33248,1,0,0,1
"Elvin (Katelyn Morgan) Student Folklore Fieldwork Project",orflr_2012_049.xml,80444/xv27517,1,0,0,1
"Acheson (Bruce) Student Folklore Fieldwork Project",orflr_1974_050.xml,80444/xv04467,0,0,1,1
"Nelson (Carlyle) Student Folklore Fieldwork Project",orflr_2008_214.xml,80444/xv17727,0,1,0,1
"Meyers (Sean) Student Folklore Fieldwork Project",orflr_1983_024.xml,80444/xv15710,1,0,0,1
"Hansen (Susan) Student Folklore Fieldwork Project",orflr_1970_104.xml,80444/xv81436,1,0,0,1
"Volz (Daniel) Student Folklore Fieldwork Project",orflr_1975_115.xml,80444/xv27444,1,0,0,1
"Schaub (Rick) Student Folklore Fieldwork Project",orflr_1975_108.xml,80444/xv42517,0,1,0,1
"Wellborn (Sherry) Student Folklore Fieldwork Project",orflr_1979_043.xml,80444/xv45458,0,0,1,1
"Danielson (Linda) Student Folklore Fieldwork Project",orflr_1984_003.xml,80444/xv45639,0,1,0,1
"Student Folklore Fieldwork Project",orflr_1973_222.xml,80444/xv85040,0,0,1,1
"Moore (Elizabeth) Student Folklore Fieldwork Project",orflr_1982_118.xml,80444/xv27737,0,0,1,1
"Spencer (Jennie) Student Folklore Fieldwork Project",orflr_1980_010.xml,80444/xv29330,0,1,0,1
"Addleson (Scott) Student Folklore Fieldwork Project",orflr_1991_008.xml,80444/xv04177,0,1,0,1
"Student Folklore Fieldwork Project",orflr_1973_274.xml,80444/xv67767,0,1,0,1
"Slocum (Terry L.) Student Folklore Fieldwork Project",orflr_1999_005.xml,80444/xv53384,1,0,0,1
"Feist (Paul) Student Folklore Fieldwork Project",orflr_1980_005.xml,80444/xv43142,0,1,0,1
"Hunt (Rahnee) Student Folklore Fieldwork Project",orflr_1971_052.xml,80444/xv21844,0,0,1,1
"Friend (Kathleen D.) Student Folklore Fieldwork Project",orflr_1981_023.xml,80444/xv77923,0,0,1,1
"Hager (Marilyn) Student Folklore Fieldwork Project",orflr_1975_129.xml,80444/xv53656,0,1,0,1
"Zee (Patricia) Student Folklore Fieldwork Project",orflr_1977_093.xml,80444/xv16073,1,0,0,1
"Fitz (Sinde) Student Folklore Fieldwork Project",orflr_1986_010.xml,80444/xv95889,0,0,1,1
"Wolf-Prusan (Noah) Student Folklore Fieldwork Project",orflr_2008_133.xml,80444/xv69842,0,1,0,1
"Krogh (Nancy) Student Folklore Fieldwork Project",orflr_1973_057.xml,80444/xv21957,1,0,0,1
"Terry (Liza) Student Folklore Fieldwork Project",orflr_1977_054.xml,80444/xv30270,1,0,0,1
"Keyes (Kimberly) Student Folklore Fieldwork Project",orflr_1985_025.xml,80444/xv22665,0,1,0,1
"Daniels (Darcy) Student Folklore Fieldwork Project",orflr_1985_007.xml,80444/xv02606,0,1,0,1
"van Keppel (Eric) Student Folklore Fieldwork Project",orflr_1985_051.xml,80444/xv33032,0,1,0,1
"Student Folklore Fieldwork Project",orflr_1973_167.xml,80444/xv93417,1,0,0,1
"Leigh (Jacquelyn) Student Folklore Fieldwork Project",orflr_1974_028.xml,80444/xv20401,1,0,0,1
"Foster (Shirley J.) Student Folklore Fieldwork Project",orflr_1972_114.xml,80444/xv46627,0,0,1,1
"Nielsen (Gordon) Student Folklore Fieldwork Project",orflr_1975_035.xml,80444/xv98233,0,1,0,1
"Student Folklore Fieldwork Project",orflr_1973_233.xml,80444/xv96823,0,1,0,1
"Sabin (Kathryn) Student Folklore Fieldwork Project",orflr_1980_039.xml,80444/xv12402,0,1,0,1
"Student Folklore Fieldwork Project",orflr_1973_194.xml,80444/xv89184,0,1,0,1
"James (Ronny Lee) Student Folklore Fieldwork Project",orflr_1973_052.xml,80444/xv53643,0,1,0,1
"Woodie (Megan) Student Folklore Fieldwork Project",orflr_2008_077.xml,80444/xv16113,0,0,1,1
"Villeneuve (Matt) Student Folklore Fieldwork Project",orflr_2010_016.xml,80444/xv22149,1,0,0,1
"McGeary (Malcolm) Student Folklore Fieldwork Project",orflr_2010_011.xml,80444/xv71383,0,0,1,1
"Mickey (Donald L.) Student Folklore Fieldwork Project",orflr_1971_229.xml,80444/xv91693,0,1,0,1
"Hammond (Rory) Student Folklore Fieldwork Project",orflr_1974_145.xml,80444/xv61480,0,0,1,1
"Duggan (Kara) Student Folklore Fieldwork Project",orflr_2012_045.xml,80444/xv41958,1,0,0,1
"Headlee (Sue) Student Folklore Fieldwork Project",orflr_1975_094.xml,80444/xv18399,0,1,0,1
"Gile (Angela) Student Folklore Fieldwork Project",orflr_2008_136.xml,80444/xv02435,0,1,0,1
"Fagan (Susan J.) Student Folklore Fieldwork Project",orflr_1979_023.xml,80444/xv66229,0,1,0,1
"Howie (Cory) Student Folklore Fieldwork Project",orflr_2012_075.xml,80444/xv92404,1,0,0,1
"Justus (Debra) Student Folklore Fieldwork Project",orflr_1975_062.xml,80444/xv72052,0,1,0,1
"Schutz (Kevin) Student Folklore Fieldwork Project",orflr_2002_025.xml,80444/xv69830,0,1,0,1
"Hand (Scott) Student Folklore Fieldwork Project",orflr_1971_125.xml,80444/xv00479,0,0,1,1
"Crim (Jody) Student Folklore Fieldwork Project",orflr_1974_311.xml,80444/xv07131,0,1,0,1
"Gaul (Jessica) Student Folklore Fieldwork Project",orflr_2008_138.xml,80444/xv93402,0,1,0,1
"Student Folklore Fieldwork Project",orflr_1973_270.xml,80444/xv19064,0,0,1,1
"Bentson (John E.) Student Folklore Fieldwork Project",orflr_1982_104.xml,80444/xv81427,0,0,1,1
"Yu (James) Student Folklore Fieldwork Project",orflr_1990_023.xml,80444/xv62960,1,0,0,1
"Stull (Judy) Student Folklore Fieldwork Project",orflr_1971_122.xml,80444/xv46551,0,1,0,1
"Lindsay (Robert J.) Student Folklore Fieldwork Project",orflr_1974_029.xml,80444/xv25396,0,0,1,1
"Axelrod (Christine Johnson) Student Folklore Fieldwork Project",orflr_1972_091.xml,80444/xv78759,0,0,1,1
"Howard (Gregory G.) Student Folklore Fieldwork Project",orflr_1974_023.xml,80444/xv16677,0,1,0,1
"Anonymous Student Folklore Fieldwork Project",orflr_1973_012.xml,80444/xv17993,0,0,1,1
"Student Folklore Fieldwork Project",orflr_1973_196.xml,80444/xv42175,0,0,1,1
"Pierce (Lindsay) Student Folklore Fieldwork Project",orflr_2006_022.xml,80444/xv85900,0,0,1,1
"Robertson (Suzy) Student Folklore Fieldwork Project",orflr_1972_196.xml,80444/xv44305,0,1,0,1
"Berger (Cody) Student Folklore Fieldwork Project",orflr_2010_024.xml,80444/xv27844,0,0,1,1
"Johnson (Edwin S.) Student Folklore Fieldwork Project",orflr_1971_340.xml,80444/xv24783,1,0,0,1
"Gano (Roger) Student Folklore Fieldwork Project",orflr_1971_196.xml,80444/xv82806,0,1,0,1
"Fay (Cindy) Student Folklore Fieldwork Project",orflr_1989_018.xml,80444/xv98565,1,0,0,1
"Chapman (Jennifer) Student Folklore Fieldwork Project",orflr_1989_003.xml,80444/xv76699,1,0,0,1
"Robinson (David) Student Folklore Fieldwork Project",orflr_1980_063.xml,80444/xv14791,0,0,1,1
"Lewis (Kevin M.) Student Folklore Fieldwork Project",orflr_2010_105.xml,80444/xv34713,1,0,0,1
"Tibbetts (Eric) Student Folklore Fieldwork Project",orflr_1987_054.xml,80444/xv73950,1,0,0,1
"Levy (Sami) Student Folklore Fieldwork Project",orflr_2008_008.xml,80444/xv03704,1,0,0,1
"Pheck (Ong Swee) Student Folklore Fieldwork Project",orflr_1987_038.xml,80444/xv86419,0,1,0,1
"Woolsey (Taylor) Student Folklore Fieldwork Project",orflr_2011_045.xml,80444/xv43978,0,1,0,1
"Sartor (Judy R.) Student Folklore Fieldwork Project",orflr_1970_129.xml,80444/xv44741,0,0,1,1
"Holaday (Joseph A.) Student Folklore Fieldwork Project",orflr_1976_130.xml,80444/xv71969,0,0,1,1
"Inani (Naoko) Student Folklore Fieldwork Project",orflr_2002_087.xml,80444/xv92849,1,0,0,1
"Brower (Rebecca) Student Folklore Fieldwork Project",orflr_2010_046.xml,80444/xv60299,1,0,0,1
"Leng (Taylor) Student Folklore Fieldwork Project",orflr_2010_022.xml,80444/xv77737,0,1,0,1
"Ewing (Joan) Student Folklore Fieldwork Project",orflr_1974_100.xml,80444/xv99899,0,1,0,1
"Lyons (Steven L.) Student Folklore Fieldwork Project",orflr_1987_033.xml,80444/xv02416,0,1,0,1
"Azad (Zahra) Student Folklore Fieldwork Project",orflr_1975_077.xml,80444/xv98880,0,1,0,1
"Wade (Dana) Student Folklore Fieldwork Project",orflr_1982_042.xml,80444/xv13830,0,1,0,1
"Student Folklore Fieldwork Project",orflr_1973_357.xml,80444/xv69967,0,1,0,1
"Frankovic (Anita) Student Folklore Fieldwork Project",orflr_1981_022.xml,80444/xv33389,0,0,1,1
"Batchelder (Sarah) Student Folklore Fieldwork Project",orflr_1996_005.xml,80444/xv32339,0,0,1,1
"Merz (Trudi) Student Folklore Fieldwork Project",orflr_1975_143.xml,80444/xv01296,0,0,1,1
"Short (Shirley) Student Folklore Fieldwork Project",orflr_1975_149.xml,80444/xv82504,1,0,0,1
"Cueto (Antonia) Student Folklore Fieldwork Project",orflr_2008_086.xml,80444/xv50149,1,0,0,1
"Ochs (Ellin Anne) Student Folklore Fieldwork Project",orflr_1971_107.xml,80444/xv60861,0,0,1,1
"Student Folklore Fieldwork Project",orflr_1973_244.xml,80444/xv08001,0,1,0,1
"Dobson (Kristy) Student Folklore Fieldwork Project",orflr_1973_032.xml,80444/xv56085,1,0,0,1
"McClure (Andrew) Student Folklore Fieldwork Project",orflr_1979_006.xml,80444/xv43261,0,0,1,1
"Gates (Charlene) Student Folklore Fieldwork Project",orflr_1981_001.xml,80444/xv52667,0,1,0,1
"Contois (Paul S.) Student Folklore Fieldwork Project",orflr_1971_326.xml,80444/xv42605,0,0,1,1
"Morton (Patricia Vlcek) Student Folklore Fieldwork Project",orflr_1975_144.xml,80444/xv73104,0,0,1,1
"Wold (Cheryl) Student Folklore Fieldwork Project",orflr_1979_016.xml,80444/xv49923,0,1,0,1
"Gates (Charlene) Student Folklore Fieldwork Project",orflr_1975_091.xml,80444/xv59329,1,0,0,1
"Agee (Bill) Student Folklore Fieldwork Project",orflr_1976_093.xml,80444/xv49072,0,1,0,1
"Isaac (Lee) Student Folklore Fieldwork Project",orflr_2010_037.xml,80444/xv71163,0,0,1,1
"Wellner (Thomas B.) Student Folklore Fieldwork Project",orflr_1977_092.xml,80444/xv15573,0,1,0,1
"Renkert (Robert A.) Student Folklore Fieldwork Project",orflr_1974_317.xml,80444/xv62185,0,0,1,1
"Peck (Thomas) Student Folklore Fieldwork Project",orflr_2005_010.xml,80444/xv96807,0,0,1,1
"Heintz (Eric) Student Folklore Fieldwork Project",orflr_1993_017.xml,80444/xv67886,0,0,1,1
"Student Folklore Fieldwork Project",orflr_1973_104.xml,80444/xv98864,0,1,0,1
"Student Folklore Fieldwork Project",orflr_1973_213.xml,80444/xv98742,0,0,1,1
"Nutter (Susan) Student Folklore Fieldwork Project",orflr_2003_019.xml,80444/xv88903,0,1,0,1
"Wilson (Mardi) Student Folklore Fieldwork Project",orflr_1971_132.xml,80444/xv00073,0,1,0,1
"Albright (James) Student Folklore Fieldwork Project",orflr_2010_087.xml,80444/xv41836,0,0,1,1
"Hatia (Shirley) Student Folklore Fieldwork Project",orflr_2002_044.xml,80444/xv34860,0,0,1,1
"Moskowitz (Felice) Student Folklore Fieldwork Project",orflr_1971_233.xml,80444/xv39913,0,1,0,1
"Noland (John) Student Folklore Fieldwork Project",orflr_0000_035.xml,80444/xv04675,0,0,1,1
"Linde (Tanda) Student Folklore Fieldwork Project",orflr_2002_086.xml,80444/xv61859,0,0,1,1
"Nyland (Jean) Student Folklore Fieldwork Project",orflr_1974_073.xml,80444/xv64923,0,1,0,1
"Hines (Emily) Student Folklore Fieldwork Project",orflr_2003_016.xml,80444/xv75073,1,0,0,1
"Kemper (Kristy) Student Folklore Fieldwork Project",orflr_2003_010.xml,80444/xv99658,0,0,1,1
"Laing (Steven M.) Student Folklore Fieldwork Project",orflr_1982_087.xml,80444/xv70202,0,0,1,1
"Tenner (Elana) Student Folklore Fieldwork Project",orflr_2011_034.xml,80444/xv27319,0,0,1,1
"Englehart (Jane) Student Folklore Fieldwork Project",orflr_1976_032.xml,80444/xv10125,0,1,0,1
"Peppars (Chad) Student Folklore Fieldwork Project",orflr_2008_197.xml,80444/xv75564,0,0,1,1
"Johanson (Neil) Student Folklore Fieldwork Project",orflr_2012_082.xml,80444/xv31967,1,0,0,1
"Student Folklore Fieldwork Project",orflr_1971_394.xml,80444/xv35986,1,0,0,1
"Lundquist (Kathy) Student Folklore Fieldwork Project",orflr_1971_225.xml,80444/xv22470,1,0,0,1
"Lyons (Kelli) Student Folklore Fieldwork Project",orflr_2010_083.xml,80444/xv84204,0,0,1,1
"Collen (Robin) Student Folklore Fieldwork Project",orflr_1983_014.xml,80444/xv36843,0,1,0,1
"Sears (Mindy) Student Folklore Fieldwork Project",orflr_1991_021.xml,80444/xv15759,0,1,0,1
"Nakagawa (Charlene) Student Folklore Fieldwork Project",orflr_1970_051.xml,80444/xv88430,0,0,1,1
"Shelton (Laura) Student Folklore Fieldwork Project",orflr_1973_082.xml,80444/xv14895,0,0,1,1
"Cornacchia (Peter) Student Folklore Fieldwork Project",orflr_1974_131.xml,80444/xv43545,0,1,0,1
"Gunther (Molly) Student Folklore Fieldwork Project",orflr_2011_023.xml,80444/xv65759,0,0,1,1
"Wellman (Terri) Student Folklore Fieldwork Project",orflr_2008_022.xml,80444/xv04327,0,0,1,1
"Stevenson (Nancy L.) Student Folklore Fieldwork Project",orflr_1974_037.xml,80444/xv06063,0,1,0,1
"Radding (Barbara) Student Folklore Fieldwork Project",orflr_2006_029.xml,80444/xv51400,0,0,1,1
"Hersey (Matthew) Student Folklore Fieldwork Project",orflr_1993_003.xml,80444/xv71984,0,1,0,1
"Worlein (Jim) Student Folklore Fieldwork Project",orflr_1974_303.xml,80444/xv07138,0,0,1,1
"Dugdale (Lori) Student Folklore Fieldwork Project",orflr_1976_097.xml,80444/xv26898,0,1,0,1
"Peront (Katie) Student Folklore Fieldwork Project",orflr_2008_072.xml,80444/xv25027,0,1,0,1
"Donnally (Mary) Student Folklore Fieldwork Project",orflr_1975_124.xml,80444/xv85003,0,1,0,1
"Griffith (Patsy) Student Folklore Fieldwork Project",orflr_1976_142.xml,80444/xv46932,0,1,0,1
"Ross (Karen) and Johnson (Michael) Student Folklore Fieldwork Project",orflr_1974_151.xml,80444/xv76202,0,0,1,1
"Clarke (Phoebe) Student Folklore Fieldwork Project",orflr_1972_185.xml,80444/xv52319,1,0,0,1
"DuVal (Molly) Student Folklore Fieldwork Project",orflr_2010_065.xml,80444/xv16137,0,1,0,1
"Student Folklore Fieldwork Project",orflr_1973_183.xml,80444/xv57244,0,0,1,1
"Baugh (Steven M.) Student Folklore Fieldwork Project",orflr_1979_025.xml,80444/xv12728,0,1,0,1
"Powell (Melissa) Student Folklore Fieldwork Project",orflr_2008_088.xml,80444/xv62731,0,1,0,1
"Mettler (Greg) Student Folklore Fieldwork Project",orflr_1977_041.xml,80444/xv56646,1,0,0,1
"Goodling (Benjamin) Student Folklore Fieldwork Project",orflr_2006_023.xml,80444/xv15426,1,0,0,1
"Student Folklore Fieldwork Project",orflr_1971_348.xml,80444/xv59576,0,1,0,1
"Melton (Debbie) Student Folklore Fieldwork Project",orflr_1976_151.xml,80444/xv36828,1,0,0,1
"Johnson (JoZell) Student Folklore Fieldwork Project",orflr_1982_086.xml,80444/xv67544,1,0,0,1
"Dunlop (Curt) Student Folklore Fieldwork Project",orflr_1976_008.xml,80444/xv38449,0,1,0,1
"Everwine (Chris) Student Folklore Fieldwork Project",orflr_1975_015.xml,80444/xv99914,1,0,0,1
"Hager (Marilyn) Student Folklore Fieldwork Project",orflr_1975_128.xml,80444/xv78836,0,1,0,1
"Bozich (Scott) Student Folklore Fieldwork Project",orflr_2012_026.xml,80444/xv92132,0,0,1,1
"Huelshoff (Michael) Student Folklore Fieldwork Project",orflr_1977_032.xml,80444/xv75991,1,0,0,1
"Harwig (Dan) Student Folklore Fieldwork Project",orflr_1986_012.xml,80444/xv93194,0,1,0,1
"Student Folklore Fieldwork Project",orflr_1972_015.xml,80444/xv12109,0,0,1,1
"Shook (Diana) Student Folklore Fieldwork Project",orflr_1989_011.xml,80444/xv18423,0,1,0,1
"Arntzen (Tim) Student Folklore Fieldwork Project",orflr_1980_056.xml,80444/xv00268,0,1,0,1
"Tarzaban (Joan) Student Folklore Fieldwork Project",orflr_1972_154.xml,80444/xv64828,0,0,1,1
"Student Folklore Fieldwork Project",orflr_1973_191.xml,80444/xv04144,0,1,0,1
"Fitzpatrick (Lauren) Student Folklore Fieldwork Project",orflr_2012_053.xml,80444/xv72479,0,1,0,1
"Bittner (Nancy) Student Folklore Fieldwork Project",orflr_1974_216.xml,80444/xv38134,0,1,0,1
"Michalsen (Karen) Student Folklore Fieldwork Project",orflr_1989_036.xml,80444/xv78024,0,1,0,1
"Schafer (Jim) Student Folklore Fieldwork Project",orflr_1974_049.xml,80444/xv56579,0,0,1,1
"Amick-Elder (Davena) Student Folklore Fieldwork Project",orflr_2008_160.xml,80444/xv15789,0,1,0,1
"Dinsdale (Grace) Student Folklore Fieldwork Project",orflr_1975_012.xml,80444/xv73815,0,0,1,1
"Chitwood (Greg) Student Folklore Fieldwork Project",orflr_1976_029.xml,80444/xv35360,1,0,0,1
"Hormel (Anita) Student Folklore Fieldwork Project",orflr_1976_049.xml,80444/xv41998,1,0,0,1
"Wood (Susan) Student Folklore Fieldwork Project",orflr_1980_067.xml,80444/xv88070,0,0,1,1
"Halvorson (Todd C.) Student Folklore Fieldwork Project",orflr_1982_083.xml,80444/xv73522,0,1,0,1
"McLaughlin (Patricia) Student Folklore Fieldwork Project",orflr_1987_056.xml,80444/xv89819,0,0,1,1
"Student Folklore Fieldwork Project",orflr_1973_322.xml,80444/xv10580,0,1,0,1
"Jacobsen (Kylee) Student Folklore Fieldwork Project",orflr_2008_020.xml,80444/xv31033,0,1,0,1
"Dearborn (Susan) Student Folklore Fieldwork Project",orflr_1992_010.xml,80444/xv18063,0,1,0,1
"Magee (Jerome) Student Folklore Fieldwork Project",orflr_1974_002.xml,80444/xv17333,0,1,0,1
"Estep (Susan Jane) Student Folklore Fieldwork Project",orflr_1989_057.xml,80444/xv23712,1,0,0,1
"Ridge (Dennis) Student Folklore Fieldwork Project",orflr_1977_049.xml,80444/xv50344,0,0,1,1
"Hunter (Penelope) Student Folklore Fieldwork Project",orflr_1974_065.xml,80444/xv41180,1,0,0,1
"Payton (Victoria) Student Folklore Fieldwork Project",orflr_1978_008.xml,80444/xv47109,0,0,1,1
"Edison (Yvonne) Student Folklore Fieldwork Project",orflr_1980_023.xml,80444/xv05218,0,1,0,1
"Griffith (Cadence) Student Folklore Fieldwork Project",orflr_2008_012.xml,80444/xv45281,1,0,0,1
"Collier (Peggy) Student Folklore Fieldwork Project",orflr_1974_226.xml,80444/xv89700,0,1,0,1
"Martins (Elle) Student Folklore Fieldwork Project",orflr_2005_007.xml,80444/xv10357,1,0,0,1
"Wilkalis (Vicki Lynn) Student Folklore Fieldwork Project",orflr_1975_071.xml,80444/xv81558,0,0,1,1
"Garza (Dana J.) Student Folklore Fieldwork Project",orflr_1977_066.xml,80444/xv82019,0,1,0,1
"Cox (Crystal Faith) Student Folklore Fieldwork Project",orflr_2010_058.xml,80444/xv94863,0,0,1,1
"Kyle (Ellen L.) Student Folklore Fieldwork Project",orflr_1974_046.xml,80444/xv62646,0,1,0,1
"Martin (Cally) Student Folklore Fieldwork Project",orflr_2002_028.xml,80444/xv48300,0,1,0,1
"Morris (Phillip) Student Folklore Fieldwork Project",orflr_1971_232.xml,80444/xv28552,0,0,1,1
"Stacy (Don) Student Folklore Fieldwork Project",orflr_2008_110.xml,80444/xv03900,1,0,0,1
"Finch (Barbara Jo) Student Folklore Fieldwork Project",orflr_1972_112.xml,80444/xv71926,1,0,0,1
"Thorn (Kathleen) Student Folklore Fieldwork Project",orflr_1974_191.xml,80444/xv96411,0,1,0,1
"Goodwin (Londa Lea) Student Folklore Fieldwork Project",orflr_1980_027.xml,80444/xv25354,0,1,0,1
"Jones (Meredith) Student Folklore Fieldwork Project",orflr_1994_007.xml,80444/xv89871,0,0,1,1
"Proett (David M.) Student Folklore Fieldwork Project",orflr_1975_041.xml,80444/xv34512,0,1,0,1
"Engelbrecht (Janet) Student Folklore Fieldwork Project",orflr_1971_116.xml,80444/xv62045,0,1,0,1
"Brown (Sabina) Student Folklore Fieldwork Project",orflr_2002_018.xml,80444/xv57943,1,0,0,1
"Gabriel (Daphne) Student Folklore Fieldwork Project",orflr_2002_003.xml,80444/xv06793,1,0,0,1
"Coughlan (Brian) Student Folklore Fieldwork Project",orflr_1987_011.xml,80444/xv55728,0,1,0,1
"Skillman (Laurie Ann) Student Folklore Fieldwork Project",orflr_1971_083.xml,80444/xv18408,0,0,1,1
"Purn (Tiffany) Student Folklore Fieldwork Project",orflr_2005_014.xml,80444/xv14413,0,0,1,1
"Brown (Timothy) Student Folklore Fieldwork Project",orflr_1980_017.xml,80444/xv04220,0,0,1,1
"Ramey (Karen) Student Folklore Fieldwork Project",orflr_1976_019.xml,80444/xv28021,0,1,0,1
"Student Folklore Fieldwork Project",orflr_1973_351.xml,80444/xv28640,0,1,0,1
"Lutes (James) Student Folklore Fieldwork Project",orflr_2008_203.xml,80444/xv36349,0,0,1,1
"Student Folklore Fieldwork Project",orflr_1973_218.xml,80444/xv13888,0,1,0,1
"Nowak (Lon) Student Folklore Fieldwork Project",orflr_2008_053.xml,80444/xv51773,0,1,0,1
"Hardie (Teresa) Student Folklore Fieldwork Project",orflr_1975_092.xml,80444/xv23699,0,1,0,1
"Stanley (Matthew) Student Folklore Fieldwork Project",orflr_1975_048.xml,80444/xv92486,0,0,1,1
"Dale (Gordon) Student Folklore Fieldwork Project",orflr_1972_104.xml,80444/xv52090,0,0,1,1
"Anonymous Student Folklore Fieldwork Project",orflr_1972_078.xml,80444/xv55685,0,0,1,1
"Frye (Leslie E.) Student Folklore Fieldwork Project",orflr_1975_017.xml,80444/xv17260,0,0,1,1
"Yarbrough (Jennifer M.) Student Folklore Fieldwork Project",orflr_1977_002.xml,80444/xv81958,0,0,1,1
"Denney (Cameron) Student Folklore Fieldwork Project",orflr_1981_019.xml,80444/xv55776,0,0,1,1
"Student Folklore Fieldwork Project",orflr_1973_327.xml,80444/xv17819,1,0,0,1
"Casimir (Ulrick) Student Folklore Fieldwork Project",orflr_2003_022.xml,80444/xv85491,1,0,0,1
"Denison (Judith) Student Folklore Fieldwork Project",orflr_1986_008.xml,80444/xv10351,1,0,0,1
"Marvel (Nancy) Student Folklore Fieldwork Project",orflr_1975_099.xml,80444/xv87805,1,0,0,1
"Gabriel (Joe) Student Folklore Fieldwork Project",orflr_1976_036.xml,80444/xv80633,1,0,0,1
"Rott (Betsy) Student Folklore Fieldwork Project",orflr_1977_120.xml,80444/xv68380,0,1,0,1
"Roberts (Evan Douglas) Student Folklore Fieldwork Project",orflr_2008_093.xml,80444/xv52410,1,0,0,1
"Gantz (Jen) Student Folklore Fieldwork Project",orflr_1991_035.xml,80444/xv02465,1,0,0,1
"Mansinon (Krislyn K.) Student Folklore Fieldwork Project",orflr_2010_012.xml,80444/xv45178,0,0,1,1
"Student Folklore Fieldwork Project",orflr_1973_303.xml,80444/xv37078,0,1,0,1
"Cressman (Miles Hendrix) Student Folklore Fieldwork Project",orflr_2010_031.xml,80444/xv76208,1,0,0,1
"Kurtz (Georgia) Student Folklore Fieldwork Project",orflr_2012_096.xml,80444/xv91384,1,0,0,1
"Rasmussen (Shane E.) Student Folklore Fieldwork Project",orflr_1997_013.xml,80444/xv61679,0,1,0,1
"Seid (John) Student Folklore Fieldwork Project",orflr_1980_065.xml,80444/xv66513,1,0,0,1
"Lewetag (Kenneth E.) Student Folklore Fieldwork Project",orflr_1976_148.xml,80444/xv37921,0,1,0,1
"Blattler (Haidee A.) Student Folklore Fieldwork Project",orflr_1982_080.xml,80444/xv50430,0,0,1,1
"Sharpe (Rita) Student Folklore Fieldwork Project",orflr_1971_263.xml,80444/xv05126,0,1,0,1
"Chuman (Lisa) Student Folklore Fieldwork Project",orflr_1977_146.xml,80444/xv45294,0,1,0,1
"Jaffe (Sue) Student Folklore Fieldwork Project",orflr_1975_179.xml,80444/xv00131,1,0,0,1
"McCormick (Matthew) Student Folklore Fieldwork Project",orflr_1976_114.xml,80444/xv32232,0,1,0,1
"Shimomaeda (Jimmy) Student Folklore Fieldwork Project",orflr_1977_142.xml,80444/xv85614,0,0,1,1
"Beroldo (Antonio) Student Folklore Fieldwork Project",orflr_2012_020.xml,80444/xv98516,0,0,1,1
"Popp (Julia) Student Folklore Fieldwork Project",orflr_2008_178.xml,80444/xv01739,1,0,0,1
"Dowdy (Shannon) Student Folklore Fieldwork Project",orflr_1986_032.xml,80444/xv76531,0,1,0,1
"Weaver (Laura Morrow) Student Folklore Fieldwork Project",orflr_1979_044.xml,80444/xv62133,0,1,0,1
"Kemp (Sierra) Student Folklore Fieldwork Project",orflr_2012_090.xml,80444/xv14221,0,0,1,1
"Brower (Gary R.) Student Folklore Fieldwork Project",orflr_1977_152.xml,80444/xv06317,0,0,1,1
"Student Folklore Fieldwork Project",orflr_1973_224.xml,80444/xv55017,0,1,0,1
"Sansum (Carol H.) Student Folklore Fieldwork Project",orflr_1975_065.xml,80444/xv32803,1,0,0,1
"Emerson (Terry) Student Folklore Fieldwork Project",orflr_1977_102.xml,80444/xv93292,1,0,0,1
"Hall (Mary) Student Folklore Fieldwork Project",orflr_2008_159.xml,80444/xv74942,1,0,0,1
"Metzler (Roxia A.) Student Folklore Fieldwork Project",orflr_1996_013.xml,80444/xv81484,0,0,1,1
"Granzeback (Richard R.) Student Folklore Fieldwork Project",orflr_1972_117.xml,80444/xv08035,1,0,0,1
"Howald (Heather) Student Folklore Fieldwork Project",orflr_2002_055.xml,80444/xv29183,0,1,0,1
"Shuler (Gage) Student Folklore Fieldwork Project",orflr_2010_032.xml,80444/xv82748,1,0,0,1
"Dickerson (Jeremy) Student Folklore Fieldwork Project",orflr_2002_012.xml,80444/xv97882,0,1,0,1
"Franklin (Margot) Student Folklore Fieldwork Project",orflr_1989_044.xml,80444/xv19955,0,1,0,1
"Volkmann (Peter Barett) Student Folklore Fieldwork Project",orflr_2002_058.xml,80444/xv69360,0,1,0,1
"Sherman (Michael D.) Student Folklore Fieldwork Project",orflr_1975_044.xml,80444/xv88571,0,1,0,1
"Sundwall (Dale) Student Folklore Fieldwork Project",orflr_1985_023.xml,80444/xv90158,1,0,0,1
"Mitchell (Denise) Student Folklore Fieldwork Project",orflr_1996_016.xml,80444/xv28970,0,1,0,1
"Rucker (Christopher M.) Student Folklore Fieldwork Project",orflr_2002_014.xml,80444/xv79962,0,1,0,1
"Cothern (Leah) Student Folklore Fieldwork Project",orflr_1986_007.xml,80444/xv00817,0,0,1,1
"Osborn (Robbie) Student Folklore Fieldwork Project",orflr_1979_003.xml,80444/xv09280,0,1,0,1
"Stewart (Jennifer L.) Student Folklore Fieldwork Project",orflr_1987_051.xml,80444/xv51159,1,0,0,1
"Howard (Kirsten) Student Folklore Fieldwork Project",orflr_2006_041.xml,80444/xv89245,0,1,0,1
"Azad (Zahra) Student Folklore Fieldwork Project",orflr_1975_002.xml,80444/xv18887,0,1,0,1
"Grigg (Laurie) and Kenfield (Terry) Student Folklore Fieldwork Project",orflr_1972_033.xml,80444/xv16070,0,1,0,1
"Student Folklore Fieldwork Project",orflr_1973_306.xml,80444/xv89755,0,0,1,1
"Laurence (Michele) Student Folklore Fieldwork Project",orflr_1984_031.xml,80444/xv03182,1,0,0,1
"Harkin (Dave) Student Folklore Fieldwork Project",orflr_1992_027.xml,80444/xv41668,0,1,0,1
"Nash (Curt) Student Folklore Fieldwork Project",orflr_1974_032.xml,80444/xv99032,0,1,0,1
"Lea (Tom M.) Student Folklore Fieldwork Project",orflr_1986_015.xml,80444/xv32559,1,0,0,1
"Rabinowitz (Neil) Student Folklore Fieldwork Project",orflr_1979_007.xml,80444/xv80892,1,0,0,1
"Anonymous Student Folklore Fieldwork Project",orflr_1973_013.xml,80444/xv66970,0,0,1,1
"Student Folklore Fieldwork Project",orflr_1973_237.xml,80444/xv85662,0,1,0,1
"Yildirim (Gokhan) Student Folklore Fieldwork Project",orflr_2011_046.xml,80444/xv71752,1,0,0,1
"Saltvold (Martha) Student Folklore Fieldwork Project",orflr_1982_123.xml,80444/xv89913,0,0,1,1
"Lloyd (Michael B.) Student Folklore Fieldwork Project",orflr_1977_014.xml,80444/xv95056,0,1,0,1
"McCulley (Stephanie) Student Folklore Fieldwork Project",orflr_2008_052.xml,80444/xv72424,1,0,0,1
"Colter (Hillary) Folklore Thesis",orflr_2008_112.xml,80444/xv78869,0,1,0,1
"Jakovec (Amy) Student Folklore Fieldwork Project",orflr_2012_080.xml,80444/xv30944,0,0,1,1
"Friesen (Christina) Student Folklore Fieldwork Project",orflr_2004_002.xml,80444/xv29324,1,0,0,1
"Richman (Jillian) Student Folklore Fieldwork Project",orflr_1973_078.xml,80444/xv56317,1,0,0,1
"Sanders (Ty) Student Folklore Fieldwork Project",orflr_2005_002.xml,80444/xv66833,0,1,0,1
"Southern (Kelly A.) Student Folklore Fieldwork Project",orflr_1989_032.xml,80444/xv75659,0,1,0,1
"Fassler (Kristy) Student Folklore Fieldwork Project",orflr_1974_106.xml,80444/xv40618,1,0,0,1
"Vuoso (Laura) Student Folklore Fieldwork Project",orflr_2011_041.xml,80444/xv68338,0,0,1,1
"Traphagen (Elizabeth) Student Folklore Fieldwork Project",orflr_1974_322.xml,80444/xv05191,0,1,0,1
"Morrison (Jean) Student Folklore Fieldwork Project",orflr_1974_272.xml,80444/xv17364,0,0,1,1
"Fuller (Mike) Student Folklore Fieldwork Project",orflr_1974_234.xml,80444/xv33721,0,0,1,1
"Student Folklore Fieldwork Project",orflr_1973_278.xml,80444/xv18319,0,1,0,1
"Bredeson (John) Student Folklore Fieldwork Project",orflr_1982_122.xml,80444/xv47705,0,0,1,1
"Hubbard (Anne) Student Folklore Fieldwork Project",orflr_1971_117.xml,80444/xv60769,1,0,0,1
"Sunia (Andrew Tuiai) Student Folklore Fieldwork Project",orflr_1989_012.xml,80444/xv61514,0,0,1,1
"Werner (Janet L.) Student Folklore Fieldwork Project",orflr_1977_065.xml,80444/xv24414,1,0,0,1
"Parkyn (Jenny) Student Folklore Fieldwork Project",orflr_2010_073.xml,80444/xv16183,0,0,1,1
"Hedge (Linda) Student Folklore Fieldwork Project",orflr_1972_080.xml,80444/xv31262,0,1,0,1
"Asl (Kiana Motahari) Student Folklore Fieldwork Project",orflr_2011_004.xml,80444/xv34689,0,0,1,1
"Danielson (Linda) Student Folklore Fieldwork Project",orflr_1983_034.xml,80444/xv67758,1,0,0,1
"Vallee (Geoffrey) Folklore Thesis",orflr_2010_121.xml,80444/xv68835,0,1,0,1
"Steffy (Christina) Student Folklore Fieldwork Project",orflr_1992_006.xml,80444/xv16043,0,1,0,1
"Jenks (Julie) Student Folklore Fieldwork Project",orflr_1977_033.xml,80444/xv06179,0,0,1,1
"Esselstrom (Jacqueline) Student Folklore Fieldwork Project",orflr_1980_024.xml,80444/xv14273,0,1,0,1
"Poizat-Newcomb (Steve) Student Folklore Fieldwork Project",orflr_1996_019.xml,80444/xv10229,1,0,0,1
"Tan (Angeline) Student Folklore Fieldwork Project",orflr_1987_048.xml,80444/xv59771,0,0,1,1
"Kirkpatrick (Molly) Student Folklore Fieldwork Project",orflr_2012_093.xml,80444/xv33920,0,1,0,1
"Fife (Casey Marks) Student Folklore Fieldwork Project",orflr_2012_052.xml,80444/xv11993,0,1,0,1
"Milleville (Cynthia Haines) Student Folklore Fieldwork Project",orflr_1972_169.xml,80444/xv75125,0,0,1,1
"Gutin (Samuel) Student Folklore Fieldwork Project",orflr_2012_061.xml,80444/xv38827,0,1,0,1
"Chong (Natalie) Student Folklore Fieldwork Project",orflr_1993_006.xml,80444/xv53134,1,0,0,1
"Reames (Scott) Student Folklore Fieldwork Project",orflr_1985_038.xml,80444/xv99139,0,1,0,1
"Kari (Nola) Student Folklore Fieldwork Project",orflr_1979_035.xml,80444/xv91015,0,0,1,1
"Nerenberg (Lisa) Student Folklore Fieldwork Project",orflr_1974_273.xml,80444/xv30374,0,1,0,1
"Armstrong (Katie) Student Folklore Fieldwork Project",orflr_2008_024.xml,80444/xv17764,0,0,1,1
"Student Folklore Fieldwork Project",orflr_1971_392.xml,80444/xv33566,0,0,1,1
"Student Folklore Fieldwork Project",orflr_1973_140.xml,80444/xv40005,0,0,1,1
"Chen (Che-Yu) Student Folklore Fieldwork Project",orflr_2012_034.xml,80444/xv42465,1,0,0,1
"Conner (Roberta L.) Student Folklore Fieldwork Project",orflr_1976_030.xml,80444/xv54562,1,0,0,1
"Student Folklore Fieldwork Project",orflr_1973_261.xml,80444/xv06112,0,0,1,1
"McJunkin (Gary) Student Folklore Fieldwork Project",orflr_1972_136.xml,80444/xv65795,0,1,0,1
"Student Folklore Fieldwork Project",orflr_1973_109.xml,80444/xv88143,0,0,0,0
"Meusey (Roberta) Student Folklore Fieldwork Project",orflr_1970_126.xml,80444/xv25949,0,0,0,0
"Kranzler (Kathryn L.) Student Folklore Fieldwork Project",orflr_1983_021.xml,80444/xv29479,0,0,0,0
"Zwingli (Christopher) Student Folklore Fieldwork Project",orflr_1977_059.xml,80444/xv46557,0,0,0,0
"LaSage (Michael A.) Student Folklore Fieldwork Project",orflr_1993_028.xml,80444/xv02734,0,0,0,0
"Anonymous Student Folklore Fieldwork Project",orflr_1971_163.xml,80444/xv78692,0,0,0,0
"Hake (Bruce A.) Student Folklore Fieldwork Project",orflr_1973_047.xml,80444/xv33935,0,0,0,0
"Ashen (Carly) Student Folklore Fieldwork Project",orflr_2011_003.xml,80444/xv11450,0,0,0,0
"Zeider (Shirley) Student Folklore Fieldwork Project",orflr_1972_066.xml,80444/xv64770,0,0,0,0
"Anonymous Student Folklore Fieldwork Project",orflr_1972_180.xml,80444/xv27792,0,0,0,0
"Student Folklore Fieldwork Project",orflr_1973_311.xml,80444/xv14416,0,0,0,0
"Nelson (Chris) Student Folklore Fieldwork Project",orflr_2002_072.xml,80444/xv19076,0,0,0,0
"Crowley (Steven) Student Folklore Fieldwork Project",orflr_2004_007.xml,80444/xv38464,0,0,0,0
"Czech (Adrienne) Student Folklore Fieldwork Project",orflr_2008_150.xml,80444/xv01260,0,0,0,0
"Holt (George) Student Folklore Fieldwork Project",orflr_1982_084.xml,80444/xv47866,0,0,0,0
"Kopp (James J.) Student Folklore Fieldwork Project",orflr_1974_069.xml,80444/xv79779,0,0,0,0
"Kircher (Suzanne) Student Folklore Fieldwork Project",orflr_1974_252.xml,80444/xv84164,0,0,0,0
"Herbst (Shallon R.) Student Folklore Fieldwork Project",orflr_1990_010.xml,80444/xv50683,0,0,0,0
"Axelrod (Christine Johnson) Student Folklore Fieldwork Project",orflr_1972_093.xml,80444/xv80090,0,0,0,0
"Smith (Brad) Student Folklore Fieldwork Project",orflr_1975_059.xml,80444/xv99414,0,0,0,0
"Latourette (Lauren) Student Folklore Fieldwork Project",orflr_1974_258.xml,80444/xv65084,0,0,0,0
"Heidrich (William Randy) Student Folklore Fieldwork Project",orflr_1973_050.xml,80444/xv71386,0,0,0,0
"Student Folklore Fieldwork Project",orflr_1973_234.xml,80444/xv38442,0,0,0,0
"Nolan (Maureen) Student Folklore Fieldwork Project",orflr_1984_051.xml,80444/xv78958,0,0,0,0
"Echeto (Nicole) Student Folklore Fieldwork Project",orflr_2012_047.xml,80444/xv67019,0,0,0,0
"Mezzatesta (Lynn) Student Folklore Fieldwork Project",orflr_1977_081.xml,80444/xv85055,0,0,0,0
"Heinle (Eugene H.) Student Folklore Fieldwork Project",orflr_1971_336.xml,80444/xv52890,0,0,0,0
"Tan (Jennifer) Student Folklore Fieldwork Project",orflr_1987_045.xml,80444/xv92724,0,0,0,0
"Schmitt (Casey) Student Folklore Fieldwork Project",orflr_2007_002.xml,80444/xv61633,0,0,0,0
"Lennard (Micky) Student Folklore Fieldwork Project",orflr_2002_056.xml,80444/xv43252,0,0,0,0
"Student Folklore Fieldwork Project",orflr_1973_352.xml,80444/xv12509,0,0,0,0
"Johanns (Nancy) Student Folklore Fieldwork Project",orflr_1972_121.xml,80444/xv56301,0,0,0,0
"Swingen (Amy L.) Student Folklore Fieldwork Project",orflr_1982_096.xml,80444/xv21771,0,0,0,0
"Phillips (Roy and Bonnie) Student Folklore Fieldwork Project",orflr_1970_112.xml,80444/xv31616,0,0,0,0
"Fulstone (Emily) Student Folklore Fieldwork Project",orflr_2010_015.xml,80444/xv17034,0,0,0,0
"Student Folklore Fieldwork Project",orflr_1971_395.xml,80444/xv69488,0,0,0,0
"Keller (Stephen R.) Student Folklore Fieldwork Project",orflr_1975_180.xml,80444/xv96780,0,0,0,0
"Smith (Karen) Student Folklore Fieldwork Project",orflr_1977_051.xml,80444/xv08370,0,0,0,0
"Gregory (Adele) Student Folklore Fieldwork Project",orflr_1976_044.xml,80444/xv63644,0,0,0,0
"Topolewski (Mathew) Student Folklore Fieldwork Project",orflr_2011_037.xml,80444/xv30688,0,0,0,0
"Kearney (Courtnery) Student Folklore Fieldwork Project",orflr_2008_208.xml,80444/xv72589,0,0,0,0
"Parrish (Elizabeth) Student Folklore Fieldwork Project",orflr_1974_075.xml,80444/xv49539,0,0,0,0
"Denecke (William) Student Folklore Fieldwork Project",orflr_1973_005.xml,80444/xv62472,0,0,0,0
"Hagen (Ryan) Student Folklore Fieldwork Project",orflr_2010_072.xml,80444/xv35272,0,0,0,0
"Moore (Spencer) Student Folklore Fieldwork Project",orflr_1985_036.xml,80444/xv89401,0,0,0,0
"Hernandez (Marissa) Student Folklore Fieldwork Project",orflr_2011_024.xml,80444/xv69891,0,0,0,0
"Student Folklore Fieldwork Project",orflr_1973_295.xml,80444/xv94079,0,0,0,0
"Gieber (Timothy D.) Student Folklore Fieldwork Project",orflr_1976_039.xml,80444/xv72201,0,0,0,0
"Graves (Claude) Student Folklore Fieldwork Project",orflr_1976_140.xml,80444/xv06988,0,0,0,0
"Mentzer (Laura) Student Folklore Fieldwork Project",orflr_1975_185.xml,80444/xv53723,0,0,0,0
"Schilling (LeAnne) Student Folklore Fieldwork Project",orflr_2008_057.xml,80444/xv32684,0,0,0,0
"De Witt-Hoeger (Nora) Student Folklore Fieldwork Project",orflr_2010_097.xml,80444/xv22805,0,0,0,0
"Russell (Terry) Student Folklore Fieldwork Project",orflr_1981_050.xml,80444/xv28668,0,0,0,0
"McGee (Freedom) Student Folklore Fieldwork Project",orflr_1976_061.xml,80444/xv51766,0,0,0,0
"Hamilton (Leslie) Student Folklore Fieldwork Project",orflr_1974_242.xml,80444/xv35031,0,0,0,0
"Huso (Michela M.) Student Folklore Fieldwork Project",orflr_1978_017.xml,80444/xv84756,0,0,0,0
"Student Folklore Fieldwork Project",orflr_1973_164.xml,80444/xv02496,0,0,0,0
"Student Folklore Fieldwork Project",orflr_1973_102.xml,80444/xv83023,0,0,0,0
"Student Folklore Fieldwork Project",orflr_1973_173.xml,80444/xv14633,0,0,0,0
"Knorek (John K.) Student Folklore Fieldwork Project",orflr_2002_047.xml,80444/xv44213,0,0,0,0
"Student Folklore Fieldwork Project",orflr_1973_211.xml,80444/xv85256,0,0,0,0
"Seloover (Robin) Student Folklore Fieldwork Project",orflr_1988_016.xml,80444/xv34838,0,0,0,0
"Houser (Hayden E.) Student Folklore Fieldwork Project",orflr_2010_023.xml,80444/xv86679,0,0,0,0
"Tompkins (Daniel) Student Folklore Fieldwork Project",orflr_2011_036.xml,80444/xv08630,0,0,0,0
"Hart (Moriah) Student Folklore Fieldwork Project",orflr_2004_015.xml,80444/xv60751,0,0,0,0
"Brock (Rebecca J.) Student Folklore Fieldwork Project",orflr_1974_219.xml,80444/xv08749,0,0,0,0
"Tsuchihashi (Mika) Student Folklore Fieldwork Project",orflr_1977_090.xml,80444/xv49511,0,0,0,0
"Diven (Joseph) Student Folklore Fieldwork Project",orflr_1970_059.xml,80444/xv41601,0,0,0,0
"Davis (Gary) Student Folklore Fieldwork Project",orflr_1974_133.xml,80444/xv63760,0,0,0,0
"Sheller (Gayle A.) Student Folklore Fieldwork Project",orflr_1982_091.xml,80444/xv53140,0,0,0,0
"McLain (Alysia) Student Folklore Fieldwork Project",orflr_2002_033.xml,80444/xv36563,0,0,0,0
"Moravec (Marcie) Student Folklore Fieldwork Project",orflr_1996_024.xml,80444/xv20303,0,0,0,0
"Wagner (Susan) Student Folklore Fieldwork Project",orflr_1975_053.xml,80444/xv34954,0,0,0,0
"Walhovd (Christina M.) Student Folklore Fieldwork Project",orflr_2010_088.xml,80444/xv56130,0,0,0,0
"Lichtenstein (Carol) Student Folklore Fieldwork Project",orflr_1992_003.xml,80444/xv54769,0,0,0,0
"Russell (Linda) Student Folklore Fieldwork Project",orflr_1975_107.xml,80444/xv13098,0,0,0,0
"Student Folklore Fieldwork Project",orflr_1973_227.xml,80444/xv71801,0,0,0,0
"Flori (Heather) Student Folklore Fieldwork Project",orflr_2002_077.xml,80444/xv25451,0,0,0,0
"Graham (Don) Student Folklore Fieldwork Project",orflr_1977_074.xml,80444/xv87393,0,0,0,0
"Troskey (Drew) Student Folklore Fieldwork Project",orflr_2008_010.xml,80444/xv30606,0,0,0,0
"Aro (Pamela) Student Folklore Fieldwork Project",orflr_1970_132.xml,80444/xv17205,0,0,0,0
"Dowbenko (Valerie Anne) Folklore Thesis",orflr_2010_124.xml,80444/xv09558,0,0,0,0
"Jud (Daniel A.) Student Folklore Fieldwork Project",orflr_1976_014.xml,80444/xv49273,0,0,0,0
"Mode (Jemine) Student Folklore Fieldwork Project",orflr_2003_018.xml,80444/xv91009,0,0,0,0
"Northup (Michael) Student Folklore Fieldwork Project",orflr_1971_073.xml,80444/xv96664,0,0,0,0
"Teeters (Kay) Student Folklore Fieldwork Project",orflr_1969_027.xml,80444/xv37722,0,0,0,0
"Nichol (Christina) Student Folklore Fieldwork Project",orflr_1993_024.xml,80444/xv13586,0,0,0,0
"Nearing (Jane M.) Student Folklore Fieldwork Project",orflr_1977_045.xml,80444/xv25167,0,0,0,0
"Lewis (Shelley J.) Student Folklore Fieldwork Project",orflr_1971_221.xml,80444/xv80667,0,0,0,0
"Manfredi (Taylor) Student Folklore Fieldwork Project",orflr_2008_026.xml,80444/xv65859,0,0,0,0
"Hartt (Lori) Student Folklore Fieldwork Project",orflr_2002_013.xml,80444/xv47344,0,0,0,0
"Cowart (Corrie Franz) Student Folklore Fieldwork Project",orflr_2002_034.xml,80444/xv30932,0,0,0,0
"Gates (Charlene) Student Folklore Fieldwork Project",orflr_1977_155.xml,80444/xv19674,0,0,0,0
"Miller (Sarah) Student Folklore Fieldwork Project",orflr_2006_015.xml,80444/xv26068,0,0,0,0
"Carpenter (Steve) Student Folklore Fieldwork Project",orflr_1977_022.xml,80444/xv61450,0,0,0,0
"Feldman (Judith) Student Folklore Fieldwork Project",orflr_1973_038.xml,80444/xv70977,0,0,0,0
"Student Folklore Fieldwork Project",orflr_1973_326.xml,80444/xv16625,0,0,0,0
"Sodergren (Steven D.) Student Folklore Fieldwork Project",orflr_1972_150.xml,80444/xv86087,0,0,0,0
"Student Folklore Fieldwork Project",orflr_1973_276.xml,80444/xv39639,0,0,0,0
"Cornett (J. Jeffrey) Student Folklore Fieldwork Project",orflr_1975_010.xml,80444/xv24395,0,0,0,0
"Furl (Jennifer) Folklore Terminal Project",orflr_2009_001.xml,80444/xv57415,0,0,0,0
"Fauvre (Lisa) Student Folklore Fieldwork Project",orflr_1985_018.xml,80444/xv79162,0,0,0,0
"Thomason (Steven D.) Student Folklore Fieldwork Project",orflr_1974_190.xml,80444/xv29382,0,0,0,0
"Sherwin (Jennifer) Student Folklore Fieldwork Project",orflr_1987_050.xml,80444/xv81356,0,0,0,0
"Holman (Nicole) Student Folklore Fieldwork Project",orflr_2008_059.xml,80444/xv57650,0,0,0,0
"Wan (Yuh-Yao) Student Folklore Fieldwork Project",orflr_1992_002.xml,80444/xv35363,0,0,0,0
"Knight (Tracy) Student Folklore Fieldwork Project",orflr_1982_113.xml,80444/xv99765,0,0,0,0
"Haddad (Robert) Student Folklore Fieldwork Project",orflr_1977_106.xml,80444/xv41809,0,0,0,0
"Umphress (Jori) Student Folklore Fieldwork Project",orflr_2010_038.xml,80444/xv01571,0,0,0,0
"Hill (Douglas S.) Student Folklore Fieldwork Project",orflr_1987_025.xml,80444/xv10644,0,0,0,0
"Robinson (Sue) Student Folklore Fieldwork Project",orflr_1971_256.xml,80444/xv90878,0,0,0,0
"Loewen (Becca) Student Folklore Fieldwork Project",orflr_2010_055.xml,80444/xv98818,0,0,0,0
"Pusieski (Paula) Student Folklore Fieldwork Project",orflr_1974_079.xml,80444/xv79766,0,0,0,0
"Morgan (Catherine) Student Folklore Fieldwork Project",orflr_1980_035.xml,80444/xv73132,0,0,0,0
"Sander (Maura) Student Folklore Fieldwork Project",orflr_1993_030.xml,80444/xv44232,0,0,0,0
"Meeuwsen (Jason) Student Folklore Fieldwork Project",orflr_2006_021.xml,80444/xv62823,0,0,0,0
"Colleary (Kellie) Student Folklore Fieldwork Project",orflr_1977_003.xml,80444/xv01910,0,0,0,0
"Harris (Samantha) Student Folklore Fieldwork Project",orflr_2008_155.xml,80444/xv10192,0,0,0,0
"Bulat (Alec) Student Folklore Fieldwork Project",orflr_2011_007.xml,80444/xv04605,0,0,0,0
"Student Folklore Fieldwork Project",orflr_1973_217.xml,80444/xv88650,0,0,0,0
"Voll (Dawn) Student Folklore Fieldwork Project",orflr_1985_050.xml,80444/xv14334,0,0,0,0
"McFall (Kyle) Student Folklore Fieldwork Project",orflr_2008_060.xml,80444/xv92022,0,0,0,0
"Anonymous Student Folklore Fieldwork Project",orflr_1972_089.xml,80444/xv71966,0,0,0,0
"Naegle (Vance) Student Folklore Fieldwork Project",orflr_1984_050.xml,80444/xv48382,0,0,0,0
"Gonzalez (Teresa) Student Folklore Fieldwork Project",orflr_2004_003.xml,80444/xv32043,0,0,0,0
"Brown (Shannon) Student Folklore Fieldwork Project",orflr_1974_221.xml,80444/xv26171,0,0,0,0
"McCollister (Maegan) Student Folklore Fieldwork Project",orflr_2008_106.xml,80444/xv72436,0,0,0,0
"Gutwig (Leslie) Student Folklore Fieldwork Project",orflr_2012_063.xml,80444/xv98477,0,0,0,0
"Tollefson (Deborah D.) Student Folklore Fieldwork Project",orflr_1973_089.xml,80444/xv70440,0,0,0,0
"McFarlane (David) Student Folklore Fieldwork Project",orflr_1974_030.xml,80444/xv71206,0,0,0,0
"Steward (Anne) Student Folklore Fieldwork Project",orflr_2008_161.xml,80444/xv54611,0,0,0,0
"Van Devender (Carolyn) Student Folklore Fieldwork Project",orflr_1986_023.xml,80444/xv85229,0,0,0,0
"Dalton (Tresa) Student Folklore Fieldwork Project",orflr_2008_184.xml,80444/xv95251,0,0,0,0
"Cox (Nicholas) Student Folklore Fieldwork Project",orflr_2006_053.xml,80444/xv64529,0,0,0,0
"Barich (Tony) Student Folklore Fieldwork Project",orflr_1972_022.xml,80444/xv69009,0,0,0,0
"Moore (Sean) Student Folklore Fieldwork Project",orflr_2008_123.xml,80444/xv50250,0,0,0,0
"Harris (Christopher) Student Folklore Fieldwork Project",orflr_1993_011.xml,80444/xv46539,0,0,0,0
"Romero (Jose) Student Folklore Fieldwork Project",orflr_1993_008.xml,80444/xv39230,0,0,0,0
"Glazer (Michele) Student Folklore Fieldwork Project",orflr_1976_041.xml,80444/xv33383,0,0,0,0
"Lohman (Jason) Student Folklore Fieldwork Project",orflr_2008_173.xml,80444/xv91546,0,0,0,0
"Logan (Ross) Student Folklore Fieldwork Project",orflr_2007_004.xml,80444/xv58633,0,0,0,0
"H. (Frank) Student Folklore Fieldwork Project",orflr_1987_004.xml,80444/xv42877,0,0,0,0
"Benedetti (Bonnie) Student Folklore Fieldwork Project",orflr_1972_183.xml,80444/xv28317,0,0,0,0
"Mauritz (Larry) Student Folklore Fieldwork Project",orflr_1974_167.xml,80444/xv69070,0,0,0,0
"House (Seymour) Student Folklore Fieldwork Project",orflr_1975_024.xml,80444/xv39440,0,0,0,0
"Friem (Shannon) Student Folklore Fieldwork Project",orflr_1974_078.xml,80444/xv22372,0,0,0,0
"Herdklotz-Yasutake (Allegra) Student Folklore Fieldwork Project",orflr_2008_100.xml,80444/xv37832,0,0,0,0
"Hilliard (Jacquelyn) Student Folklore Fieldwork Project",orflr_1975_131.xml,80444/xv64660,0,0,0,0
"Brennan (Margaret) Student Folklore Fieldwork Project",orflr_1976_096.xml,80444/xv65240,0,0,0,0
"Losco (Rosanne) Student Folklore Fieldwork Project",orflr_1975_137.xml,80444/xv18838,0,0,0,0
"Landstrom (Lindsay E.) Student Folklore Fieldwork Project",orflr_2010_114.xml,80444/xv53097,0,0,0,0
"Cooper (Peter) Student Folklore Fieldwork Project",orflr_1977_099.xml,80444/xv75451,0,0,0,0
"Sherman (Julia) Student Folklore Fieldwork Project",orflr_2008_078.xml,80444/xv38290,0,0,0,0
"Gonzalez (Veronica) Student Folklore Fieldwork Project",orflr_2010_006.xml,80444/xv82147,0,0,0,0
"Brown (Carla) Student Folklore Fieldwork Project",orflr_1982_025.xml,80444/xv57510,0,0,0,0
"Omlid (Rod F.) Student Folklore Fieldwork Project",orflr_1975_104.xml,80444/xv61676,0,0,0,0
"Williamson (John L.) Student Folklore Fieldwork Project",orflr_1983_029.xml,80444/xv97781,0,0,0,0
"Markiz (Jeremy) Student Folklore Fieldwork Project",orflr_2006_024.xml,80444/xv08377,0,0,0,0
"Chavez (Robyn) Student Folklore Fieldwork Project",orflr_2008_163.xml,80444/xv14941,0,0,0,0
"Swearingen (Loretta L.) Student Folklore Fieldwork Project",orflr_1984_025.xml,80444/xv18884,0,0,0,0
"Redfield (Kerri Lynn) Student Folklore Fieldwork Project",orflr_1992_018.xml,80444/xv20510,0,0,0,0
"Kolstoe (Douglas) Student Folklore Fieldwork Project",orflr_1977_109.xml,80444/xv71182,0,0,0,0
"Burnham (Austin C.) Student Folklore Fieldwork Project",orflr_1977_021.xml,80444/xv41708,0,0,0,0
"Tung-yi (Kho) Student Folklore Fieldwork Project",orflr_2009_008.xml,80444/xv28128,0,0,0,0
"Hill (Margaret Thompson) Student Folklore Fieldwork Project",orflr_1977_164.xml,80444/xv02032,0,0,0,0
"Wagner (Kimberly) Student Folklore Fieldwork Project",orflr_2005_009.xml,80444/xv85122,0,0,0,0
"Pattillo (Ceil A.) Student Folklore Fieldwork Project",orflr_1976_068.xml,80444/xv09402,0,0,0,0
"Neeley (Kathy) Student Folklore Fieldwork Project",orflr_1975_102.xml,80444/xv94290,0,0,0,0
"Student Folklore Fieldwork Project",orflr_1973_215.xml,80444/xv00271,0,0,0,0
"Masuyama (Erick Eiichi) Student Folklore Fieldwork Project",orflr_1986_028.xml,80444/xv88076,0,0,0,0
"Costales (Dawn) Student Folklore Fieldwork Project",orflr_1980_002.xml,80444/xv85690,0,0,0,0
"Martinez (Elena) Student Folklore Fieldwork Project",orflr_1997_006.xml,80444/xv15994,0,0,0,0
"Thompson (Trudy) Student Folklore Fieldwork Project",orflr_1975_114.xml,80444/xv59506,0,0,0,0
"Sellai (Christine A.) Student Folklore Fieldwork Project",orflr_1990_019.xml,80444/xv73751,0,0,0,0
"Hirschy (Jessica) Student Folklore Fieldwork Project",orflr_2012_074.xml,80444/xv19659,0,0,0,0
"Wilder (Warren W.) Student Folklore Fieldwork Project",orflr_1973_095.xml,80444/xv12286,0,0,0,0
"Student Folklore Fieldwork Project",orflr_1973_242.xml,80444/xv63537,0,0,0,0
"Langford (Terri S.) Student Folklore Fieldwork Project",orflr_1987_027.xml,80444/xv02905,0,0,0,0
"Whitaker (Jim) Student Folklore Fieldwork Project",orflr_1976_162.xml,80444/xv58465,0,0,0,0
"Lee (Marianne) Student Folklore Fieldwork Project",orflr_1974_158.xml,80444/xv99432,0,0,0,0
"Burchak (Wally) Student Folklore Fieldwork Project",orflr_1987_003.xml,80444/xv76525,0,0,0,0
"Jones (Laurie) Student Folklore Fieldwork Project",orflr_1991_014.xml,80444/xv23852,0,0,0,0
"Baker (James C.) Student Folklore Fieldwork Project",orflr_1969_076.xml,80444/xv58978,0,0,0,0
"Glatt (Zachary) Student Folklore Fieldwork Project",orflr_2008_006.xml,80444/xv23080,0,0,0,0
"Dailey (Kathleen) Student Folklore Fieldwork Project",orflr_1981_018.xml,80444/xv54241,0,0,0,0
"Conner (Susan) Student Folklore Fieldwork Project",orflr_1985_008.xml,80444/xv18280,0,0,0,0
"Poston (Forrest D.) Student Folklore Fieldwork Project",orflr_1986_018.xml,80444/xv87768,0,0,0,0
"Jorden (Kathryn) Student Folklore Fieldwork Project",orflr_1974_154.xml,80444/xv41525,0,0,0,0
"Collins (Kristin) Student Folklore Fieldwork Project",orflr_2010_035.xml,80444/xv12246,0,0,0,0
"Aoki (Andrew L.) Student Folklore Fieldwork Project",orflr_1977_096.xml,80444/xv26361,0,0,0,0
"Caylger (Ashley) Student Folklore Fieldwork Project",orflr_2002_042.xml,80444/xv91952,0,0,0,0
"Sharp (Karen Lee) Student Folklore Fieldwork Project",orflr_1981_002.xml,80444/xv55941,0,0,0,0
"Cheney (Carol) Student Folklore Fieldwork Project",orflr_1990_007.xml,80444/xv19464,0,0,0,0
"Childs (Alex) Student Folklore Fieldwork Project",orflr_2011_009.xml,80444/xv22210,0,0,0,0
"Engiles (James G.) Student Folklore Fieldwork Project",orflr_1975_088.xml,80444/xv68530,0,0,0,0
"Student Folklore Fieldwork Project",orflr_1973_249.xml,80444/xv76376,0,0,0,0
"Bazanele (Michael A.) Student Folklore Fieldwork Project",orflr_2006_039.xml,80444/xv08093,0,0,0,0
"Vingelen (Sheryl) Student Folklore Fieldwork Project",orflr_1974_299.xml,80444/xv08688,0,0,0,0
"Krause (Joe) Student Folklore Fieldwork Project",orflr_1971_118.xml,80444/xv11715,0,0,0,0
"Peterson (Ian) Student Folklore Fieldwork Project",orflr_2010_079.xml,80444/xv99893,0,0,0,0
"Dughri (Amira) Student Folklore Fieldwork Project",orflr_2004_010.xml,80444/xv46038,0,0,0,0
"Brady (Stephen) Student Folklore Fieldwork Project",orflr_1992_012.xml,80444/xv78491,0,0,0,0
"Yundt (Robin) Student Folklore Fieldwork Project",orflr_1974_306.xml,80444/xv28469,0,0,0,0
"Cheney (Elizabeth) Student Folklore Fieldwork Project",orflr_1974_222.xml,80444/xv95318,0,0,0,0
"Eggink (Kimberly J.) Student Folklore Fieldwork Project",orflr_1977_060.xml,80444/xv01892,0,0,0,0
"Student Folklore Fieldwork Project",orflr_1973_330.xml,80444/xv85827,0,0,0,0
"Gehrmann (Charlie) Student Folklore Fieldwork Project",orflr_1977_028.xml,80444/xv78607,0,0,0,0
"Bradley (Brenda) Student Folklore Fieldwork Project",orflr_1993_007.xml,80444/xv36727,0,0,0,0
"Guo (Grant M.) Student Folklore Fieldwork Project",orflr_2008_142.xml,80444/xv48361,0,0,0,0
"Inahara (Laurie) Student Folklore Fieldwork Project",orflr_1977_140.xml,80444/xv09912,0,0,0,0
"Carpenter (Stephanie M.) Student Folklore Fieldwork Project",orflr_2003_021.xml,80444/xv30651,0,0,0,0
"Posavatz (Alana) Student Folklore Fieldwork Project",orflr_2006_050.xml,80444/xv42703,0,0,0,0
"Nelson (Howard) Student Folklore Fieldwork Project",orflr_1972_171.xml,80444/xv46343,0,0,0,0
"Student Folklore Fieldwork Project",orflr_1971_347.xml,80444/xv93264,0,0,0,0
"Dyal (James G.) Student Folklore Fieldwork Project",orflr_1973_036.xml,80444/xv56256,0,0,0,0
"Vincent (Wayne) Student Folklore Fieldwork Project",orflr_1986_024.xml,80444/xv28518,0,0,0,0
"Cliff (Janet M.) Student Folklore Fieldwork Project",orflr_1984_007.xml,80444/xv98800,0,0,0,0
"Student Folklore Fieldwork Project",orflr_1973_221.xml,80444/xv76037,0,0,0,0
"Hancock (Robert) Student Folklore Fieldwork Project",orflr_1972_035.xml,80444/xv14111,0,0,0,0
"Nelson (Robert) Student Folklore Fieldwork Project",orflr_1973_072.xml,80444/xv22378,0,0,0,0
"Smith (Jennifer) Student Folklore Fieldwork Project",orflr_2006_011.xml,80444/xv67825,0,0,0,0
"Smith (Karin) Student Folklore Fieldwork Project",orflr_1974_089.xml,80444/xv11688,0,0,0,0
"Dean (Tom) Student Folklore Fieldwork Project",orflr_1985_000.xml,80444/xv34646,0,0,0,0
"Glantz (Chelsea) Student Folklore Fieldwork Project",orflr_2008_194.xml,80444/xv59893,0,0,0,0
"Baker (Kenneth D.) Student Folklore Fieldwork Project",orflr_1972_018.xml,80444/xv89413,0,0,0,0
"Sterton (Gary) Student Folklore Fieldwork Project",orflr_1975_050.xml,80444/xv98995,0,0,0,0
"Blake (Joe) Student Folklore Fieldwork Project",orflr_2006_055.xml,80444/xv06478,0,0,0,0
"Yamashiro (Carla) Student Folklore Fieldwork Project",orflr_1987_049.xml,80444/xv24105,0,0,0,0
"Hart (Allan) Student Folklore Fieldwork Project",orflr_1972_062.xml,80444/xv17462,0,0,0,0
"Delaval (Renee) Student Folklore Fieldwork Project",orflr_2008_166.xml,80444/xv22476,0,0,0,0
"LaMonte (Robin) Student Folklore Fieldwork Project",orflr_1972_126.xml,80444/xv37097,0,0,0,0
"Medland (Linda) Student Folklore Fieldwork Project",orflr_1972_132.xml,80444/xv54003,0,0,0,0
"Clason (Leslie D.) Student Folklore Fieldwork Project",orflr_1984_043.xml,80444/xv55465,0,0,0,0
"Huffman (Tom) Student Folklore Fieldwork Project",orflr_1984_059.xml,80444/xv92376,0,0,0,0
"Student Folklore Fieldwork Project",orflr_1971_398.xml,80444/xv21423,0,0,0,0
"Wayne (Vincent) Student Folklore Fieldwork Project",orflr_1990_026.xml,80444/xv65942,0,0,0,0
"Student Folklore Fieldwork Project",orflr_1973_365.xml,80444/xv45965,0,0,0,0
"Winner (Elizabeth Rose) Student Folklore Fieldwork Project",orflr_2008_193.xml,80444/xv43847,0,0,0,0
"Milgram (Miriam) Student Folklore Fieldwork Project",orflr_1987_055.xml,80444/xv00122,0,0,0,0
"Nagle (David) Student Folklore Fieldwork Project",orflr_1989_024.xml,80444/xv81954,0,0,0,0
"Noel (Jim) Student Folklore Fieldwork Project",orflr_1977_046.xml,80444/xv06137,0,0,0,0
"Dallas (Karen) Student Folklore Fieldwork Project",orflr_1974_319.xml,80444/xv86077,0,0,0,0
"Briot (Chrisanne) Student Folklore Fieldwork Project",orflr_1976_005.xml,80444/xv18695,0,0,0,0
"Stanton (Cindy)Student Folklore Fieldwork Project",orflr_1985_046.xml,80444/xv45812,0,0,0,0
"Miller (Mike) Student Folklore Fieldwork Project",orflr_1977_114.xml,80444/xv69323,0,0,0,0
"Marshall (Keith) Student Folklore Fieldwork Project",orflr_1972_047.xml,80444/xv10455,0,0,0,0
"Milgram (Miriam) Student Folklore Fieldwork Project",orflr_1988_025.xml,80444/xv02444,0,0,0,0
"Anonymous Student Folklore Fieldwork Project",orflr_1981_039.xml,80444/xv37402,0,0,0,0
"McRae (Rob) Student Folklore Fieldwork Project",orflr_2006_035.xml,80444/xv05319,0,0,0,0
"Wright (Ron) Student Folklore Fieldwork Project",orflr_1975_158.xml,80444/xv60961,0,0,0,0
"Sundby (Mark) Student Folklore Fieldwork Project",orflr_1977_089.xml,80444/xv95498,0,0,0,0
"Skinner Student Folklore Fieldwork Project",orflr_1993_019.xml,80444/xv57897,0,0,0,0
"Fisher (Ann H.) Student Folklore Fieldwork Project",orflr_1975_089.xml,80444/xv61755,0,0,0,0
"Wills (Preston A.) Student Folklore Fieldwork Project",orflr_1974_199.xml,80444/xv35760,0,0,0,0
"Leonard (Adam) Student Folklore Fieldwork Project",orflr_2002_032.xml,80444/xv17501,0,0,0,0
"Student Folklore Fieldwork Project",orflr_1973_133.xml,80444/xv57614,0,0,0,0
"Safranski (Mary E. (Beth)) Student Folklore Fieldwork Project",orflr_1987_053.xml,80444/xv79772,0,0,0,0
"Cress (John) Student Folklore Fieldwork Project",orflr_2012_037.xml,80444/xv22531,0,0,0,0
"Thompson (Sandra) Student Folklore Fieldwork Project",orflr_1993_012.xml,80444/xv82473,0,0,0,0
"Brastad (J.P.) Student Folklore Fieldwork Project",orflr_1994_004.xml,80444/xv60968,0,0,0,0
"Colleary (Kellie) Student Folklore Fieldwork Project",orflr_1980_048.xml,80444/xv79418,0,0,0,0
"Waggener (Mitchell S.) Student Folklore Fieldwork Project",orflr_1972_074.xml,80444/xv16281,0,0,0,0
"Fisher (Bruce J.) Student Folklore Fieldwork Project",orflr_1971_331.xml,80444/xv39215,0,0,0,0
"Vrtis (Christina) Folklore Thesis",orflr_2010_122.xml,80444/xv48434,0,0,0,0
"Tiddens (Katherine) Student Folklore Fieldwork Project",orflr_1972_061.xml,80444/xv06286,0,0,0,0
"Scofield (Twilo) Student Folklore Fieldwork Project",orflr_1976_113.xml,80444/xv41830,0,0,0,0
"Miller (Linda Lorene) Student Folklore Fieldwork Project",orflr_1972_134.xml,80444/xv98220,0,0,0,0
"Weber (Brian) Student Folklore Fieldwork Project",orflr_2008_083.xml,80444/xv80361,0,0,0,0
"Davis (Carrie L.) Student Folklore Fieldwork Project",orflr_1982_005.xml,80444/xv58337,0,0,0,0
"Rodak (Janet) Student Folklore Fieldwork Project",orflr_1984_023.xml,80444/xv36975,0,0,0,0
"Coates (Audrey) Student Folklore Fieldwork Project",orflr_2006_045.xml,80444/xv80017,0,0,0,0
"Student Folklore Fieldwork Project",orflr_1975_142.xml,80444/xv67669,0,0,0,0
"Corthell (Katie) Student Folklore Fieldwork Project",orflr_1984_014.xml,80444/xv06234,0,0,0,0
"Maitlen (Stuart A.) Student Folklore Fieldwork Project",orflr_1987_034.xml,80444/xv34350,0,0,0,0
"Liolo (Bill) Student Folklore Fieldwork Project",orflr_1972_127.xml,80444/xv65316,0,0,0,0
"Chin (Elaine) Student Folklore Fieldwork Project",orflr_1982_026.xml,80444/xv13513,0,0,0,0
"Vincent (Wayne) Student Folklore Fieldwork Project",orflr_1989_033.xml,80444/xv08795,0,0,0,0
"Brandsnees (Betsy) Student Folklore Fieldwork Project",orflr_1977_137.xml,80444/xv65536,0,0,0,0
"Walker (Timothy E.) Student Folklore Fieldwork Project",orflr_1986_026.xml,80444/xv67193,0,0,0,0
"Jones (Alex) Student Folklore Fieldwork Project",orflr_2012_084.xml,80444/xv04016,0,0,0,0
"White (Wendy G.) Student Folklore Fieldwork Project",orflr_1981_053.xml,80444/xv64068,0,0,0,0
"Student Folklore Fieldwork Project",orflr_1973_321.xml,80444/xv08392,0,0,0,0
"Keller (Johanna) Student Folklore Fieldwork Project",orflr_1970_097.xml,80444/xv57186,0,0,0,0
"Sirkis (Lauren D.) Student Folklore Fieldwork Project",orflr_1977_124.xml,80444/xv34521,0,0,0,0
"Student Folklore Fieldwork Project",orflr_1973_122.xml,80444/xv03274,0,0,0,0
"James (Thomas) Student Folklore Fieldwork Project",orflr_2008_202.xml,80444/xv91381,0,0,0,0
"Conversano (Lorraine I.) Student Folklore Fieldwork Project",orflr_1974_227.xml,80444/xv36242,0,0,0,0
"Beebe (Whitney) Student Folklore Fieldwork Project",orflr_2002_021.xml,80444/xv70767,0,0,0,0
"DeLaunay (Janine) Student Folklore Fieldwork Project",orflr_1976_136.xml,80444/xv04943,0,0,0,0
"Frost (Susan M.) Student Folklore Fieldwork Project",orflr_1973_039.xml,80444/xv76507,0,0,0,0
"Wandling (Therese) Student Folklore Fieldwork Project",orflr_1971_273.xml,80444/xv84347,0,0,0,0
"McGowan (Barbara) Student Folklore Fieldwork Project",orflr_1974_004.xml,80444/xv21884,0,0,0,0
"Haynes (Sandra) Student Folklore Fieldwork Project",orflr_1986_013.xml,80444/xv03607,0,0,0,0
"Caire (Donna) Student Folklore Fieldwork Project",orflr_1977_071.xml,80444/xv02780,0,0,0,0
"Davis (Gordon R.) Student Folklore Fieldwork Project",orflr_1977_024.xml,80444/xv70184,0,0,0,0
"Girardi (Janice) Student Folklore Fieldwork Project",orflr_1973_044.xml,80444/xv18310,0,0,0,0
"Myers (Jill) Student Folklore Fieldwork Project",orflr_1984_033.xml,80444/xv71124,0,0,0,0
"Smith (Joe K.) Student Folklore Fieldwork Project",orflr_1974_286.xml,80444/xv35800,0,0,0,0
"Dawson (Carol) Student Folklore Fieldwork Project",orflr_1972_107.xml,80444/xv94619,0,0,0,0
"Hanberg (Greg) Student Folklore Fieldwork Project",orflr_1979_032.xml,80444/xv21466,0,0,0,0
"Rota (Lily) Student Folklore Fieldwork Project",orflr_2006_025.xml,80444/xv95019,0,0,0,0
"Pomroy (Kenji) Student Folklore Fieldwork Project",orflr_1974_077.xml,80444/xv29953,0,0,0,0
"Taylor (D. Scott) Student Folklore Fieldwork Project",orflr_1984_055.xml,80444/xv36831,0,0,0,0
"Pietryk (Suzanne) Student Folklore Fieldwork Project",orflr_1974_034.xml,80444/xv03692,0,0,0,0
"Economus (Tina) Student Folklore Fieldwork Project",orflr_1976_138.xml,80444/xv36157,0,0,0,0
"Voves (Steve) Student Folklore Fieldwork Project",orflr_1973_092.xml,80444/xv74429,0,0,0,0
"Sigler (Jan) Student Folklore Fieldwork Project",orflr_1974_183.xml,80444/xv39096,0,0,0,0
"Student Folklore Fieldwork Project",orflr_1973_280.xml,80444/xv09756,0,0,0,0
"Kendall (Lisa) Student Folklore Fieldwork Project",orflr_1990_012.xml,80444/xv16656,0,0,0,0
"Student Folklore Fieldwork Project",orflr_1973_184.xml,80444/xv99710,0,0,0,0
"Geddy (Pam) Student Folklore Fieldwork Project",orflr_1971_198.xml,80444/xv66574,0,0,0,0
"Baker (James C.) Student Folklore Fieldwork Project",orflr_1970_037.xml,80444/xv04571,0,0,0,0
"Kriekis (Carol) Student Folklore Fieldwork Project",orflr_1976_018.xml,80444/xv79965,0,0,0,0
"Flint (Mason) Student Folklore Fieldwork Project",orflr_2012_055.xml,80444/xv56048,0,0,0,0
"Moak (Kathleen M.) Student Folklore Fieldwork Project",orflr_1972_135.xml,80444/xv84295,0,0,0,0
"Trenholm (Terry B.) Student Folklore Fieldwork Project",orflr_1971_091.xml,80444/xv25341,0,0,0,0
"Student Folklore Fieldwork Project",orflr_1973_110.xml,80444/xv87347,0,0,0,0
"Sherburne (Philip F.) Student Folklore Fieldwork Project",orflr_1974_285.xml,80444/xv35052,0,0,0,0
"Harris (Carol S.) Student Folklore Fieldwork Project",orflr_1975_093.xml,80444/xv86645,0,0,0,0
"Goldsmith (Bill) Student Folklore Fieldwork Project",orflr_1989_006.xml,80444/xv39108,0,0,0,0
"Vercelli (George, Jr.) Student Folklore Fieldwork Project",orflr_1977_135.xml,80444/xv40283,0,0,0,0
"Kramer (Boyd) Student Folklore Fieldwork Project",orflr_1974_157.xml,80444/xv95452,0,0,0,0
"Smoyer (Carole) Student Folklore Fieldwork Project",orflr_1984_054.xml,80444/xv59405,0,0,0,0
"Student Folklore Fieldwork Project",orflr_1973_323.xml,80444/xv64816,0,0,0,0
"Allen (Virginia) Student Folklore Fieldwork Project",orflr_1973_007.xml,80444/xv30218,0,0,0,0
"Moore (Eric) Student Folklore Fieldwork Project",orflr_1985_035.xml,80444/xv65515,0,0,0,0
"Barnes (David) Student Folklore Fieldwork Project",orflr_1992_011.xml,80444/xv84182,0,0,0,0
"N (Zak) Student Folklore Fieldwork Project",orflr_2008_030.xml,80444/xv39077,0,0,0,0
"Mitchell (Amy) Student Folklore Fieldwork Project",orflr_1990_016.xml,80444/xv44445,0,0,0,0
"Deur (Douglas) Student Folklore Fieldwork Project",orflr_1987_015.xml,80444/xv82000,0,0,0,0
"Altig (Jeff) Student Folklore Fieldwork Project",orflr_1982_125.xml,80444/xv99768,0,0,0,0
"Rodin (Jane) Student Folklore Fieldwork Project",orflr_1977_050.xml,80444/xv84552,0,0,0,0
"Dreeson (Daniel P.) Student Folklore Fieldwork Project",orflr_1992_026.xml,80444/xv06365,0,0,0,0
"Welsh (Robert T.) Student Folklore Fieldwork Project",orflr_1974_012.xml,80444/xv86093,0,0,0,0
"Iselin (Megan) Student Folklore Fieldwork Project",orflr_2012_079.xml,80444/xv40155,0,0,0,0
"Wilcox (Andrew Chisholm) Student Folklore Fieldwork Project",orflr_2008_075.xml,80444/xv37411,0,0,0,0
"Student Folklore Fieldwork Project",orflr_1973_331.xml,80444/xv89859,0,0,0,0
"Sohlarb (Pamela Carpenter) Student Folklore Fieldwork Project",orflr_1974_284.xml,80444/xv14279,0,0,0,0
"Pate (A.) Student Folklore Fieldwork Project",orflr_1987_039.xml,80444/xv56353,0,0,0,0
"Hayes (Virginia) Student Folklore Fieldwork Project",orflr_1975_021.xml,80444/xv87451,0,0,0,0
"Haub (Courtny) Student Folklore Fieldwork Project",orflr_2006_028.xml,80444/xv72625,0,0,0,0
"Slagle (Sheryl K.) Student Folklore Fieldwork Project",orflr_1980_041.xml,80444/xv06060,0,0,0,0
"Olsen (Nancy Elizabeth) Student Folklore Fieldwork Project",orflr_1972_172.xml,80444/xv23764,0,0,0,0
"Lorain (Christine) Student Folklore Fieldwork Project",orflr_1980_032.xml,80444/xv75082,0,0,0,0
"West (Sarah) Student Folklore Fieldwork Project",orflr_2008_065.xml,80444/xv33541,0,0,0,0
"Moura (Joan A.) Student Folklore Fieldwork Project",orflr_1983_025.xml,80444/xv45797,0,0,0,0
"Gresham (Kirsten) Student Folklore Fieldwork Project",orflr_1976_045.xml,80444/xv59780,0,0,0,0
"Williams (Emily) Student Folklore Fieldwork Project",orflr_2008_212.xml,80444/xv48483,0,0,0,0
"Student Folklore Fieldwork Project",orflr_1973_123.xml,80444/xv03305,0,0,0,0
"Storr (Cecilia) Student Folklore Fieldwork Project",orflr_1975_070.xml,80444/xv17547,0,0,0,0
"Whittle (Makenzie) Student Folklore Fieldwork Project",orflr_2008_014.xml,80444/xv79119,0,0,0,0
"Coleman (Callan T.) Student Folklore Fieldwork Project",orflr_1989_017.xml,80444/xv09844,0,0,0,0
"Ditto (Patsy) Student Folklore Fieldwork Project",orflr_1975_064.xml,80444/xv28414,0,0,0,0
"Brandt (Eric) Student Folklore Fieldwork Project",orflr_1973_017.xml,80444/xv94900,0,0,0,0
"Student Folklore Fieldwork Project",orflr_1973_115.xml,80444/xv58999,0,0,0,0
"Ristau (Katherine Jane) Folklore Thesis",orflr_2010_118.xml,80444/xv36172,0,0,0,0
"Halter (Myrna) Student Folklore Fieldwork Project",orflr_1976_098.xml,80444/xv31762,0,0,0,0
"Compesi (Ron) Student Folklore Fieldwork Project",orflr_1975_084.xml,80444/xv31747,0,0,0,0
"Student Folklore Fieldwork Project",orflr_1973_281.xml,80444/xv31768,0,0,0,0
"Student Folklore Fieldwork Project",orflr_1973_148.xml,80444/xv82186,0,0,0,0
"Van Buren (Jessica) Student Folklore Fieldwork Project",orflr_1985_049.xml,80444/xv01229,0,0,0,0
"Student Folklore Fieldwork Project",orflr_1973_367.xml,80444/xv17373,0,0,0,0
"Sevetson (Erika Z.) Student Folklore Fieldwork Project",orflr_1989_045.xml,80444/xv41458,0,0,0,0
"Hjelte (Jeff) Student Folklore Fieldwork Project",orflr_1984_015.xml,80444/xv57226,0,0,0,0
"Lowe (Sarah) Student Folklore Fieldwork Project",orflr_2008_023.xml,80444/xv46658,0,0,0,0
"Reed (Suzanne) Student Folklore Fieldwork Project",orflr_2008_102.xml,80444/xv09472,0,0,0,0
"Reiley (Darren C.) Student Folklore Fieldwork Project",orflr_2000_002.xml,80444/xv94589,0,0,0,0
"Duncan (Mike) Student Folklore Fieldwork Project",orflr_1984_044.xml,80444/xv28909,0,0,0,0
"Sheehy (John F.) Student Folklore Fieldwork Project",orflr_2010_013.xml,80444/xv26507,0,0,0,0
"Hunt (Tim) Student Folklore Fieldwork Project",orflr_1976_119.xml,80444/xv54284,0,0,0,0
"Costine (Michele A.) Student Folklore Fieldwork Project",orflr_1974_132.xml,80444/xv24276,0,0,0,0
"Kosmatka (David) Student Folklore Fieldwork Project",orflr_2001_005.xml,80444/xv85296,0,0,0,0
"Goulette (Steven) Student Folklore Fieldwork Project",orflr_1976_042.xml,80444/xv52096,0,0,0,0
"Cookson (Richard) Student Folklore Fieldwork Project",orflr_1973_028.xml,80444/xv19650,0,0,0,0
"Barnes (Scott) Student Folklore Fieldwork Project",orflr_1984_039.xml,80444/xv91390,0,0,0,0
"Phinney (James) Student Folklore Fieldwork Project",orflr_1974_278.xml,80444/xv84671,0,0,0,0
"Student Folklore Fieldwork Project",orflr_1973_209.xml,80444/xv58364,0,0,0,0
"Schroeder (Margaret) Student Folklore Fieldwork Project",orflr_2010_090.xml,80444/xv82882,0,0,0,0
"Hobbs (Richard A.) Student Folklore Fieldwork Project",orflr_1971_047.xml,80444/xv39062,0,0,0,0
"Cohen (Helen) Student Folklore Fieldwork Project",orflr_1974_130.xml,80444/xv06002,0,0,0,0
"Student Folklore Fieldwork Project",orflr_1972_013.xml,80444/xv60803,0,0,0,0
"Miller (Tim) Student Folklore Fieldwork Project",orflr_1987_035.xml,80444/xv50765,0,0,0,0
"Govig (Ashley) Student Folklore Fieldwork Project",orflr_2008_028.xml,80444/xv26470,0,0,0,0
"Riseborough (Joseph) Student Folklore Fieldwork Project",orflr_1982_038.xml,80444/xv98562,0,0,0,0
"Legue (Victoria) Student Folklore Fieldwork Project",orflr_2011_027.xml,80444/xv39874,0,0,0,0
"Ronning (Kathleen S.) Student Folklore Fieldwork Project",orflr_1976_155.xml,80444/xv32675,0,0,0,0
"Crew (Sophie) Student Folklore Fieldwork Project",orflr_2012_038.xml,80444/xv62463,0,0,0,0
"Briger (Sam) Student Folklore Fieldwork Project",orflr_2001_003.xml,80444/xv41754,0,0,0,0
"Egan (Brian) Student Folklore Fieldwork Project",orflr_1981_040.xml,80444/xv74972,0,0,0,0
"Popick (Eadi) Student Folklore Fieldwork Project",orflr_1977_084.xml,80444/xv41854,0,0,0,0
"Mann (Kathy) Student Folklore Fieldwork Project",orflr_1977_040.xml,80444/xv28491,0,0,0,0
"Phay (Margaret) Student Folklore Fieldwork Project",orflr_1977_048.xml,80444/xv04556,0,0,0,0
"Crook (Kalayna) Student Folklore Fieldwork Project",orflr_2008_148.xml,80444/xv62295,0,0,0,0
"Nolan (Mary) Student Folklore Fieldwork Project",orflr_1982_094.xml,80444/xv30377,0,0,0,0
"Hutton (Mallorey) Student Folklore Fieldwork Project",orflr_2012_077.xml,80444/xv20025,0,0,0,0
"Rothschild (James) Student Folklore Fieldwork Project",orflr_2006_056.xml,80444/xv71258,0,0,0,0
"Barry-Stevens (Susan) Student Folklore Fieldwork Project",orflr_1976_094.xml,80444/xv57485,0,0,0,0
"Student Folklore Fieldwork Project",orflr_1973_360.xml,80444/xv88064,0,0,0,0
"Huffman (Stephanie) Student Folklore Fieldwork Project",orflr_1996_025.xml,80444/xv66494,0,0,0,0
"Sevde (Karin) Student Folklore Fieldwork Project",orflr_1985_010.xml,80444/xv29647,0,0,0,0
"Pollard (Christopher) Student Folklore Fieldwork Project",orflr_2006_031.xml,80444/xv75131,0,0,0,0
"Barnes (Steven) Student Folklore Fieldwork Project",orflr_2008_183.xml,80444/xv01510,0,0,0,0
"Evans (Alison) Student Folklore Fieldwork Project",orflr_1972_110.xml,80444/xv27301,0,0,0,0
"Garrison-Terry (Porter) Student Folklore Fieldwork Project",orflr_2010_104.xml,80444/xv91198,0,0,0,0
"Heberling (C. Roger) Student Folklore Fieldwork Project",orflr_1974_146.xml,80444/xv51025,0,0,0,0
"Kinoshita (Norma) Student Folklore Fieldwork Project",orflr_1981_044.xml,80444/xv09884,0,0,0,0
"Richardson (Steve) Student Folklore Fieldwork Project",orflr_1987_046.xml,80444/xv27767,0,0,0,0
"Student Folklore Fieldwork Project",orflr_1973_264.xml,80444/xv49703,0,0,0,0
"Spady (Susan) Student Folklore Fieldwork Project",orflr_1985_045.xml,80444/xv43072,0,0,0,0
"Spracklen (Amy) Student Folklore Fieldwork Project",orflr_1993_021.xml,80444/xv30300,0,0,0,0
"Humphreys (James) Student Folklore Fieldwork Project",orflr_2009_010.xml,80444/xv19946,0,0,0,0
"Pierson (Paul) Student Folklore Fieldwork Project",orflr_1984_052.xml,80444/xv45028,0,0,0,0
"Hughes (Barbara J.) Student Folklore Fieldwork Project",orflr_1980_028.xml,80444/xv28158,0,0,0,0
"Thompson (Renee) Student Folklore Fieldwork Project",orflr_1985_048.xml,80444/xv69390,0,0,0,0
"Wasmann (Janice) Student Folklore Fieldwork Project",orflr_1976_128.xml,80444/xv37268,0,0,0,0
"Jamieson (Elizabeth) Student Folklore Fieldwork Project",orflr_2002_074.xml,80444/xv45245,0,0,0,0
"Hartmann (Chelsea) Student Folklore Fieldwork Project",orflr_2010_045.xml,80444/xv49169,0,0,0,0
"Harris (Timothy) Student Folklore Fieldwork Project",orflr_1976_047.xml,80444/xv44918,0,0,0,0
"Notthoff (Ann) Student Folklore Fieldwork Project",orflr_1975_147.xml,80444/xv41168,0,0,0,0
"Blumberg (Jamie) Student Folklore Fieldwork Project",orflr_2001_004.xml,80444/xv48880,0,0,0,0
"Choun (Kent) Student Folklore Fieldwork Project",orflr_1974_057.xml,80444/xv13796,0,0,0,0
"Sloan (Kelly) Student Folklore Fieldwork Project",orflr_1980_042.xml,80444/xv02914,0,0,0,0
"Conner (Susan) Student Folklore Fieldwork Project",orflr_1984_004.xml,80444/xv66659,0,0,0,0
"Vradenburgh (Elaine) Student Folklore Fieldwork Project",orflr_2008_036.xml,80444/xv73107,0,0,0,0
"West (Kevin) Student Folklore Fieldwork Project",orflr_1977_057.xml,80444/xv94256,0,0,0,0
"Stellavato (Mickey) Student Folklore Fieldwork Project",orflr_2004_013.xml,80444/xv18963,0,0,0,0
"Barnes (Luana) Student Folklore Fieldwork Project",orflr_1974_015.xml,80444/xv12417,0,0,0,0
"Sembler (Jacob) Student Folklore Fieldwork Project",orflr_2010_077.xml,80444/xv56204,0,0,0,0
"Bradley (Teresa L.) Student Folklore Fieldwork Project",orflr_1986_004.xml,80444/xv40603,0,0,0,0
"Anonymous Student Folklore Fieldwork Project",orflr_1971_164.xml,80444/xv82119,0,0,0,0
"Leland (Michael) Student Folklore Fieldwork Project",orflr_1989_050.xml,80444/xv65234,0,0,0,0
"Johnston (Cole) Student Folklore Fieldwork Project",orflr_2011_025.xml,80444/xv76672,0,0,0,0
"Raphael (Raphael) Student Folklore Fieldwork Project",orflr_2005_006.xml,80444/xv81701,0,0,0,0
"Hall (Carolyn) Student Folklore Fieldwork Project",orflr_1977_076.xml,80444/xv69796,0,0,0,0
"Ryan (Theresa) Student Folklore Fieldwork Project",orflr_1973_081.xml,80444/xv04193,0,0,0,0
"Vik (Sonja M.) Student Folklore Fieldwork Project",orflr_1974_194.xml,80444/xv48327,0,0,0,0
"Kaanapu (Todd) Student Folklore Fieldwork Project",orflr_1989_007.xml,80444/xv59152,0,0,0,0
"Student Folklore Fieldwork Project",orflr_1973_127.xml,80444/xv46313,0,0,0,0
"Wagner (Susan) Student Folklore Fieldwork Project",orflr_1975_054.xml,80444/xv45849,0,0,0,0
"Maloney (Charles A.) Student Folklore Fieldwork Project",orflr_1974_165.xml,80444/xv73117,0,0,0,0
"Johnson (Harriet) Student Folklore Fieldwork Project",orflr_1975_068.xml,80444/xv89727,0,0,0,0
"Hoder (Melinda) Student Folklore Fieldwork Project",orflr_1989_020.xml,80444/xv64825,0,0,0,0
"Bradford (E.) Student Folklore Fieldwork Project",orflr_1975_003.xml,80444/xv95870,0,0,0,0
"Student Folklore Fieldwork Project",orflr_1973_220.xml,80444/xv74136,0,0,0,0
"Whitaker (Amanda) Student Folklore Fieldwork Project",orflr_2002_022.xml,80444/xv45693,0,0,0,0
"Byorklund (Cybele) Student Folklore Fieldwork Project",orflr_1989_002.xml,80444/xv67355,0,0,0,0
"Cook (Marah) Student Folklore Fieldwork Project",orflr_2008_105.xml,80444/xv14730,0,0,0,0
"Liberty (Robert L.) Student Folklore Fieldwork Project",orflr_1974_159.xml,80444/xv50323,0,0,0,0
"Kindall (Tracey L.) Student Folklore Fieldwork Project",orflr_1997_003.xml,80444/xv28588,0,0,0,0
"Mudrow (Michelle) Student Folklore Fieldwork Project",orflr_2008_118.xml,80444/xv16195,0,0,0,0
"Mesman (Greg) Student Folklore Fieldwork Project",orflr_1974_320.xml,80444/xv25299,0,0,0,0
"Parker (Marsha) Student Folklore Fieldwork Project",orflr_1973_075.xml,80444/xv88674,0,0,0,0
"Fisher (Susan) Student Folklore Fieldwork Project",orflr_1980_026.xml,80444/xv95272,0,0,0,0
"Weisel (Sally) Student Folklore Fieldwork Project",orflr_1974_300.xml,80444/xv01525,0,0,0,0
"Morrill (Deborah) Student Folklore Fieldwork Project",orflr_1973_070.xml,80444/xv91851,0,0,0,0
"Student Folklore Fieldwork Project",orflr_1973_120.xml,80444/xv70162,0,0,0,0
"Beechel (Christopher S.) Student Folklore Fieldwork Project",orflr_1974_118.xml,80444/xv62551,0,0,0,0
"Snowball (Jana) Student Folklore Fieldwork Project",orflr_1975_111.xml,80444/xv82238,0,0,0,0
"Conte (Michele M.) Student Folklore Fieldwork Project",orflr_1989_004.xml,80444/xv37731,0,0,0,0
"Langworthy (Kurt) Student Folklore Fieldwork Project",orflr_2002_029.xml,80444/xv13989,0,0,0,0
"Odunze (Odindu J.) Student Folklore Fieldwork Project",orflr_1977_016.xml,80444/xv21389,0,0,0,0
"Goddard (Cascadia) Student Folklore Fieldwork Project",orflr_1993_020.xml,80444/xv46817,0,0,0,0
"Butzin (Lianne) Student Folklore Fieldwork Project",orflr_1974_018.xml,80444/xv06182,0,0,0,0
"Poticha (Sharon S.) Student Folklore Fieldwork Project",orflr_1976_069b.xml,80444/xv18551,0,0,0,0
"Student Folklore Fieldwork Project",orflr_1973_145.xml,80444/xv70883,0,0,0,0
"Kopp (James J.) Student Folklore Fieldwork Project",orflr_1974_255.xml,80444/xv75335,0,0,0,0
"Mazzowe (Johnnie) Student Folklore Fieldwork Project",orflr_2001_006.xml,80444/xv20208,0,0,0,0
"Langford (Terri S.) Student Folklore Fieldwork Project",orflr_1985_027.xml,80444/xv27758,0,0,0,0
"Carlile (Sonya) Student Folklore Fieldwork Project",orflr_2008_070.xml,80444/xv76910,0,0,0,0
"Clark (Deborah) Student Folklore Fieldwork Project",orflr_1973_023.xml,80444/xv58795,0,0,0,0
"Stein (Kenneth A.) Student Folklore Fieldwork Project",orflr_1982_092.xml,80444/xv16842,0,0,0,0
"Matthews (Cindy) Student Folklore Fieldwork Project",orflr_1981_047.xml,80444/xv10076,0,0,0,0
"Logan (Craig) Student Folklore Fieldwork Project",orflr_1974_259.xml,80444/xv85531,0,0,0,0
"Gibbs (Edward L.) Student Folklore Fieldwork Project",orflr_1974_236.xml,80444/xv42221,0,0,0,0
"Student Folklore Fieldwork Project",orflr_1973_366.xml,80444/xv22253,0,0,0,0
"Weast (Michael J.) Student Folklore Fieldwork Project",orflr_1990_022.xml,80444/xv74542,0,0,0,0
"Wright (Michael J.) Student Folklore Fieldwork Project",orflr_1974_202.xml,80444/xv10516,0,0,0,0
"Bennett (Grant) Student Folklore Fieldwork Project",orflr_1972_020.xml,80444/xv45358,0,0,0,0
"Haning (Cheryl) Student Folklore Fieldwork Project",orflr_2002_017.xml,80444/xv05603,0,0,0,0
"Hall (Alex) Student Folklore Fieldwork Project",orflr_2010_102.xml,80444/xv66952,0,0,0,0
"Ready (Pete) Student Folklore Fieldwork Project",orflr_1974_081.xml,80444/xv99270,0,0,0,0
"Tank (Diane) Student Folklore Fieldwork Project",orflr_1974_294.xml,80444/xv86251,0,0,0,0
"Stroud (Jim) Student Folklore Fieldwork Project",orflr_1977_148.xml,80444/xv44500,0,0,0,0
"Kindall (Tracy Lynn) Student Folklore Fieldwork Project",orflr_1997_017.xml,80444/xv20611,0,0,0,0
"O'Brien (Kathleen) Student Folklore Fieldwork Project",orflr_1992_004.xml,80444/xv39947,0,0,0,0
"Herman (Lauren) Student Folklore Fieldwork Project",orflr_2008_201.xml,80444/xv38446,0,0,0,0
"Mangers (Holly) Student Folklore Fieldwork Project",orflr_1973_062.xml,80444/xv41989,0,0,0,0
"Goldberg (John) Student Folklore Fieldwork Project",orflr_2008_170.xml,80444/xv67974,0,0,0,0
"Ross (Judith L.) Student Folklore Fieldwork Project",orflr_1975_148.xml,80444/xv31173,0,0,0,0
"Boesswetter (Kelly) Student Folklore Fieldwork Project",orflr_2008_198.xml,80444/xv01647,0,0,0,0
"McVickar (Miriam) Student Folklore Fieldwork Project",orflr_1971_071.xml,80444/xv78805,0,0,0,0
"Student Folklore Fieldwork Project",orflr_1971_361.xml,80444/xv39968,0,0,0,0
"Laughman (Karen) Student Folklore Fieldwork Project",orflr_1974_027.xml,80444/xv19604,0,0,0,0
"Schaller (Liz) Student Folklore Fieldwork Project",orflr_1981_051.xml,80444/xv72415,0,0,0,0
"Muerle (Linda) Student Folklore Fieldwork Project",orflr_1977_115.xml,80444/xv32934,0,0,0,0
"Stewart (Sally) Student Folklore Fieldwork Project",orflr_1974_186.xml,80444/xv59777,0,0,0,0
"Trout (Barbara A.) Student Folklore Fieldwork Project",orflr_1977_132.xml,80444/xv03961,0,0,0,0
"Johnson (Edward) Student Folklore Fieldwork Project",orflr_1970_107.xml,80444/xv72094,0,0,0,0
"Soll (Valerie) Student Folklore Fieldwork Project",orflr_1975_164.xml,80444/xv37829,0,0,0,0
"Hart (Shannon) Student Folklore Fieldwork Project",orflr_1990_009.xml,80444/xv88339,0,0,0,0
"Stoffel (Joe) Student Folklore Fieldwork Project",orflr_1975_150.xml,80444/xv71572,0,0,0,0
"Daniels (Hoyle) Student Folklore Fieldwork Project",orflr_2008_120.xml,80444/xv10876,0,0,0,0
"Murkowski (Carol) Student Folklore Fieldwork Project",orflr_1977_042.xml,80444/xv30847,0,0,0,0
"West (Sue) Student Folklore Fieldwork Project",orflr_1972_063.xml,80444/xv30081,0,0,0,0
"Kounovsky (Ryan) Student Folklore Fieldwork Project",orflr_2010_019.xml,80444/xv94262,0,0,0,0
"Weiss (Mark) Student Folklore Fieldwork Project",orflr_1976_088.xml,80444/xv81253,0,0,0,0
"Calson (Christi) Student Folklore Fieldwork Project",orflr_1989_041.xml,80444/xv35321,0,0,0,0
"Singer (Patrick) Student Folklore Fieldwork Project",orflr_2011_032.xml,80444/xv21051,0,0,0,0
"Schall (Dian) Student Folklore Fieldwork Project",orflr_1985_041.xml,80444/xv84054,0,0,0,0
"Nichols (Brett) Student Folklore Fieldwork Project",orflr_2010_109.xml,80444/xv15493,0,0,0,0
"Student Folklore Fieldwork Project",orflr_1973_358.xml,80444/xv03942,0,0,0,0
"Sundquist (Neal) Student Folklore Fieldwork Project",orflr_1973_086.xml,80444/xv08831,0,0,0,0
"Peterson (Eric) Student Folklore Fieldwork Project",orflr_1973_076.xml,80444/xv85925,0,0,0,0
"Hart (John Woods) Student Folklore Fieldwork Project",orflr_1972_163.xml,80444/xv65158,0,0,0,0
"Student Folklore Fieldwork Project",orflr_1973_284.xml,80444/xv75231,0,0,0,0
"Cleary (Charlotte) Student Folklore Fieldwork Project",orflr_2011_010.xml,80444/xv63333,0,0,0,0
"Fisher (Allison) Student Folklore Fieldwork Project",orflr_1974_103.xml,80444/xv57067,0,0,0,0
"Grandberry (Mykel) Student Folklore Fieldwork Project",orflr_1974_142.xml,80444/xv39871,0,0,0,0
"Student Folklore Fieldwork Project",orflr_1973_241.xml,80444/xv54922,0,0,0,0
"Messe (Jack) Student Folklore Fieldwork Project",orflr_1974_168.xml,80444/xv46090,0,0,0,0
"Sutphin (Christi) Student Folklore Fieldwork Project",orflr_1981_037.xml,80444/xv74392,0,0,0,0
"Stratmann (Silke Gwendolin) Student Folklore Fieldwork Project",orflr_1990_021.xml,80444/xv25106,0,0,0,0
"Mesman (Greg) Student Folklore Fieldwork Project",orflr_1974_323.xml,80444/xv86083,0,0,0,0
"Brinton (Kathie) Student Folklore Fieldwork Project",orflr_1971_114.xml,80444/xv69061,0,0,0,0
"Heikes (Drex) Student Folklore Fieldwork Project",orflr_1974_147.xml,80444/xv11468,0,0,0,0
"Goldsmith (Bill) Student Folklore Fieldwork Project",orflr_1991_041.xml,80444/xv95065,0,0,0,0
"Hildenbrand (Donald Gerald) Student Folklore Fieldwork Project",orflr_1975_178.xml,80444/xv24316,0,0,0,0
"Smith (Karen I.) Student Folklore Fieldwork Project",orflr_1972_198.xml,80444/xv77438,0,0,0,0
"Fischer (Dahvi Shira) Student Folklore Fieldwork Project",orflr_2002_069.xml,80444/xv76812,0,0,0,0
"Mohrmann (Eric) Student Folklore Fieldwork Project",orflr_1973_068.xml,80444/xv08612,0,0,0,0
"Reese (Terry) Student Folklore Fieldwork Project",orflr_1996_002.xml,80444/xv66485,0,0,0,0
"Dahlgren (Janet) Student Folklore Fieldwork Project",orflr_1990_008.xml,80444/xv13302,0,0,0,0
"Albright (Christine A.) Student Folklore Fieldwork Project",orflr_2006_001.xml,80444/xv41500,0,0,0,0
"Vangel (Cheryl) Student Folklore Fieldwork Project",orflr_1974_298.xml,80444/xv20455,0,0,0,0
"Powell (Saundra B.) Student Folklore Fieldwork Project",orflr_1983_027.xml,80444/xv61874,0,0,0,0
"Benage (Chris) Student Folklore Fieldwork Project",orflr_1975_080.xml,80444/xv20645,0,0,0,0
"Ogle (Chuck) Student Folklore Fieldwork Project",orflr_1976_066.xml,80444/xv75537,0,0,0,0
"Sliman (Virginia) Student Folklore Fieldwork Project",orflr_1979_005.xml,80444/xv44677,0,0,0,0
"Smithwick (Crystal L.) Student Folklore Fieldwork Project",orflr_1985_044.xml,80444/xv31863,0,0,0,0
"Lena (Christopher) Student Folklore Fieldwork Project",orflr_2008_095.xml,80444/xv27648,0,0,0,0
"Walden (Jane Lee) Student Folklore Fieldwork Project",orflr_1973_094.xml,80444/xv42575,0,0,0,0
"Owens (Andrea C.) Student Folklore Fieldwork Project",orflr_1982_036.xml,80444/xv29156,0,0,0,0
"Huntsberger (Kristianne) Student Folklore Fieldwork Project",orflr_2006_007.xml,80444/xv31698,0,0,0,0
"Pitt (Keith A.) Student Folklore Fieldwork Project",orflr_1991_026.xml,80444/xv29727,0,0,0,0
"Bowcock (Elise M.) Student Folklore Fieldwork Project",orflr_1974_123.xml,80444/xv87594,0,0,0,0
"Lee (Regan) Student Folklore Fieldwork Project",orflr_1995_005.xml,80444/xv35714,0,0,0,0
"Student Folklore Fieldwork Project",orflr_1973_144.xml,80444/xv84283,0,0,0,0
"Morgan (Thomas) Student Folklore Fieldwork Project",orflr_1993_018.xml,80444/xv98620,0,0,0,0
"May (Seth) Student Folklore Fieldwork Project",orflr_2003_008.xml,80444/xv87191,0,0,0,0
"Christie (Robert) Student Folklore Fieldwork Project",orflr_1987_007.xml,80444/xv42480,0,0,0,0
"Richardson (Tracey) Student Folklore Fieldwork Project",orflr_1975_042.xml,80444/xv50744,0,0,0,0
"O'Brien (Mary) Student Folklore Fieldwork Project",orflr_1974_096.xml,80444/xv83541,0,0,0,0
"Gradison (Daniel) Student Folklore Fieldwork Project",orflr_2011_022.xml,80444/xv80841,0,0,0,0
"Johnson (Tom) Student Folklore Fieldwork Project",orflr_1990_011.xml,80444/xv20339,0,0,0,0
"Sherrick (Alexa) Student Folklore Fieldwork Project",orflr_2011_031.xml,80444/xv95217,0,0,0,0
"Williams (Thomas) Student Folklore Fieldwork Project",orflr_1973_096.xml,80444/xv94992,0,0,0,0
"Mills (Amy) Student Folklore Fieldwork Project",orflr_2002_093.xml,80444/xv56481,0,0,0,0
"Gernard (Nickolas Valenti) Student Folklore Fieldwork Project",orflr_2012_058.xml,80444/xv50552,0,0,0,0
"Parks (Jane) Student Folklore Fieldwork Project",orflr_1975_106.xml,80444/xv69705,0,0,0,0
"Student Folklore Fieldwork Project",orflr_1971_372.xml,80444/xv93997,0,0,0,0
"Phillips (Brenda) Student Folklore Fieldwork Project",orflr_1993_027.xml,80444/xv21835,0,0,0,0
"Barrett (Charles) Student Folklore Fieldwork Project",orflr_1976_022.xml,80444/xv77288,0,0,0,0
"Elliott (Caronwen Amber Nuinui) Student Folklore Fieldwork Project",orflr_2002_071.xml,80444/xv92221,0,0,0,0
"Albright (Christine A.) Student Folklore Fieldwork Project",orflr_2006_017.xml,80444/xv07501,0,0,0,0
"Wright (Jerry R.) Student Folklore Fieldwork Project",orflr_1974_201.xml,80444/xv30407,0,0,0,0
"Hackley (Laura) Student Folklore Fieldwork Project",orflr_1971_145.xml,80444/xv11459,0,0,0,0
"Wiser (Ali) Student Folklore Fieldwork Project",orflr_2006_043.xml,80444/xv05670,0,0,0,0
"Anthony (Lee M.) Student Folklore Fieldwork Project",orflr_2008_126.xml,80444/xv46408,0,0,0,0
"Progler (Margaret D.) Student Folklore Fieldwork Project",orflr_1977_086.xml,80444/xv54641,0,0,0,0
"Meyer (Jeremy) Student Folklore Fieldwork Project",orflr_2008_213.xml,80444/xv96936,0,0,0,0
"Daniel (Larry S.) Student Folklore Fieldwork Project",orflr_1974_007.xml,80444/xv90417,0,0,0,0
"Student Folklore Fieldwork Project",orflr_1973_185.xml,80444/xv87149,0,0,0,0
"Mills (Amy) Student Folklore Fieldwork Project",orflr_2002_094.xml,80444/xv33355,0,0,0,0
"Bechtel (Louise K.) Student Folklore Fieldwork Project",orflr_1974_098.xml,80444/xv90628,0,0,0,0
"Miller (Paige) Student Folklore Fieldwork Project",orflr_2008_085.xml,80444/xv01556,0,0,0,0
"Powell (Phyllis L.) Student Folklore Fieldwork Project",orflr_1976_153.xml,80444/xv20999,0,0,0,0
"Jones (Meredith) Student Folklore Fieldwork Project",orflr_2008_122.xml,80444/xv74261,0,0,0,0
"Brown (Mark) Student Folklore Fieldwork Project",orflr_1977_138.xml,80444/xv72439,0,0,0,0
"Slaughter (Joel) Student Folklore Fieldwork Project",orflr_1996_017.xml,80444/xv92297,0,0,0,0
"Wartluft (Elizabeth) Student Folklore Fieldwork Project",orflr_1994_010.xml,80444/xv24093,0,0,0,0
"Student Folklore Fieldwork Project",orflr_1973_304.xml,80444/xv49426,0,0,0,0
"Bauer (Miko) Student Folklore Fieldwork Project",orflr_2008_071.xml,80444/xv05905,0,0,0,0
"Nagel (Britan) Student Folklore Fieldwork Project",orflr_2008_034.xml,80444/xv34060,0,0,0,0
"Lockfield (Steven) Student Folklore Fieldwork Project",orflr_2002_049.xml,80444/xv94180,0,0,0,0
"Salvador (Janice L.) Student Folklore Fieldwork Project",orflr_1979_040.xml,80444/xv69223,0,0,0,0
"Student Folklore Fieldwork Project",orflr_1973_103.xml,80444/xv74301,0,0,0,0
"Ramsey (Mary) Student Folklore Fieldwork Project",orflr_1976_154.xml,80444/xv26358,0,0,0,0
"Gray (Devon) Student Folklore Fieldwork Project",orflr_1993_001.xml,80444/xv96386,0,0,0,0
"Student Folklore Fieldwork Project",orflr_1973_342.xml,80444/xv63565,0,0,0,0
"Student Folklore Fieldwork Project",orflr_1973_332.xml,80444/xv69116,0,0,0,0
"Parks (Jane) Student Folklore Fieldwork Project",orflr_1977_047.xml,80444/xv21615,0,0,0,0
"Goddard (Susan B.) Student Folklore Fieldwork Project",orflr_1972_032.xml,80444/xv51571,0,0,0,0
"Moody (Kent) Student Folklore Fieldwork Project",orflr_1973_069.xml,80444/xv01602,0,0,0,0
"Student Folklore Fieldwork Project",orflr_1973_113.xml,80444/xv25357,0,0,0,0
"Moore (Robert) Student Folklore Fieldwork Project",orflr_2006_019.xml,80444/xv58911,0,0,0,0
"Schorzman (Anne) Student Folklore Fieldwork Project",orflr_1975_162.xml,80444/xv52615,0,0,0,0
"Henderson (Bonnie) Student Folklore Fieldwork Project",orflr_1975_176.xml,80444/xv97360,0,0,0,0
"Parker (Dawn) Student Folklore Fieldwork Project",orflr_1984_020.xml,80444/xv39990,0,0,0,0
"Esherick (Judy) Student Folklore Fieldwork Project",orflr_1974_136.xml,80444/xv82312,0,0,0,0
"Larsen (Christopher A.) Student Folklore Fieldwork Project",orflr_1982_114.xml,80444/xv06271,0,0,0,0
"Davis (D. Russell) Student Folklore Fieldwork Project",orflr_1974_059.xml,80444/xv36627,0,0,0,0
"Dunlap (Ann) Student Folklore Fieldwork Project",orflr_1986_009.xml,80444/xv65768,0,0,0,0
"Person (Ceon) Student Folklore Fieldwork Project",orflr_1972_139.xml,80444/xv88623,0,0,0,0
"Fletcher (Hannah) Student Folklore Fieldwork Project",orflr_2008_051.xml,80444/xv92886,0,0,0,0
"Knight (Jane) Student Folklore Fieldwork Project",orflr_1972_179.xml,80444/xv14810,0,0,0,0
"Student Folklore Fieldwork Project",orflr_1971_351.xml,80444/xv97378,0,0,0,0
"VanAtta (Jan L.) Student Folklore Fieldwork Project",orflr_1980_044.xml,80444/xv18505,0,0,0,0
"Buddeke (Jack) Student Folklore Fieldwork Project",orflr_1973_018.xml,80444/xv31094,0,0,0,0
"Januik (Michael) Student Folklore Fieldwork Project",orflr_1974_066.xml,80444/xv31933,0,0,0,0
"Witcher (Carol F.) Student Folklore Fieldwork Project",orflr_1980_053.xml,80444/xv70236,0,0,0,0
"Burkert (Kristen) Student Folklore Fieldwork Project",orflr_1975_167.xml,80444/xv39068,0,0,0,0
"Peyton-Levine (Samuel) Student Folklore Fieldwork Project",orflr_2010_030.xml,80444/xv96191,0,0,0,0
"Student Folklore Fieldwork Project",orflr_1973_177.xml,80444/xv63311,0,0,0,0
"Saltvold (Ingrid) Student Folklore Fieldwork Project",orflr_1974_179.xml,80444/xv07809,0,0,0,0
"Student Folklore Fieldwork Project",orflr_1973_157.xml,80444/xv62503,0,0,0,0
"Gabriel (Joe) Student Folklore Fieldwork Project",orflr_1973_040.xml,80444/xv05212,0,0,0,0
"Trump (Bob D.) Student Folklore Fieldwork Project",orflr_1976_158.xml,80444/xv83209,0,0,0,0
"McGill (Meg) Student Folklore Fieldwork Project",orflr_1972_069.xml,80444/xv63314,0,0,0,0
"Hall (Alexis) Student Folklore Fieldwork Project",orflr_2006_046.xml,80444/xv61614,0,0,0,0
"Nobles (Jenny) Student Folklore Fieldwork Project",orflr_1971_135.xml,80444/xv64379,0,0,0,0
"Nurge (Steve) Student Folklore Fieldwork Project",orflr_1975_036.xml,80444/xv64453,0,0,0,0
"Student Folklore Fieldwork Project",orflr_1973_312.xml,80444/xv77261,0,0,0,0
"Linville (Mara) Student Folklore Fieldwork Project",orflr_1991_015.xml,80444/xv04492,0,0,0,0
"Student Folklore Fieldwork Project",orflr_1973_168.xml,80444/xv22506,0,0,0,0
"Student Folklore Fieldwork Project",orflr_1973_158.xml,80444/xv12011,0,0,0,0
"Student Folklore Fieldwork Project",orflr_1973_153.xml,80444/xv14624,0,0,0,0
"Berry (Rebecca Lynn) Student Folklore Fieldwork Project",orflr_2003_012.xml,80444/xv01849,0,0,0,0
"Naumes (John P.) Student Folklore Fieldwork Project",orflr_2002_009.xml,80444/xv37243,0,0,0,0
"Pagenstecher (Gerhard) Student Folklore Fieldwork Project",orflr_1974_315.xml,80444/xv00491,0,0,0,0
"Fujiwara (Kaori) Student Folklore Fieldwork Project",orflr_1997_007.xml,80444/xv97293,0,0,0,0
"Crawford (Bonnie) Student Folklore Fieldwork Project",orflr_1977_100.xml,80444/xv69137,0,0,0,0
"Paris (Christopher D.) Student Folklore Fieldwork Project",orflr_2008_074.xml,80444/xv16918,0,0,0,0
"Macpherson (Ruth J.) Student Folklore Fieldwork Project",orflr_1975_138.xml,80444/xv10638,0,0,0,0
"Speck (Peggy) Student Folklore Fieldwork Project",orflr_1974_289.xml,80444/xv82296,0,0,0,0
"Kostelecky (Dennis) Student Folklore Fieldwork Project",orflr_1976_122.xml,80444/xv34246,0,0,0,0
"Gould (Lauren) Student Folklore Fieldwork Project",orflr_2008_042.xml,80444/xv06570,0,0,0,0
"Heubusch (Diane) Student Folklore Fieldwork Project",orflr_1974_001.xml,80444/xv81866,0,0,0,0
"Mitchell (Sue Ann) Student Folklore Fieldwork Project",orflr_1975_101.xml,80444/xv85061,0,0,0,0
"Student Folklore Fieldwork Project",orflr_1973_362.xml,80444/xv44494,0,0,0,0
"Fahr (Alycia) Student Folklore Fieldwork Project",orflr_1992_031.xml,80444/xv69131,0,0,0,0
"McLain (Alysia D.) Student Folklore Fieldwork Project",orflr_2005_016.xml,80444/xv16564,0,0,0,0
"Burkhart (Markie) Student Folklore Fieldwork Project",orflr_1974_056.xml,80444/xv91918,0,0,0,0
"Olney (Libby M.) Student Folklore Fieldwork Project",orflr_1993_029.xml,80444/xv43154,0,0,0,0
"McKee (Bonnie) Student Folklore Fieldwork Project",orflr_1971_070.xml,80444/xv68325,0,0,0,0
"Johnson (Brenda) Student Folklore Fieldwork Project",orflr_2006_047.xml,80444/xv12915,0,0,0,0
"Bayless (Joanie) Student Folklore Fieldwork Project",orflr_1973_099.xml,80444/xv77413,0,0,0,0
"Knoper (Sharon) Student Folklore Fieldwork Project",orflr_1974_025.xml,80444/xv10794,0,0,0,0
"Hairston (Susan J.) Student Folklore Fieldwork Project",orflr_1976_111.xml,80444/xv76565,0,0,0,0
"Torkelson (Cerrio) Student Folklore Fieldwork Project",orflr_1973_090.xml,80444/xv20672,0,0,0,0
"Geiszler (Mabel) Student Folklore Fieldwork Project",orflr_1971_333.xml,80444/xv90228,0,0,0,0
"Eagle (Sioux) Student Folklore Fieldwork Project",orflr_1975_086.xml,80444/xv07977,0,0,0,0
"Moro (Lena) Student Folklore Fieldwork Project",orflr_2008_129.xml,80444/xv91076,0,0,0,0
"Galvez (Jeanne) Student Folklore Fieldwork Project",orflr_1973_041.xml,80444/xv39471,0,0,0,0
"Hutchison (Wesley A.) Student Folklore Fieldwork Project",orflr_1977_010.xml,80444/xv36071,0,0,0,0
"Burks (Kris) Student Folklore Fieldwork Project",orflr_1976_006.xml,80444/xv97729,0,0,0,0
"Richardson (Kathe) Student Folklore Fieldwork Project",orflr_1987_044.xml,80444/xv11337,0,0,0,0
"Goldsmith (Bill) Student Folklore Fieldwork Project",orflr_1992_032.xml,80444/xv40579,0,0,0,0
"Brady (Pam) Student Folklore Fieldwork Project",orflr_1974_218.xml,80444/xv57699,0,0,0,0
"Brito (Kayleen) Student Folklore Fieldwork Project",orflr_2008_091.xml,80444/xv55990,0,0,0,0
"Beimdiek (Jill) Student Folklore Fieldwork Project",orflr_1976_023.xml,80444/xv17132,0,0,0,0
"Roach (Gene Paul) Student Folklore Fieldwork Project",orflr_1971_129.xml,80444/xv42514,0,0,0,0
"Majetich (S.) Student Folklore Fieldwork Project",orflr_1977_039.xml,80444/xv67016,0,0,0,0
"Levine (Joshua A.) Student Folklore Fieldwork Project",orflr_1989_049.xml,80444/xv43225,0,0,0,0
"O'Donnell (Kate) Student Folklore Fieldwork Project",orflr_1987_036.xml,80444/xv30850,0,0,0,0
"Walch (Michelle) Student Folklore Fieldwork Project",orflr_1991_022.xml,80444/xv28717,0,0,0,0
"Grady (Michael) Student Folklore Fieldwork Project",orflr_1976_043.xml,80444/xv07897,0,0,0,0
"Matthew (Lenore) Student Folklore Fieldwork Project",orflr_2002_073.xml,80444/xv29333,0,0,0,0
"Duffy (Olivia) Student Folklore Fieldwork Project",orflr_2006_006.xml,80444/xv77514,0,0,0,0
"Flake (Meghan) Student Folklore Fieldwork Project",orflr_2012_054.xml,80444/xv82940,0,0,0,0
"Thiessen (Deborah) Student Folklore Fieldwork Project",orflr_1973_087.xml,80444/xv53274,0,0,0,0
"Merge (Lauren) Student Folklore Fieldwork Project",orflr_2008_152.xml,80444/xv82302,0,0,0,0
"Findlay (Barbara J.) Student Folklore Fieldwork Project",orflr_1972_162.xml,80444/xv54531,0,0,0,0
"Aschim (Joan) Student Folklore Fieldwork Project",orflr_1975_001.xml,80444/xv13482,0,0,0,0
"Berger (Lisa Kay) Student Folklore Fieldwork Project",orflr_1991_032.xml,80444/xv58331,0,0,0,0
"Hogan (Donna) Student Folklore Fieldwork Project",orflr_1972_119.xml,80444/xv97210,0,0,0,0
"Higgins (Madelyn) Student Folklore Fieldwork Project",orflr_2008_025.xml,80444/xv38497,0,0,0,0
"Waterman (Rena K.) Student Folklore Fieldwork Project",orflr_1977_133.xml,80444/xv47586,0,0,0,0
"Iwata (Bill) Student Folklore Fieldwork Project",orflr_1979_012.xml,80444/xv91912,0,0,0,0
"Curington (Susan L.) Student Folklore Fieldwork Project",orflr_1980_021.xml,80444/xv52169,0,0,0,0
"Paces (James B.) Student Folklore Fieldwork Project",orflr_1977_015.xml,80444/xv07476,0,0,0,0
"Fults (Lauri) Student Folklore Fieldwork Project",orflr_1982_081.xml,80444/xv71377,0,0,0,0
"Stellavato (Mickey) Student Folklore Fieldwork Project",orflr_2006_008.xml,80444/xv07345,0,0,0,0
"Craig (Erin) Student Folklore Fieldwork Project",orflr_2008_027.xml,80444/xv47665,0,0,0,0
"Cleland (Scott Lincoln) Student Folklore Fieldwork Project",orflr_1992_013.xml,80444/xv69140,0,0,0,0
"Student Folklore Fieldwork Project",orflr_1973_334.xml,80444/xv09036,0,0,0,0
"Harvey (Andrew) Student Folklore Fieldwork Project",orflr_1982_111.xml,80444/xv31286,0,0,0,0
"Hart (Shannon) Student Folklore Fieldwork Project",orflr_1990_000.xml,80444/xv90551,0,0,0,0
"Koch (David) Student Folklore Fieldwork Project",orflr_1987_028.xml,80444/xv37640,0,0,0,0
"Blumenstein (Debbie J.) Student Folklore Fieldwork Project",orflr_1980_016.xml,80444/xv16445,0,0,0,0
"Rose (Sean) Student Folklore Fieldwork Project",orflr_1988_015.xml,80444/xv13085,0,0,0,0
"Spreiter (Ilsa) Student Folklore Fieldwork Project",orflr_2004_012.xml,80444/xv12365,0,0,0,0
"Student Folklore Fieldwork Project",orflr_1973_273.xml,80444/xv87802,0,0,0,0
"Purn (Tiffany) Student Folklore Fieldwork Project",orflr_2005_001.xml,80444/xv34371,0,0,0,0
"Bay (Kenneth E.) Student Folklore Fieldwork Project",orflr_1980_015.xml,80444/xv31958,0,0,0,0
"Thompson (Linda) Student Folklore Fieldwork Project",orflr_1972_073.xml,80444/xv30047,0,0,0,0
"Dean (Amelia) Student Folklore Fieldwork Project",orflr_2003_011.xml,80444/xv14804,0,0,0,0
"Anderson (Robin) Student Folklore Fieldwork Project",orflr_1977_163.xml,80444/xv34118,0,0,0,0
"Briger (Sam) Student Folklore Fieldwork Project",orflr_2001_010.xml,80444/xv49334,0,0,0,0
"Student Folklore Fieldwork Project",orflr_1973_141.xml,80444/xv68502,0,0,0,0
"Gingerich (Margaret) Student Folklore Fieldwork Project",orflr_1977_073.xml,80444/xv32073,0,0,0,0
"Fix (Jessica) Student Folklore Fieldwork Project",orflr_2010_071.xml,80444/xv18261,0,0,0,0
"Del Giorgio (Kathleen) Student Folklore Fieldwork Project",orflr_1971_033.xml,80444/xv27157,0,0,0,0
"Student Folklore Fieldwork Project",orflr_1971_382.xml,80444/xv70593,0,0,0,0
"Mitchell (Karen) Student Folklore Fieldwork Project",orflr_1993_010.xml,80444/xv19573,0,0,0,0
"Northfield (Brett) Student Folklore Fieldwork Project",orflr_2010_039.xml,80444/xv56887,0,0,0,0
"Student Folklore Fieldwork Project",orflr_1973_162.xml,80444/xv18740,0,0,0,0
"Brock (Rebecca J.) Student Folklore Fieldwork Project",orflr_1974_220.xml,80444/xv96960,0,0,0,0
"Mehlenbacher (Kurt) Student Folklore Fieldwork Project",orflr_2003_005.xml,80444/xv99615,0,0,0,0
"LePore (Kathryn) Student Folklore Fieldwork Project",orflr_2002_064.xml,80444/xv83813,0,0,0,0
"Henshaw (Kim) Student Folklore Fieldwork Project",orflr_1989_051.xml,80444/xv90484,0,0,0,0
"Matheson (Leila K.) Student Folklore Fieldwork Project",orflr_1975_140.xml,80444/xv04901,0,0,0,0
"Nipp (Lucas) Student Folklore Fieldwork Project",orflr_2002_024.xml,80444/xv84811,0,0,0,0
"Adams (Linda J.) Student Folklore Fieldwork Project",orflr_1970_138.xml,80444/xv01672,0,0,0,0
"Sherriffs (Ellen) Student Folklore Fieldwork Project",orflr_1984_035.xml,80444/xv56381,0,0,0,0
"Steigerwald (Carol) Student Folklore Fieldwork Project",orflr_1975_049.xml,80444/xv50115,0,0,0,0
"Tichinin (Lilli) Student Folklore Fieldwork Project",orflr_2008_002.xml,80444/xv86917,0,0,0,0
"Koroloff (Mary) Student Folklore Fieldwork Project",orflr_1990_013.xml,80444/xv73693,0,0,0,0
"Gosnell (Nicolas W.) Student Folklore Fieldwork Project",orflr_2010_021.xml,80444/xv97201,0,0,0,0
"Student Folklore Fieldwork Project",orflr_1975_152.xml,80444/xv75314,0,0,0,0
"Martinez (Mauricio) Student Folklore Fieldwork Project",orflr_2008_196.xml,80444/xv56478,0,0,0,0
"Hart (Emily) Student Folklore Fieldwork Project",orflr_2010_078.xml,80444/xv35021,0,0,0,0
"Student Folklore Fieldwork Project",orflr_1973_108.xml,80444/xv75378,0,0,0,0
"Kiester (Lucille) Student Folklore Fieldwork Project",orflr_2008_080.xml,80444/xv70932,0,0,0,0
"Student Folklore Fieldwork Project",orflr_1973_368.xml,80444/xv81686,0,0,0,0
"Hibbs (Jennifer) Student Folklore Fieldwork Project",orflr_1974_308.xml,80444/xv04278,0,0,0,0
"Quinn (Norma B.) Student Folklore Fieldwork Project",orflr_1974_174.xml,80444/xv83502,0,0,0,0
"Liskey (Jessica) Student Folklore Fieldwork Project",orflr_2008_124.xml,80444/xv50531,0,0,0,0
"Copenhaver (James G.) Student Folklore Fieldwork Project",orflr_1973_100.xml,80444/xv82800,0,0,0,0
"Qualman (Nancy J.) Student Folklore Fieldwork Project",orflr_1989_027.xml,80444/xv57608,0,0,0,0
"Banks (Angela) Student Folklore Fieldwork Project",orflr_1993_016.xml,80444/xv04330,0,0,0,0
"Gold (Dana M.) Student Folklore Fieldwork Project",orflr_1971_303.xml,80444/xv04779,0,0,0,0
"Jayne (Thomas) Student Folklore Fieldwork Project",orflr_1981_043.xml,80444/xv40585,0,0,0,0
"Wells (Megan) Student Folklore Fieldwork Project",orflr_2008_107.xml,80444/xv13101,0,0,0,0
"Calef (Hillary) Student Folklore Fieldwork Project",orflr_2011_008.xml,80444/xv96185,0,0,0,0
"Sowell (John) Student Folklore Fieldwork Project",orflr_1989_058.xml,80444/xv80886,0,0,0,0
"Nicola (John) Student Folklore Fieldwork Project",orflr_1974_274.xml,80444/xv67675,0,0,0,0
"Riggs (Chiree) Student Folklore Fieldwork Project",orflr_2010_053.xml,80444/xv24578,0,0,0,0
"Carr (Darrin) Student Folklore Fieldwork Project",orflr_1982_107.xml,80444/xv03045,0,0,0,0
"Proudfit (Rebecca) Student Folklore Fieldwork Project",orflr_2008_207.xml,80444/xv77868,0,0,0,0
"Stephens (Leslie) Student Folklore Fieldwork Project",orflr_1976_081.xml,80444/xv04855,0,0,0,0
"Jaques (Nanette) Student Folklore Fieldwork Project",orflr_1975_026.xml,80444/xv52142,0,0,0,0
"Leibik (Ruth) Student Folklore Fieldwork Project",orflr_1983_022.xml,80444/xv14535,0,0,0,0
"Easton (Mike) Student Folklore Fieldwork Project",orflr_1985_016.xml,80444/xv45419,0,0,0,0
"Barrows (Mathew) Student Folklore Fieldwork Project",orflr_1977_154.xml,80444/xv18627,0,0,0,0
"Dyer (Dani) Student Folklore Fieldwork Project",orflr_2012_046.xml,80444/xv95062,0,0,0,0
"Tottenhoff (Marta) Student Folklore Fieldwork Project",orflr_1977_131.xml,80444/xv21011,0,0,0,0
"Moschetti (Jo) Student Folklore Fieldwork Project",orflr_1974_169.xml,80444/xv49694,0,0,0,0
"Student Folklore Fieldwork Project",orflr_1973_199.xml,80444/xv28451,0,0,0,0
"Hager (Michaela) Student Folklore Fieldwork Project",orflr_2012_065.xml,80444/xv02917,0,0,0,0
"Byrd (Catherine) Student Folklore Fieldwork Project",orflr_2002_096.xml,80444/xv18841,0,0,0,0
"Melyan (Mark H.) Student Folklore Fieldwork Project",orflr_1975_141.xml,80444/xv98553,0,0,0,0
"Brown (William A.) Student Folklore Fieldwork Project",orflr_1974_125.xml,80444/xv09527,0,0,0,0
"Shields (Amy) Student Folklore Fieldwork Project",orflr_2008_013.xml,80444/xv90219,0,0,0,0
"Ralph (Jim) Student Folklore Fieldwork Project",orflr_1974_280.xml,80444/xv35891,0,0,0,0
"Despacio (Orly) Student Folklore Fieldwork Project",orflr_2003_017.xml,80444/xv37808,0,0,0,0
"Sieradski (Karen) Student Folklore Fieldwork Project",orflr_1975_109.xml,80444/xv55746,0,0,0,0
"Hambourg (Klemi) Student Folklore Fieldwork Project",orflr_1974_144.xml,80444/xv56140,0,0,0,0
"Ottum (Philip Kendall) Student Folklore Fieldwork Project",orflr_1972_052.xml,80444/xv42596,0,0,0,0
"Student Folklore Fieldwork Project",orflr_1973_161.xml,80444/xv47149,0,0,0,0
"Student Folklore Fieldwork Project",orflr_1973_338.xml,80444/xv13574,0,0,0,0
"Martinez (Elena) Student Folklore Fieldwork Project",orflr_1994_008.xml,80444/xv47296,0,0,0,0
"Smith (Kim) Student Folklore Fieldwork Project",orflr_1985_043.xml,80444/xv34313,0,0,0,0
"Streeter (Marian) Student Folklore Fieldwork Project",orflr_1971_086.xml,80444/xv70764,0,0,0,0
"Dorsett (Beth) Student Folklore Fieldwork Project",orflr_1985_015.xml,80444/xv13031,0,0,0,0
"Cox (Anthony) Student Folklore Fieldwork Project",orflr_1983_015.xml,80444/xv54150,0,0,0,0
"Toothman (Constance Anna) Student Folklore Fieldwork Project",orflr_1974_192.xml,80444/xv57449,0,0,0,0
"Sanders (Russell) Student Folklore Fieldwork Project",orflr_1980_064.xml,80444/xv01083,0,0,0,0
"Lirman (Glenn) Student Folklore Fieldwork Project",orflr_1976_055.xml,80444/xv32760,0,0,0,0
"Anderson (Kerri) Student Folklore Fieldwork Project",orflr_2008_131.xml,80444/xv57171,0,0,0,0
"Mills (Amy) Student Folklore Fieldwork Project",orflr_1999_004.xml,80444/xv05538,0,0,0,0
"Nevill (Nancy) Student Folklore Fieldwork Project",orflr_1977_150.xml,80444/xv90322,0,0,0,0
"Danielson (Linda L.) Student Folklore Fieldwork Project",orflr_1984_002.xml,80444/xv01431,0,0,0,0
"Hescock (Connie) Student Folklore Fieldwork Project",orflr_1985_030.xml,80444/xv82913,0,0,0,0
"Student Folklore Fieldwork Project",orflr_1971_366.xml,80444/xv67944,0,0,0,0
"Reeve (Alexi) Student Folklore Fieldwork Project",orflr_2010_094.xml,80444/xv00244,0,0,0,0
"Student Folklore Fieldwork Project",orflr_1973_111.xml,80444/xv13400,0,0,0,0
"Dearborn (Katrin) Student Folklore Fieldwork Project",orflr_1993_009.xml,80444/xv93060,0,0,0,0
"Farr-Baenziger (Cody) Student Folklore Fieldwork Project",orflr_2012_051.xml,80444/xv99063,0,0,0,0
"Johnson (Hannalisa) Student Folklore Fieldwork Project",orflr_2008_154.xml,80444/xv99487,0,0,0,0
"Chung (Pat) Student Folklore Fieldwork Project",orflr_1972_026.xml,80444/xv82257,0,0,0,0
"Snow (Barbara) Student Folklore Fieldwork Project",orflr_1974_184.xml,80444/xv00228,0,0,0,0
"Sorensen (Kendra) Student Folklore Fieldwork Project",orflr_1991_024.xml,80444/xv23208,0,0,0,0
"Compesi (Wendy) Student Folklore Fieldwork Project",orflr_1974_058.xml,80444/xv61010,0,0,0,0
"Student Folklore Fieldwork Project",orflr_1973_325.xml,80444/xv86569,0,0,0,0
"Duncan (Mike) Student Folklore Fieldwork Project",orflr_1984_000.xml,80444/xv25936,0,0,0,0
"Ousterhout (Jean E.) Student Folklore Fieldwork Project",orflr_1972_194.xml,80444/xv55545,0,0,0,0
"McGrew (Kathy) Student Folklore Fieldwork Project",orflr_1977_044.xml,80444/xv21652,0,0,0,0
"Hladky (Joan) Student Folklore Fieldwork Project",orflr_1975_161.xml,80444/xv36724,0,0,0,0
"Primm (Ryan) Student Folklore Fieldwork Project",orflr_2008_158.xml,80444/xv58108,0,0,0,0
"Stevens (W. Grant) Student Folklore Fieldwork Project",orflr_1974_291.xml,80444/xv76248,0,0,0,0
"Student Folklore Fieldwork Project",orflr_1973_297.xml,80444/xv26748,0,0,0,0
"Ray (Carolyn) Student Folklore Fieldwork Project",orflr_1976_070.xml,80444/xv28265,0,0,0,0
"Zukaitis (Barbara) Student Folklore Fieldwork Project",orflr_1982_043.xml,80444/xv37893,0,0,0,0
"Knosp (Miriam) Student Folklore Fieldwork Project",orflr_2000_003.xml,80444/xv95355,0,0,0,0
"Bersch (Al) Student Folklore Fieldwork Project",orflr_2010_107.xml,80444/xv58685,0,0,0,0
"Wells (Jay) Student Folklore Fieldwork Project",orflr_1977_056.xml,80444/xv80065,0,0,0,0
"Radloff (Lori) Student Folklore Fieldwork Project",orflr_1979_038.xml,80444/xv10238,0,0,0,0
"Mintz (David) Student Folklore Fieldwork Project",orflr_2008_004.xml,80444/xv67184,0,0,0,0
"Lupton (Marilee) Student Folklore Fieldwork Project",orflr_1976_102.xml,80444/xv45046,0,0,0,0
"Kangas (Karen) Student Folklore Fieldwork Project",orflr_1977_064.xml,80444/xv40203,0,0,0,0
"Guillot (Julien) Student Folklore Fieldwork Project",orflr_2002_059.xml,80444/xv87994,0,0,0,0
"Johnson (Kaari Georgia) Student Folklore Fieldwork Project",orflr_1977_107.xml,80444/xv32647,0,0,0,0
"Close (Christopher) Student Folklore Fieldwork Project",orflr_1976_135.xml,80444/xv34988,0,0,0,0
"Menaker (Ellen Margaret) Student Folklore Fieldwork Project",orflr_1982_117.xml,80444/xv83764,0,0,0,0
"Vincent (Christopher) Student Folklore Fieldwork Project",orflr_2002_085.xml,80444/xv66735,0,0,0,0
"Diven (Joseph) and Jones (Janice) Student Folklore Fieldwork Project",orflr_1970_060.xml,80444/xv68850,0,0,0,0
"Ogata (Nathan) Student Folklore Fieldwork Project",orflr_2010_043.xml,80444/xv77148,0,0,0,0
"Wehling (Ruth) Student Folklore Fieldwork Project",orflr_1972_156.xml,80444/xv03131,0,0,0,0
"Gant (Morris C.) Student Folklore Fieldwork Project",orflr_0000_018.xml,80444/xv65518,0,0,0,0
"Cremer (Debbie) Student Folklore Fieldwork Project",orflr_1980_019.xml,80444/xv91638,0,0,0,0
"Tanioka (Corey) Student Folklore Fieldwork Project",orflr_2010_008.xml,80444/xv12408,0,0,0,0
"Billings (Kenneth R.) Student Folklore Fieldwork Project",orflr_1976_132.xml,80444/xv77801,0,0,0,0
"Moore (Theresa) Student Folklore Fieldwork Project",orflr_1976_060.xml,80444/xv72430,0,0,0,0
"Haefling (Lauren) Student Folklore Fieldwork Project",orflr_2012_064.xml,80444/xv48788,0,0,0,0
"Morris (Sarah) Student Folklore Fieldwork Project",orflr_1991_029.xml,80444/xv22177,0,0,0,0
"Dearborn (Susan) Student Folklore Fieldwork Project",orflr_1991_003.xml,80444/xv10647,0,0,0,0
"Hasson (Janise) Student Folklore Fieldwork Project",orflr_1976_099.xml,80444/xv65069,0,0,0,0
"Arnot (Michael S.) Student Folklore Fieldwork Project",orflr_1974_114.xml,80444/xv10559,0,0,0,0
"Asla (Besse) Student Folklore Fieldwork Project",orflr_1976_115.xml,80444/xv51742,0,0,0,0
"Lewis Baesler (Susan C.) Student Folklore Fieldwork Project",orflr_1974_214.xml,80444/xv98724,0,0,0,0
"Tebrugge (Amy) Student Folklore Fieldwork Project",orflr_1975_112.xml,80444/xv88812,0,0,0,0
"Student Folklore Fieldwork Project",orflr_1973_135.xml,80444/xv14248,0,0,0,0
"Murray (R. Daniel) Student Folklore Fieldwork Project",orflr_1975_145.xml,80444/xv29922,0,0,0,0
"Ball (Michael) Student Folklore Fieldwork Project",orflr_2002_068.xml,80444/xv30096,0,0,0,0
"Bradley (Brenda) Student Folklore Fieldwork Project",orflr_1994_003.xml,80444/xv86444,0,0,0,0
"Melkonian (Kathleen) Student Folklore Fieldwork Project",orflr_1990_015.xml,80444/xv16921,0,0,0,0
"Ouderkirk (Penelope) Student Folklore Fieldwork Project",orflr_1975_037.xml,80444/xv88406,0,0,0,0
"Ganter (M. Jane) Student Folklore Fieldwork Project",orflr_1983_016.xml,80444/xv24804,0,0,0,0
"Haran (Joseph A.) Student Folklore Fieldwork Project",orflr_1972_076.xml,80444/xv89074,0,0,0,0
"Choy-Ping (Chan) Student Folklore Fieldwork Project",orflr_1985_004.xml,80444/xv13119,0,0,0,0
"Swanson (Jan) Student Folklore Fieldwork Project",orflr_1974_293.xml,80444/xv02896,0,0,0,0
"Shepherd (John) Student Folklore Fieldwork Project",orflr_1980_008.xml,80444/xv65011,0,0,0,0
"Nix (Sarah) Student Folklore Fieldwork Project",orflr_1992_025.xml,80444/xv59790,0,0,0,0
"Reiley (Darren) Student Folklore Fieldwork Project",orflr_2002_002.xml,80444/xv40942,0,0,0,0
"Gianelli (Laura) Student Folklore Fieldwork Project",orflr_1976_037.xml,80444/xv50537,0,0,0,0
"Student Folklore Fieldwork Project",orflr_1973_202.xml,80444/xv14205,0,0,0,0
"Grenzeback (Richard R.) Student Folklore Fieldwork Project",orflr_1972_116.xml,80444/xv04339,0,0,0,0
"Marugg (Jerry) Student Folklore Fieldwork Project",orflr_1976_057.xml,80444/xv78823,0,0,0,0
"Milne (Elizabeth) Student Folklore Fieldwork Project",orflr_1975_032.xml,80444/xv37783,0,0,0,0
"Thompson (Donald E.) Student Folklore Fieldwork Project",orflr_2005_013.xml,80444/xv84408,0,0,0,0
"Snouffer (Abby) Student Folklore Fieldwork Project",orflr_2010_002.xml,80444/xv44107,0,0,0,0
"Evans (Jay) Student Folklore Fieldwork Project",orflr_1977_103.xml,80444/xv86721,0,0,0,0
"Arnold (Rachael Ailene) Student Folklore Fieldwork Project",orflr_2011_002.xml,80444/xv24456,0,0,0,0
"Greenberg (Naomi) Student Folklore Fieldwork Project",orflr_1985_021.xml,80444/xv00997,0,0,0,0
"Larson (Zina) Student Folklore Fieldwork Project",orflr_1997_004.xml,80444/xv97317,0,0,0,0
"Zielony (Ann) Student Folklore Fieldwork Project",orflr_1974_307.xml,80444/xv34710,0,0,0,0
"Gerritz (John M.) Student Folklore Fieldwork Project",orflr_1976_139.xml,80444/xv28515,0,0,0,0
"Kourafas (Michal) Student Folklore Fieldwork Project",orflr_2006_018.xml,80444/xv71627,0,0,0,0
"Pennington (Howard) Student Folklore Fieldwork Project",orflr_1980_007.xml,80444/xv28576,0,0,0,0
"McMaken (Mary Ellen) Student Folklore Fieldwork Project",orflr_1980_034.xml,80444/xv66607,0,0,0,0
"Harris (Janet) Student Folklore Fieldwork Project",orflr_1986_033.xml,80444/xv21374,0,0,0,0
"Student Folklore Fieldwork Project",orflr_1973_239.xml,80444/xv27554,0,0,0,0
"Marr (Jane A.) Student Folklore Fieldwork Project",orflr_1973_066.xml,80444/xv78317,0,0,0,0
"Lee (Regan Myriam) Student Folklore Fieldwork Project",orflr_1996_011.xml,80444/xv01342,0,0,0,0
"Civey (Colleen) Student Folklore Fieldwork Project",orflr_1974_129.xml,80444/xv86065,0,0,0,0
"Grafe (Steven L.) Student Folklore Fieldwork Project",orflr_1974_205.xml,80444/xv85440,0,0,0,0
"Lord (Tracy) Student Folklore Fieldwork Project",orflr_1975_181.xml,80444/xv29977,0,0,0,0
"Student Folklore Fieldwork Project",orflr_1973_359.xml,80444/xv36532,0,0,0,0
"Chinn (Robert) Student Folklore Fieldwork Project",orflr_1979_010.xml,80444/xv80307,0,0,0,0
"Haselton (Diane) Student Folklore Fieldwork Project",orflr_1972_037.xml,80444/xv76593,0,0,0,0
"Erdman (William E.) Student Folklore Fieldwork Project",orflr_1971_140.xml,80444/xv89877,0,0,0,0
"Bauernschmidt (Vicki) Student Folklore Fieldwork Project",orflr_1971_171.xml,80444/xv57174,0,0,0,0
"Shelburne (Candy) Student Folklore Fieldwork Project",orflr_1977_123.xml,80444/xv56243,0,0,0,0
"Cooke (Amy) Student Folklore Fieldwork Project",orflr_2002_023.xml,80444/xv59335,0,0,0,0
"Lester (Donald E.) Student Folklore Fieldwork Project",orflr_1976_101.xml,80444/xv73825,0,0,0,0
"Tillman (Barbara J.) Student Folklore Fieldwork Project",orflr_1976_084.xml,80444/xv65185,0,0,0,0
"Weinraub (Richard) Student Folklore Fieldwork Project",orflr_1974_042.xml,80444/xv39132,0,0,0,0
"Student Folklore Fieldwork Project",orflr_1973_152.xml,80444/xv46429,0,0,0,0
"White (Kimberly A. Kennedy) Student Folklore Fieldwork Project",orflr_1996_004.xml,80444/xv56509,0,0,0,0
"Roberts (Noah) Student Folklore Fieldwork Project",orflr_2008_188.xml,80444/xv93841,0,0,0,0
"Douglas (Donald F.) Student Folklore Fieldwork Project",orflr_1971_191.xml,80444/xv11380,0,0,0,0
"Leahy (Denise) Student Folklore Fieldwork Project",orflr_1977_112.xml,80444/xv14547,0,0,0,0
"Student Folklore Fieldwork Project",orflr_1973_193.xml,80444/xv35137,0,0,0,0
"Wade (John Frank) Student Folklore Fieldwork Project",orflr_1974_196.xml,80444/xv56973,0,0,0,0
"Gibson (Phillip) Student Folklore Fieldwork Project",orflr_1987_019.xml,80444/xv01239,0,0,0,0
"Bumstead (Laurie) Student Folklore Fieldwork Project",orflr_1986_006.xml,80444/xv13278,0,0,0,0
"Thelander (Judith C.) Student Folklore Fieldwork Project",orflr_1971_270.xml,80444/xv59738,0,0,0,0
"Gant (Morris C.) Student Folklore Fieldwork Project",orflr_1971_197.xml,80444/xv36160,0,0,0,0
"Miller (McKenna C.) Student Folklore Fieldwork Project",orflr_2008_175.xml,80444/xv54132,0,0,0,0
"Brady (Mary K.) Student Folklore Fieldwork Project",orflr_1971_324.xml,80444/xv94522,0,0,0,0
"Moriguchi-Ross (Sarah) Student Folklore Fieldwork Project",orflr_1991_037.xml,80444/xv75183,0,0,0,0
"Whitaker (Jenni) Student Folklore Fieldwork Project",orflr_1996_018.xml,80444/xv43597,0,0,0,0
"Seton (Deborah Ann) Student Folklore Fieldwork Project",orflr_1976_077.xml,80444/xv51519,0,0,0,0
"Johnston (Taylor) Student Folklore Fieldwork Project",orflr_2011_026.xml,80444/xv19073,0,0,0,0
"Offerman (Joni) Student Folklore Fieldwork Project",orflr_2003_026.xml,80444/xv19952,0,0,0,0
"Cody (Sarah) Student Folklore Fieldwork Project",orflr_1991_010.xml,80444/xv63577,0,0,0,0
"Kindall (Tracy Lynn) Student Folklore Fieldwork Project",orflr_1997_012.xml,80444/xv41638,0,0,0,0
"Seguela (Louise) Student Folklore Fieldwork Project",orflr_1987_052.xml,80444/xv04852,0,0,0,0
"Gosar (Frank) Student Folklore Fieldwork Project",orflr_1987_020.xml,80444/xv93795,0,0,0,0
"Denney (Cameron) Student Folklore Fieldwork Project",orflr_1982_029.xml,80444/xv08349,0,0,0,0
"Student Folklore Fieldwork Project",orflr_1973_302.xml,80444/xv52828,0,0,0,0
"Taylor (Barbara) Student Folklore Fieldwork Project",orflr_1973_088.xml,80444/xv19885,0,0,0,0
"Carr (J. Revell) Student Folklore Fieldwork Project",orflr_1998_006.xml,80444/xv15322,0,0,0,0
"Smith (Brad) Student Folklore Fieldwork Project",orflr_1975_060.xml,80444/xv55780,0,0,0,0
"Coe (Timothy C.) Student Folklore Fieldwork Project",orflr_1971_184.xml,80444/xv27600,0,0,0,0
"Phillips (Tom) Student Folklore Fieldwork Project",orflr_1981_034.xml,80444/xv75454,0,0,0,0
"Davis (Jaryd) Student Folklore Fieldwork Project",orflr_2011_013.xml,80444/xv15856,0,0,0,0
"Opel (Andy) Student Folklore Fieldwork Project",orflr_1997_001.xml,80444/xv40383,0,0,0,0
"Kingery (Dianne) Student Folklore Fieldwork Project",orflr_1976_121.xml,80444/xv47262,0,0,0,0
"Hoffman (Elizabeth) Student Folklore Fieldwork Project",orflr_1976_118.xml,80444/xv11004,0,0,0,0
"Leavitt (Sandi) Student Folklore Fieldwork Project",orflr_1982_115.xml,80444/xv11019,0,0,0,0
"Yorde (Robin) Student Folklore Fieldwork Project",orflr_1974_203.xml,80444/xv81124,0,0,0,0
"Wing (Susan L.) Student Folklore Fieldwork Project",orflr_1977_067.xml,80444/xv35424,0,0,0,0
"Student Folklore Fieldwork Project",orflr_1973_271.xml,80444/xv57138,0,0,0,0
"Miller (Ashleigh) Student Folklore Fieldwork Project",orflr_2008_206.xml,80444/xv44967,0,0,0,0
"Student Folklore Fieldwork Project",orflr_1973_248.xml,80444/xv90148,0,0,0,0
"Gardner (Deirdre) Student Folklore Fieldwork Project",orflr_1973_042.xml,80444/xv06127,0,0,0,0
"Piculell (Gene) Student Folklore Fieldwork Project",orflr_1987_040.xml,80444/xv34091,0,0,0,0
"Thompson (Greg) Student Folklore Fieldwork Project",orflr_1974_091.xml,80444/xv69256,0,0,0,0
"Larson (Gary Michael) Student Folklore Fieldwork Project",orflr_1977_079.xml,80444/xv56298,0,0,0,0
"Lamont (Sam) Student Folklore Fieldwork Project",orflr_1974_070.xml,80444/xv32672,0,0,0,0
"Broornberg (Teny-Ann) Student Folklore Fieldwork Project",orflr_1988_026.xml,80444/xv75765,0,0,0,0
"Grasseth (Jesse) Student Folklore Fieldwork Project",orflr_2003_020.xml,80444/xv81314,0,0,0,0
"Murphy (Mary Catherine) Student Folklore Fieldwork Project",orflr_1985_037.xml,80444/xv91033,0,0,0,0
"Shook (Mary) Student Folklore Fieldwork Project",orflr_1982_127.xml,80444/xv72485,0,0,0,0
"Lownds (Patricia) Student Folklore Fieldwork Project",orflr_2008_216.xml,80444/xv98663,0,0,0,0
"Everwine (Chris) Student Folklore Fieldwork Project",orflr_1975_016.xml,80444/xv99822,0,0,0,0
"Ragoway (Rick) Student Folklore Fieldwork Project",orflr_1972_056.xml,80444/xv87066,0,0,0,0
"Coester (Marjan) Student Folklore Fieldwork Project",orflr_1987_009.xml,80444/xv67996,0,0,0,0
"Finke (Bryan) Student Folklore Fieldwork Project",orflr_1991_012.xml,80444/xv31964,0,0,0,0
"Student Folklore Fieldwork Project",orflr_1973_232.xml,80444/xv12500,0,0,0,0
"O'Neil (Gaynelle) Student Folklore Fieldwork Project",orflr_1980_036.xml,80444/xv77249,0,0,0,0
"Cain (Betty) Student Folklore Fieldwork Project",orflr_1972_025.xml,80444/xv88806,0,0,0,0
"Student Folklore Fieldwork Project",orflr_1971_349.xml,80444/xv78424,0,0,0,0
"Shorack (Candace) Student Folklore Fieldwork Project",orflr_1974_086.xml,80444/xv89636,0,0,0,0
"Robb (Mina C.) Student Folklore Fieldwork Project",orflr_1980_038.xml,80444/xv17538,0,0,0,0
"Perez (Maria) Student Folklore Fieldwork Project",orflr_1997_015.xml,80444/xv35690,0,0,0,0
"Campbell (Travis) Student Folklore Fieldwork Project",orflr_2002_041.xml,80444/xv54214,0,0,0,0
"Evers (Jeannie) Student Folklore Fieldwork Project",orflr_2002_084.xml,80444/xv97094,0,0,0,0
"Kenner (Mariel) Student Folklore Fieldwork Project",orflr_2012_088.xml,80444/xv23355,0,0,0,0
"Carter (Regan) Student Folklore Fieldwork Project",orflr_1984_042.xml,80444/xv18807,0,0,0,0
"Koppensteiner (Debra) Student Folklore Fieldwork Project",orflr_1974_043.xml,80444/xv69604,0,0,0,0
"Eddy (Cheryl) Student Folklore Fieldwork Project",orflr_1996_023.xml,80444/xv66290,0,0,0,0
"Student Folklore Fieldwork Project",orflr_1973_265.xml,80444/xv80740,0,0,0,0
"Payne (KanJi) Student Folklore Fieldwork Project",orflr_1975_039.xml,80444/xv72375,0,0,0,0
"Price (Jean) Student Folklore Fieldwork Project",orflr_1976_131.xml,80444/xv19299,0,0,0,0
"Winklebleck (Mary) Student Folklore Fieldwork Project",orflr_1974_200.xml,80444/xv00079,0,0,0,0
"Colter (Hillary) Student Folklore Fieldwork Project",orflr_2004_019.xml,80444/xv47439,0,0,0,0
"Clifton (Denise) Student Folklore Fieldwork Project",orflr_1991_009.xml,80444/xv08657,0,0,0,0
"Meyer (Nadean) Student Folklore Fieldwork Project",orflr_1974_072.xml,80444/xv26712,0,0,0,0
"Student Folklore Fieldwork Project",orflr_1973_240.xml,80444/xv14004,0,0,0,0
"Hand (Jonathan) Student Folklore Fieldwork Project",orflr_2001_007.xml,80444/xv22161,0,0,0,0
"Corona (Rosanna) Student Folklore Fieldwork Project",orflr_2008_096.xml,80444/xv68280,0,0,0,0
"Hardenbrook (Rowan) Student Folklore Fieldwork Project",orflr_2012_067.xml,80444/xv03851,0,0,0,0
"Love (Rebecca) Student Folklore Fieldwork Project",orflr_1975_182.xml,80444/xv93533,0,0,0,0
"Day (Donna) and McBride (Julie) Student Folklore Fieldwork Project",orflr_1973_031.xml,80444/xv72372,0,0,0,0
"Krause (Joe) Student Folklore Fieldwork Project",orflr_1971_218.xml,80444/xv60260,0,0,0,0
"McBride (Jennifer A.) Student Folklore Fieldwork Project",orflr_1985_032.xml,80444/xv89199,0,0,0,0
"Yamahiro (Sara) Student Folklore Fieldwork Project",orflr_1980_054.xml,80444/xv10900,0,0,0,0
"Newton (Bruce) Student Folklore Fieldwork Project",orflr_1973_073.xml,80444/xv65191,0,0,0,0
"Long (Richard) Student Folklore Fieldwork Project",orflr_1974_260.xml,80444/xv51864,0,0,0,0
"Van Londen (Chris) Student Folklore Fieldwork Project",orflr_1976_159.xml,80444/xv18881,0,0,0,0
"Danielson (Linda) Student Folklore Fieldwork Project",orflr_1985_054.xml,80444/xv39599,0,0,0,0
"Ebling (Hilliard) Student Folklore Fieldwork Project",orflr_1972_029.xml,80444/xv17190,0,0,0,0
"James (Amber) Student Folklore Fieldwork Project",orflr_2007_001.xml,80444/xv56176,0,0,0,0
"Student Folklore Fieldwork Project",orflr_1973_214.xml,80444/xv01300,0,0,0,0
"Katz (George) Student Folklore Fieldwork Project",orflr_1976_051.xml,80444/xv75805,0,0,0,0
"St. Clair (Kelly) Student Folklore Fieldwork Project",orflr_1991_030.xml,80444/xv11193,0,0,0,0
"Loux (Francesca) Student Folklore Fieldwork Project",orflr_2006_032.xml,80444/xv41592,0,0,0,0
"Visnick (Patricia) Student Folklore Fieldwork Project",orflr_1971_097.xml,80444/xv00436,0,0,0,0
"Green (Florence) Student Folklore Fieldwork Project",orflr_1974_008.xml,80444/xv96850,0,0,0,0
"Student Folklore Fieldwork Project",orflr_1973_290.xml,80444/xv00427,0,0,0,0
"Student Folklore Fieldwork Project",orflr_1973_175.xml,80444/xv12567,0,0,0,0
"Hebert (Lee) Student Folklore Fieldwork Project",orflr_1974_245.xml,80444/xv66156,0,0,0,0
"Davis (Constance) Student Folklore Fieldwork Project",orflr_1974_044.xml,80444/xv65417,0,0,0,0
"Meyer (Wendy E.) Student Folklore Fieldwork Project",orflr_1975_186.xml,80444/xv50195,0,0,0,0
"White (George) Student Folklore Fieldwork Project",orflr_1975_055.xml,80444/xv29949,0,0,0,0
"Mariner (Joan K.) Student Folklore Fieldwork Project",orflr_1984_049.xml,80444/xv03689,0,0,0,0
"Mason (Patrick) Student Folklore Fieldwork Project",orflr_2010_070.xml,80444/xv27700,0,0,0,0
"Krugman (Vicky) Student Folklore Fieldwork Project",orflr_1971_059.xml,80444/xv10494,0,0,0,0
"Halling (Cameron) Student Folklore Fieldwork Project",orflr_2008_200.xml,80444/xv23727,0,0,0,0
"Student Folklore Fieldwork Project",orflr_1973_182.xml,80444/xv03695,0,0,0,0
"Student Folklore Fieldwork Project",orflr_1973_318.xml,80444/xv13208,0,0,0,0
"Boshart (Sarah) Student Folklore Fieldwork Project",orflr_2008_121.xml,80444/xv45257,0,0,0,0
"Spraker (Rebecca Lea) Student Folklore Fieldwork Project",orflr_1982_039.xml,80444/xv61611,0,0,0,0
"Godby (Jacqueline) Student Folklore Fieldwork Project",orflr_1992_029.xml,80444/xv51342,0,0,0,0
"Wong (Eric) Student Folklore Fieldwork Project",orflr_2010_003.xml,80444/xv45407,0,0,0,0
"Henry (Danielle) Student Folklore Fieldwork Project",orflr_2008_016.xml,80444/xv77511,0,0,0,0
"Didlick (Jordynn) Student Folklore Fieldwork Project",orflr_2008_146.xml,80444/xv62341,0,0,0,0
"Peterson (Patty) Student Folklore Fieldwork Project",orflr_1982_089.xml,80444/xv69543,0,0,0,0
"Neidig (Steinar) Student Folklore Fieldwork Project",orflr_2003_004.xml,80444/xv78988,0,0,0,0
"Currans (Beth) Student Folklore Fieldwork Project",orflr_1996_015.xml,80444/xv88433,0,0,0,0
"Kusy (Kay Louise) Student Folklore Fieldwork Project",orflr_1976_100.xml,80444/xv02182,0,0,0,0
"Student Folklore Fieldwork Project",orflr_1973_333.xml,80444/xv64282,0,0,0,0
"Harper (Ronald Edward) and Moore (Brian Edward) Student Folklore Fieldwork Project",orflr_1984_027.xml,80444/xv99163,0,0,0,0
"Molter (Maroia) Student Folklore Fieldwork Project",orflr_1972_170.xml,80444/xv52246,0,0,0,0
"Shindler (Josh) Student Folklore Fieldwork Project",orflr_2008_145.xml,80444/xv92465,0,0,0,0
"Mann (Carol) Student Folklore Fieldwork Project",orflr_1972_130.xml,80444/xv66497,0,0,0,0
"Baniago (Joanne) Student Folklore Fieldwork Project",orflr_2002_004.xml,80444/xv11163,0,0,0,0
"Gray (Jan) Student Folklore Fieldwork Project",orflr_1971_044.xml,80444/xv43026,0,0,0,0
"Sullivan (Charles Wm.) Student Folklore Fieldwork Project",orflr_1976_165.xml,80444/xv21914,0,0,0,0
"Dehn (Elizabeth A.) and Hassapopailou (Marina) Student Folklore Fieldwork Project",orflr_2007_008.xml,80444/xv32305,0,0,0,0
"Kalergis (Karen) Student Folklore Fieldwork Project",orflr_1972_123.xml,80444/xv10714,0,0,0,0
"Cipolla (Lisa M.) Student Folklore Fieldwork Project",orflr_1989_048.xml,80444/xv34277,0,0,0,0
"Ballantyne (R. Carmen) Student Folklore Fieldwork Project",orflr_2002_079.xml,80444/xv68579,0,0,0,0
"Student Folklore Fieldwork Project",orflr_1973_324.xml,80444/xv84292,0,0,0,0
"Nakagawa (Charlene) Student Folklore Fieldwork Project",orflr_1970_050.xml,80444/xv33792,0,0,0,0
"Nelson (Gail N.) Student Folklore Fieldwork Project",orflr_1970_110.xml,80444/xv65423,0,0,0,0
"Connor (Thomas A.) Student Folklore Fieldwork Project",orflr_2010_025.xml,80444/xv35934,0,0,0,0
"Dean (Tom) Student Folklore Fieldwork Project",orflr_1985_012.xml,80444/xv19079,0,0,0,0
"Axelrod (Christine Johnson) Student Folklore Fieldwork Project",orflr_1972_092.xml,80444/xv83877,0,0,0,0
"Parvi (Brittany) Student Folklore Fieldwork Project",orflr_2010_050.xml,80444/xv45764,0,0,0,0
"Palfreyman (Laurie) Student Folklore Fieldwork Project",orflr_1972_138.xml,80444/xv39407,0,0,0,0
"Knowles (Mike) Student Folklore Fieldwork Project",orflr_2012_094.xml,80444/xv42224,0,0,0,0
"Student Folklore Fieldwork Project",orflr_1973_245.xml,80444/xv21856,0,0,0,0
"Carr (Revell J. III) Student Folklore Fieldwork Project",orflr_1998_002.xml,80444/xv72875,0,0,0,0
"Szedny (Stephanie) Student Folklore Fieldwork Project",orflr_1972_200.xml,80444/xv32391,0,0,0,0
"Woodman (Megan T.) Student Folklore Fieldwork Project",orflr_1996_022.xml,80444/xv41442,0,0,0,0
"Wortendyke (Jan) Student Folklore Fieldwork Project",orflr_1978_010.xml,80444/xv17898,0,0,0,0
"Egan (Jim) Student Folklore Fieldwork Project",orflr_1975_087.xml,80444/xv03619,0,0,0,0
"Reuter (Bob) Student Folklore Fieldwork Project",orflr_1974_281.xml,80444/xv42132,0,0,0,0
"Redditt (Rhonda) Student Folklore Fieldwork Project",orflr_1982_037.xml,80444/xv97558,0,0,0,0
"Chase (Cheryl) Student Folklore Fieldwork Project",orflr_1971_182.xml,80444/xv94699,0,0,0,0
"Kwong (Low Yew) Student Folklore Fieldwork Project",orflr_1986_016.xml,80444/xv07418,0,0,0,0
"Bleeck (Diane A.) Student Folklore Fieldwork Project",orflr_1982_106.xml,80444/xv73016,0,0,0,0
"Poole (Philip A.) Student Folklore Fieldwork Project",orflr_1972_195.xml,80444/xv04812,0,0,0,0
"Student Folklore Fieldwork Project",orflr_1973_266.xml,80444/xv90374,0,0,0,0
"Nakajima (Setsuko) Student Folklore Fieldwork Project",orflr_1981_032.xml,80444/xv33148,0,0,0,0
"Panigeo (Alice) Student Folklore Fieldwork Project",orflr_1976_124.xml,80444/xv12716,0,0,0,0
"Parker (Erik) Student Folklore Fieldwork Project",orflr_2010_036.xml,80444/xv88214,0,0,0,0
"Stanley (Matthew) Student Folklore Fieldwork Project",orflr_1975_047.xml,80444/xv27331,0,0,0,0
"Valaer (David) Student Folklore Fieldwork Project",orflr_1982_041.xml,80444/xv77624,0,0,0,0
"Hughes (Candice) Student Folklore Fieldwork Project",orflr_2008_092.xml,80444/xv99319,0,0,0,0
"Neuman (Avi) Student Folklore Fieldwork Project",orflr_2000_005.xml,80444/xv11740,0,0,0,0
"Hollis (Jeff) Student Folklore Fieldwork Project",orflr_1974_149.xml,80444/xv21020,0,0,0,0
"Sistrom (Michael) Student Folklore Fieldwork Project",orflr_1986_022.xml,80444/xv35681,0,0,0,0
"Haley (Mary) Student Folklore Fieldwork Project",orflr_1971_045.xml,80444/xv56341,0,0,0,0
"Rodiger (Judith E.) Student Folklore Fieldwork Project",orflr_1974_083.xml,80444/xv54870,0,0,0,0
"Brabb (Dale) Student Folklore Fieldwork Project",orflr_1976_026.xml,80444/xv37539,0,0,0,0
"Calhoun (Joe) Student Folklore Fieldwork Project",orflr_1980_018.xml,80444/xv49633,0,0,0,0
"Giles (Sarah) Student Folklore Fieldwork Project",orflr_2008_079.xml,80444/xv76019,0,0,0,0
"McCalley (Elizabeth A.) Student Folklore Fieldwork Project",orflr_1976_062.xml,80444/xv05444,0,0,0,0
"Coe (Allison) Student Folklore Fieldwork Project",orflr_1987_008.xml,80444/xv68392,0,0,0,0
"Cornacchia (Monica) Student Folklore Fieldwork Project",orflr_2006_033.xml,80444/xv70098,0,0,0,0
"Danielson (John) Student Folklore Fieldwork Project",orflr_1972_106.xml,80444/xv09317,0,0,0,0
"Tetlow (Julie) Student Folklore Fieldwork Project",orflr_1974_296.xml,80444/xv14678,0,0,0,0
"Reed (Marc) Student Folklore Fieldwork Project",orflr_1981_035.xml,80444/xv89346,0,0,0,0
"Herkenhoff (Tyler) Student Folklore Fieldwork Project",orflr_2012_072.xml,80444/xv04284,0,0,0,0
"Frye (George-ann) Student Folklore Fieldwork Project",orflr_1974_039.xml,80444/xv21749,0,0,0,0
"Student Folklore Fieldwork Project",orflr_1971_371.xml,80444/xv78494,0,0,0,0
"Ingram (Lisa) Student Folklore Fieldwork Project",orflr_2008_021.xml,80444/xv77380,0,0,0,0
"Sabol (Beverly) Student Folklore Fieldwork Project",orflr_1977_088.xml,80444/xv70373,0,0,0,0
"MacNeil (Bradford) Student Folklore Fieldwork Project",orflr_1974_161.xml,80444/xv28363,0,0,0,0
"Neuman (Avi) Student Folklore Fieldwork Project",orflr_2000_004.xml,80444/xv70501,0,0,0,0
"Nathan (Linda L.) Student Folklore Fieldwork Project",orflr_1974_321.xml,80444/xv96054,0,0,0,0
"Swanson (Kristin) Student Folklore Fieldwork Project",orflr_1991_007.xml,80444/xv32687,0,0,0,0
"Kim (Louise) Student Folklore Fieldwork Project",orflr_1974_156.xml,80444/xv60586,0,0,0,0
"Lowry (Catherine) Student Folklore Fieldwork Project",orflr_2008_099.xml,80444/xv41571,0,0,0,0
"Student Folklore Fieldwork Project",orflr_1973_282.xml,80444/xv14923,0,0,0,0
"Burns (Steven) Student Folklore Fieldwork Project",orflr_1991_025.xml,80444/xv93148,0,0,0,0
"Student Folklore Fieldwork Project",orflr_1973_150.xml,80444/xv21115,0,0,0,0
"Browning-Kamins (Lara) Student Folklore Fieldwork Project",orflr_2008_162.xml,80444/xv79852,0,0,0,0
"Gabel (Willena) Student Folklore Fieldwork Project",orflr_1979_031.xml,80444/xv47521,0,0,0,0
"Radmaker (Nora) Student Folklore Fieldwork Project",orflr_1972_145.xml,80444/xv95797,0,0,0,0
"Garish (Matthew R.) Student Folklore Fieldwork Project",orflr_2008_048.xml,80444/xv67279,0,0,0,0
"Danielson (John) Student Folklore Fieldwork Project",orflr_1972_105.xml,80444/xv70187,0,0,0,0
"Clapp (Michael G.) Student Folklore Fieldwork Project",orflr_1985_005.xml,80444/xv58007,0,0,0,0
"Wells (Linda) Student Folklore Fieldwork Project",orflr_1985_053.xml,80444/xv19900,0,0,0,0
"Lida (Chelsey) Student Folklore Fieldwork Project",orflr_2007_003.xml,80444/xv21640,0,0,0,0
"Schwartz (Colton) Student Folklore Fieldwork Project",orflr_1991_019.xml,80444/xv34463,0,0,0,0
"Fairbanks (Janet) Student Folklore Fieldwork Project",orflr_1972_030.xml,80444/xv70141,0,0,0,0
"O'Connor (Catherine A.) Student Folklore Fieldwork Project",orflr_1986_035.xml,80444/xv75329,0,0,0,0
"Berger (Jeannetta) Student Folklore Fieldwork Project",orflr_1970_034.xml,80444/xv89556,0,0,0,0
"Smith (Jennifer) Student Folklore Fieldwork Project",orflr_2005_003.xml,80444/xv55902,0,0,0,0
"Messer (Bill) Student Folklore Fieldwork Project",orflr_1988_011.xml,80444/xv40676,0,0,0,0
"Delperdang (M. Nicholas) Student Folklore Fieldwork Project",orflr_1996_008.xml,80444/xv20336,0,0,0,0
"Schuening (Judy) Student Folklore Fieldwork Project",orflr_1976_156.xml,80444/xv38400,0,0,0,0
"Lazarus (Gary M.) Student Folklore Fieldwork Project",orflr_1971_062b.xml,80444/xv00524,0,0,0,0
"Frisch (Paul) Student Folklore Fieldwork Project",orflr_1971_282.xml,80444/xv08773,0,0,0,0
"Bagdriwicz (Sarah) Student Folklore Fieldwork Project",orflr_2012_014.xml,80444/xv16366,0,0,0,0
"Stephens (Amanda) Student Folklore Fieldwork Project",orflr_2008_087.xml,80444/xv21929,0,0,0,0
"O'Rourke (Mike) Student Folklore Fieldwork Project",orflr_1993_031.xml,80444/xv92416,0,0,0,0
"Chatari (Kris) Student Folklore Fieldwork Project",orflr_1973_021.xml,80444/xv65655,0,0,0,0
"Deckelmann (M.E.) Student Folklore Fieldwork Project",orflr_1977_068.xml,80444/xv32318,0,0,0,0
"Oliver-Daystar (Bree) Student Folklore Fieldwork Project",orflr_2002_016.xml,80444/xv60083,0,0,0,0
"Boye (Alan) Student Folklore Fieldwork Project",orflr_1984_040.xml,80444/xv79580,0,0,0,0
"Stacy Jr (Donald) Student Folklore Fieldwork Project",orflr_2010_120.xml,80444/xv74826,0,0,0,0
"Anonymous Student Folklore Fieldwork Project",orflr_1971_168.xml,80444/xv98181,0,0,0,0
"Soboleff (Ross V.) Student Folklore Fieldwork Project",orflr_1974_048.xml,80444/xv10241,0,0,0,0
"Hamm (Mike) Student Folklore Fieldwork Project",orflr_1974_021.xml,80444/xv76983,0,0,0,0
"Martin (Tiffany) Student Folklore Fieldwork Project",orflr_2007_005.xml,80444/xv43420,0,0,0,0
"Tom (Yun-Hsien) Student Folklore Fieldwork Project",orflr_2003_007.xml,80444/xv17715,0,0,0,0
"Alexander (April) Student Folklore Fieldwork Project",orflr_2008_063.xml,80444/xv91766,0,0,0,0
"Beechler (Jeanie) Student Folklore Fieldwork Project",orflr_1974_119.xml,80444/xv89068,0,0,0,0
"Kloppenburg (Doug) Student Folklore Fieldwork Project",orflr_1977_108.xml,80444/xv33419,0,0,0,0
"Student Folklore Fieldwork Project",orflr_1973_105.xml,80444/xv72616,0,0,0,0
"Student Folklore Fieldwork Project",orflr_1973_296.xml,80444/xv56182,0,0,0,0
"Student Folklore Fieldwork Project",orflr_1971_368.xml,80444/xv28292,0,0,0,0
"Wells (Carole L.) Student Folklore Fieldwork Project",orflr_1974_094.xml,80444/xv97500,0,0,0,0
"Blanohard (Debbie) Student Folklore Fieldwork Project",orflr_1972_184.xml,80444/xv86965,0,0,0,0
"Student Folklore Fieldwork Project",orflr_1973_166.xml,80444/xv13394,0,0,0,0
"Wacker (Jan) Student Folklore Fieldwork Project",orflr_1975_116.xml,80444/xv55209,0,0,0,0
"Berlin (Karen) Student Folklore Fieldwork Project",orflr_1985_003.xml,80444/xv92193,0,0,0,0
"Student Folklore Fieldwork Project",orflr_1973_195.xml,80444/xv89202,0,0,0,0
"Dick (Bill) Student Folklore Fieldwork Project",orflr_1974_060.xml,80444/xv98968,0,0,0,0
"Anonymous #7 Student Folklore Fieldwork Project",orflr_1972_090.xml,80444/xv50680,0,0,0,0
"Student Folklore Fieldwork Project",orflr_1973_235.xml,80444/xv66482,0,0,0,0
"Turner (Steve) Student Folklore Fieldwork Project",orflr_1984_036.xml,80444/xv35971,0,0,0,0
"Magor-Goertzel (Kathleen A.) Student Folklore Fieldwork Project",orflr_1971_146.xml,80444/xv00585,0,0,0,0
"Radmaker (Nora) Student Folklore Fieldwork Project",orflr_1972_143.xml,80444/xv00506,0,0,0,0
"Fletcher (Steven) Student Folklore Fieldwork Project",orflr_1989_042.xml,80444/xv67831,0,0,0,0
"Student Folklore Fieldwork Project",orflr_1973_293.xml,80444/xv82208,0,0,0,0
"Baldwin (Andrew) Student Folklore Fieldwork Project",orflr_2008_011.xml,80444/xv56466,0,0,0,0
"Robb (Andrew Page) Student Folklore Fieldwork Project",orflr_2008_149.xml,80444/xv03591,0,0,0,0
"Hodges (Heather D.) Student Folklore Fieldwork Project",orflr_1992_021.xml,80444/xv86059,0,0,0,0
"Danielson (Linda L.) Student Folklore Fieldwork Project",orflr_1985_011.xml,80444/xv53778,0,0,0,0
"Dunn (Deborah) Student Folklore Fieldwork Project",orflr_1976_137.xml,80444/xv55691,0,0,0,0
"Cronin (Daniel) Student Folklore Fieldwork Project",orflr_1975_193.xml,80444/xv53231,0,0,0,0
"Cobb (Daniel) Student Folklore Fieldwork Project",orflr_2010_067.xml,80444/xv75262,0,0,0,0
"Lascheck (Robert) Student Folklore Fieldwork Project",orflr_2010_085.xml,80444/xv95645,0,0,0,0
"Kohno (Mariko) Student Folklore Fieldwork Project",orflr_2002_045.xml,80444/xv62289,0,0,0,0
"Eason (Kara) Student Folklore Fieldwork Project",orflr_2008_073.xml,80444/xv61203,0,0,0,0
"Girod (Laura A.) Student Folklore Fieldwork Project",orflr_1976_040.xml,80444/xv81134,0,0,0,0
"Turner (Carla) Student Folklore Fieldwork Project",orflr_1996_020.xml,80444/xv54833,0,0,0,0
"Taylor (Lynn) Student Folklore Fieldwork Project",orflr_1974_295.xml,80444/xv56045,0,0,0,0
"Student Folklore Fieldwork Project",orflr_1973_117.xml,80444/xv15423,0,0,0,0
"Navarre (Gary) Student Folklore Fieldwork Project",orflr_1974_170.xml,80444/xv45745,0,0,0,0
"Hadley (Lynn) Student Folklore Fieldwork Project",orflr_1999_009.xml,80444/xv31640,0,0,0,0
"Harris (Bruce) Student Folklore Fieldwork Project",orflr_1974_244.xml,80444/xv23883,0,0,0,0
"Wilson (Theresa) Student Folklore Fieldwork Project",orflr_1975_056.xml,80444/xv21099,0,0,0,0
"Faux (Dave) Student Folklore Fieldwork Project",orflr_1999_007.xml,80444/xv83160,0,0,0,0
"Student Folklore Fieldwork Project",orflr_1973_206.xml,80444/xv83157,0,0,0,0
"Taylor (Nancy A.) Student Folklore Fieldwork Project",orflr_1977_012.xml,80444/xv68978,0,0,0,0
"Gabriel (Matthew) Student Folklore Fieldwork Project",orflr_2010_101.xml,80444/xv13519,0,0,0,0
"Cadigan (Daniel) Student Folklore Fieldwork Project",orflr_2008_039.xml,80444/xv31005,0,0,0,0
"Robinson (James C.) Student Folklore Fieldwork Project",orflr_1974_010.xml,80444/xv99331,0,0,0,0
"Mixon (Alysoun) Student Folklore Fieldwork Project",orflr_1991_023.xml,80444/xv56604,0,0,0,0
"Curry (Ann) Student Folklore Fieldwork Project",orflr_1976_020.xml,80444/xv68524,0,0,0,0
"Rabun (Sheila) Student Folklore Fieldwork Project",orflr_2010_116b.xml,80444/xv68112,0,0,0,0
"Washburn (Brennan) Student Folklore Fieldwork Project",orflr_2002_097.xml,80444/xv62564,0,0,0,0
"Jennings (Douglas) Student Folklore Fieldwork Project",orflr_1977_061.xml,80444/xv02328,0,0,0,0
"Cahill (Kelly) Student Folklore Fieldwork Project",orflr_2002_040.xml,80444/xv27987,0,0,0,0
"Burge (Janet) Student Folklore Fieldwork Project",orflr_1977_017.xml,80444/xv66403,0,0,0,0
"Mathur (Kai lani) Student Folklore Fieldwork Project",orflr_2007_006.xml,80444/xv17614,0,0,0,0
"Haggerty (Sean) Student Folklore Fieldwork Project",orflr_2002_010.xml,80444/xv13186,0,0,0,0
"Farr (Gail) Student Folklore Fieldwork Project",orflr_1972_159b.xml,80444/xv76321,0,0,0,0
"DeCourcey (Jeanne) Student Folklore Fieldwork Project",orflr_1970_122.xml,80444/xv51556,0,0,0,0
"Loeks (Linda Lee) Student Folklore Fieldwork Project",orflr_1976_149.xml,80444/xv66210,0,0,0,0
"Marquis (Robert) Student Folklore Fieldwork Project",orflr_1982_063.xml,80444/xv74029,0,0,0,0
"Hilliard (Jill) Student Folklore Fieldwork Project",orflr_2012_073.xml,80444/xv87026,0,0,0,0
"Martinez (Elena) Student Folklore Fieldwork Project",orflr_1997_016.xml,80444/xv23834,0,0,0,0
"Anonymous Student Folklore Fieldwork Project",orflr_0000_004.xml,80444/xv25753,0,0,0,0
"Andrews (Alyce) Student Folklore Fieldwork Project",orflr_1996_003.xml,80444/xv14855,0,0,0,0
"Holland (Maggie) Student Folklore Fieldwork Project",orflr_1974_327.xml,80444/xv10104,0,0,0,0
"Beck (Nancy) Student Folklore Fieldwork Project",orflr_1972_096.xml,80444/xv92181,0,0,0,0
"Hunt (Kathryn) Student Folklore Fieldwork Project",orflr_1982_085.xml,80444/xv98767,0,0,0,0
"Student Folklore Fieldwork Project",orflr_1972_004.xml,80444/xv88034,0,0,0,0
"Drouet (Taylor J.) Student Folklore Fieldwork Project",orflr_2008_005.xml,80444/xv48144,0,0,0,0
"Streeter (Ingrid) Student Folklore Fieldwork Project",orflr_1989_039.xml,80444/xv90234,0,0,0,0
"Student Folklore Fieldwork Project",orflr_1973_320.xml,80444/xv34936,0,0,0,0
"Wyss (Wiley) Student Folklore Fieldwork Project",orflr_2008_180.xml,80444/xv81802,0,0,0,0
"Lathrop (Jayme) Student Folklore Fieldwork Project",orflr_2006_004.xml,80444/xv97042,0,0,0,0
"Student Folklore Fieldwork Project",orflr_1973_119.xml,80444/xv66769,0,0,0,0
"Day (Donna) Student Folklore Fieldwork Project",orflr_1973_030.xml,80444/xv44345,0,0,0,0
"Student Folklore Fieldwork Project",orflr_1973_147.xml,80444/xv39276,0,0,0,0
"Colvin (Penny Lee) Student Folklore Fieldwork Project",orflr_1975_123.xml,80444/xv37335,0,0,0,0
"Student Folklore Fieldwork Project",orflr_1973_310.xml,80444/xv23294,0,0,0,0
"Barnett (Malia A.) Student Folklore Fieldwork Project",orflr_1990_004.xml,80444/xv41259,0,0,0,0
"Friedman (Lesley) Student Folklore Fieldwork Project",orflr_1974_139.xml,80444/xv32550,0,0,0,0
"Engbeck (Erin) Student Folklore Fieldwork Project",orflr_2008_168.xml,80444/xv77035,0,0,0,0
"Uarich (Diane) Student Folklore Fieldwork Project",orflr_1979_027.xml,80444/xv29821,0,0,0,0
"Callahan (Thomas J.) Student Folklore Fieldwork Project",orflr_1977_147.xml,80444/xv55938,0,0,0,0
"Guppy (Malea) Student Folklore Fieldwork Project",orflr_2012_062.xml,80444/xv30056,0,0,0,0
"Gates (Charlene) Student Folklore Fieldwork Project",orflr_1977_104.xml,80444/xv08786,0,0,0,0
"Williams (Olivia) Student Folklore Fieldwork Project",orflr_2010_068.xml,80444/xv59960,0,0,0,0
"O'Donnell (Kate) Student Folklore Fieldwork Project",orflr_1987_030.xml,80444/xv71237,0,0,0,0
"Olsen (Ben) Student Folklore Fieldwork Project",orflr_2006_049.xml,80444/xv12988,0,0,0,0
"Clark (Jenna) Student Folklore Fieldwork Project",orflr_2008_047.xml,80444/xv98040,0,0,0,0
"Almand (Laurie) Student Folklore Fieldwork Project",orflr_1973_008.xml,80444/xv98364,0,0,0,0
"Gallerneaux Brooks (Kristen) Student Folklore Fieldwork Project",orflr_2011_020.xml,80444/xv63586,0,0,0,0
"Webber (LeeAnne) Student Folklore Fieldwork Project",orflr_1980_055.xml,80444/xv56372,0,0,0,0
"Carthew (Alexandra) Student Folklore Fieldwork Project",orflr_2012_031.xml,80444/xv84207,0,0,0,0
"Student Folklore Fieldwork Project",orflr_1973_171.xml,80444/xv33801,0,0,0,0
"Berkstresser (Candice P.) Student Folklore Fieldwork Project",orflr_1971_321.xml,80444/xv31610,0,0,0,0
"Pierce (Shannon) Student Folklore Fieldwork Project",orflr_1987_041.xml,80444/xv86282,0,0,0,0
"Student Folklore Fieldwork Project",orflr_1971_353.xml,80444/xv86126,0,0,0,0
"Moshofsky (Mary) Student Folklore Fieldwork Project",orflr_1977_145.xml,80444/xv80441,0,0,0,0
"Willig (Robert M.) Student Folklore Fieldwork Project",orflr_1972_157.xml,80444/xv94247,0,0,0,0
"Cooper (Hiett) Student Folklore Fieldwork Project",orflr_1992_017.xml,80444/xv81320,0,0,0,0
"Heidemann (Cindy) Student Folklore Fieldwork Project",orflr_1974_101.xml,80444/xv03536,0,0,0,0
"Burk (Kathleen) Student Folklore Fieldwork Project",orflr_2001_002.xml,80444/xv92657,0,0,0,0
"Student Folklore Fieldwork Project",orflr_1973_315.xml,80444/xv16381,0,0,0,0
"Davidson (Richard) Student Folklore Fieldwork Project",orflr_1987_012.xml,80444/xv13800,0,0,0,0
"Schlein (Neil) Student Folklore Fieldwork Project",orflr_2005_005.xml,80444/xv29827,0,0,0,0
"Olson (Holly) Student Folklore Fieldwork Project",orflr_2008_151.xml,80444/xv94177,0,0,0,0
"Browning (Tom L.) Student Folklore Fieldwork Project",orflr_1971_179.xml,80444/xv01461,0,0,0,0
"Zipf (Brett) Student Folklore Fieldwork Project",orflr_2008_190.xml,80444/xv83319,0,0,0,0
"Shields (Amy) Folklore Thesis",orflr_2010_119.xml,80444/xv31399,0,0,0,0
"Riley (Patti) Student Folklore Fieldwork Project",orflr_1971_254.xml,80444/xv47134,0,0,0,0
"Grow (Sophie) Student Folklore Fieldwork Project",orflr_2009_011.xml,80444/xv66067,0,0,0,0
"Brabb (Dale) Student Folklore Fieldwork Project",orflr_1977_001.xml,80444/xv79937,0,0,0,0
"Minato (Dena Marie) Student Folklore Fieldwork Project",orflr_1980_046.xml,80444/xv71328,0,0,0,0
"Foster (Hobert G.) Student Folklore Fieldwork Project",orflr_1974_020.xml,80444/xv51141,0,0,0,0
"Hammond (Julia) Student Folklore Fieldwork Project",orflr_2002_011.xml,80444/xv90573,0,0,0,0
"CaJaedy (Judy) Student Folklore Fieldwork Project",orflr_1980_001.xml,80444/xv40554,0,0,0,0
"Lantz (Cindi) Student Folklore Fieldwork Project",orflr_1977_037.xml,80444/xv26950,0,0,0,0
"Student Folklore Fieldwork Project",orflr_1973_288.xml,80444/xv05004,0,0,0,0
"Wagner (Pamela) Student Folklore Fieldwork Project",orflr_1984_057.xml,80444/xv38385,0,0,0,0
"Cluff (Marion E.) Student Folklore Fieldwork Project",orflr_1973_026.xml,80444/xv05599,0,0,0,0
"Lenzser (Fred) Student Folklore Fieldwork Project",orflr_1972_191.xml,80444/xv20480,0,0,0,0
"Loomis (Alexandra) Student Folklore Fieldwork Project",orflr_2011_028.xml,80444/xv78369,0,0,0,0
"Michalk (Christina) Student Folklore Fieldwork Project",orflr_2008_097.xml,80444/xv32125,0,0,0,0
"Rice (Raymond) Student Folklore Fieldwork Project",orflr_2002_031.xml,80444/xv88977,0,0,0,0
"Smith (Bridget) Student Folklore Fieldwork Project",orflr_1976_001.xml,80444/xv55722,0,0,0,0
"Ranch (Yvonne) Student Folklore Fieldwork Project",orflr_1990_017.xml,80444/xv57482,0,0,0,0
"Wechsler (Jim) Student Folklore Fieldwork Project",orflr_1974_198.xml,80444/xv23892,0,0,0,0
"Borok (Bill) Student Folklore Fieldwork Project",orflr_1984_011.xml,80444/xv54534,0,0,0,0
"Arnold (Kathryn) Student Folklore Fieldwork Project",orflr_1980_047.xml,80444/xv47671,0,0,0,0
"Lewman (Cheryl) Student Folklore Fieldwork Project",orflr_2005_015.xml,80444/xv65832,0,0,0,0
"Connelly (Angela) Student Folklore Fieldwork Project",orflr_1984_012.xml,80444/xv54159,0,0,0,0
"Student Folklore Fieldwork Project",orflr_1973_187.xml,80444/xv64471,0,0,0,0
"Student Folklore Fieldwork Project",orflr_1973_268.xml,80444/xv53445,0,0,0,0
"Mattox (Phillip D.) Student Folklore Fieldwork Project",orflr_1974_166.xml,80444/xv66519,0,0,0,0
"Vitter (Nancy) Student Folklore Fieldwork Project",orflr_1970_119.xml,80444/xv42773,0,0,0,0
"Harting (Michael G.) Student Folklore Fieldwork Project",orflr_1981_041.xml,80444/xv47402,0,0,0,0
"Griffin (Spencer) Student Folklore Fieldwork Project",orflr_2012_060.xml,80444/xv79458,0,0,0,0
"Glassow (Olivia) Student Folklore Fieldwork Project",orflr_2011_021.xml,80444/xv89788,0,0,0,0
"Sullivan (Alex) Student Folklore Fieldwork Project",orflr_1971_130.xml,80444/xv65390,0,0,0,0
"Student Folklore Fieldwork Project",orflr_1973_189.xml,80444/xv54583,0,0,0,0
"Starke (Gail) Student Folklore Fieldwork Project",orflr_1976_107.xml,80444/xv23876,0,0,0,0
"Rockey (Susan K.) Student Folklore Fieldwork Project",orflr_1974_325.xml,80444/xv20791,0,0,0,0
"Deaver (Colin) Student Folklore Fieldwork Project",orflr_2010_093.xml,80444/xv64804,0,0,0,0
"Anderson (Judith Lynn) Student Folklore Fieldwork Project",orflr_1971_159.xml,80444/xv37380,0,0,0,0
"Trano (Jamie) Student Folklore Fieldwork Project",orflr_2006_052.xml,80444/xv12292,0,0,0,0
"Gowing (Gwendolyn) Student Folklore Fieldwork Project",orflr_1983_017.xml,80444/xv39581,0,0,0,0
"Carroll (Stephanie) Student Folklore Fieldwork Project",orflr_2006_013.xml,80444/xv28289,0,0,0,0
"Naeda (Sumie) Student Folklore Fieldwork Project",orflr_1982_007.xml,80444/xv07217,0,0,0,0
"Haddatz (Sally) Student Folklore Fieldwork Project",orflr_1971_252.xml,80444/xv84970,0,0,0,0
"Sherman (Sharon) Student Folklore Fieldwork Project",orflr_1981_038.xml,80444/xv33291,0,0,0,0
"Bobiak (Stephanie M.) Student Folklore Fieldwork Project",orflr_2003_006.xml,80444/xv74865,0,0,0,0
"O'Connor (Brian) Student Folklore Fieldwork Project",orflr_1971_242.xml,80444/xv43542,0,0,0,0
"Student Folklore Fieldwork Project",orflr_1973_347.xml,80444/xv85113,0,0,0,0
"Meader (J. Faith) Student Folklore Fieldwork Project",orflr_1997_008.xml,80444/xv03683,0,0,0,0
"Miller (Simone) Student Folklore Fieldwork Project",orflr_1974_268.xml,80444/xv55718,0,0,0,0
"Hayes (Kimberly) Student Folklore Fieldwork Project",orflr_1973_049.xml,80444/xv36016,0,0,0,0
"Danielson (Linda L.) Student Folklore Fieldwork Project",orflr_1983_033.xml,80444/xv16928,0,0,0,0
"O'Dell (Michael) Student Folklore Fieldwork Project",orflr_1978_007.xml,80444/xv90521,0,0,0,0
"Student Folklore Fieldwork Project",orflr_1973_335.xml,80444/xv78613,0,0,0,0
"Saure (Susanne) Student Folklore Fieldwork Project",orflr_1984_008.xml,80444/xv88803,0,0,0,0
"Anonymous Student Folklore Fieldwork Project",orflr_1969_001.xml,80444/xv85241,0,0,0,0
"Choe (Martha) Student Folklore Fieldwork Project",orflr_1978_004.xml,80444/xv30929,0,0,0,0
"Anonymous Student Folklore Fieldwork Project",orflr_1971_004.xml,80444/xv13903,0,0,0,0
"Sellai (Christine A.) Student Folklore Fieldwork Project",orflr_1989_031.xml,80444/xv87600,0,0,0,0
"Day (Hallie) Student Folklore Fieldwork Project",orflr_2011_014.xml,80444/xv48147,0,0,0,0
"Maki (Al) Student Folklore Fieldwork Project",orflr_1977_080.xml,80444/xv07815,0,0,0,0
"Serling (Sandi) Student Folklore Fieldwork Project",orflr_1976_164.xml,80444/xv15078,0,0,0,0
"Levy (Louie) Student Folklore Fieldwork Project",orflr_1984_019.xml,80444/xv48495,0,0,0,0
"Buechler (Zach) Student Folklore Fieldwork Project",orflr_2008_050.xml,80444/xv52697,0,0,0,0
"Hart (Moriah) Student Folklore Fieldwork Project",orflr_2006_009.xml,80444/xv35861,0,0,0,0
"Vasquez (Juan) Student Folklore Fieldwork Project",orflr_2009_007.xml,80444/xv57681,0,0,0,0
"Kessel (Darlene) Student Folklore Fieldwork Project",orflr_1983_020.xml,80444/xv17831,0,0,0,0
"Ten Eyck (Chris) Student Folklore Fieldwork Project",orflr_2008_109.xml,80444/xv59561,0,0,0,0
"Brandley (Barbara L.) Student Folklore Fieldwork Project",orflr_1974_055.xml,80444/xv34542,0,0,0,0
"Shide (LaBree) Student Folklore Fieldwork Project",orflr_2002_048.xml,80444/xv08892,0,0,0,0
"Bledsoe (John W.) Student Folklore Fieldwork Project",orflr_1974_121.xml,80444/xv00180,0,0,0,0
"Niemi (Angela) Student Folklore Fieldwork Project",orflr_2006_048.xml,80444/xv26702,0,0,0,0
"Student Folklore Fieldwork Project",orflr_1973_269.xml,80444/xv26229,0,0,0,0
"Roberts (Cindy) Student Folklore Fieldwork Project",orflr_1971_255.xml,80444/xv19137,0,0,0,0
"Tarter (Karen) Student Folklore Fieldwork Project",orflr_1996_012.xml,80444/xv17138,0,0,0,0
"Dutke (Patti) Student Folklore Fieldwork Project",orflr_1975_170.xml,80444/xv81262,0,0,0,0
"Zielony (Ann) Student Folklore Fieldwork Project",orflr_1974_208.xml,80444/xv51910,0,0,0,0
"Bliss (Jacquelyn) Student Folklore Fieldwork Project",orflr_2012_022.xml,80444/xv17575,0,0,0,0
"Hill (Bonnie) Student Folklore Fieldwork Project",orflr_1975_130.xml,80444/xv15808,0,0,0,0
"Lehto (Nancy S.) Student Folklore Fieldwork Project",orflr_1976_123.xml,80444/xv21319,0,0,0,0
"Pike (Taylor) Student Folklore Fieldwork Project",orflr_2010_041.xml,80444/xv95864,0,0,0,0
"Simpson (Tracey L.) Student Folklore Fieldwork Project",orflr_1986_021.xml,80444/xv88363,0,0,0,0
"Leslie (Jennifer) Student Folklore Fieldwork Project",orflr_1984_018.xml,80444/xv61999,0,0,0,0
"Sandvig (Barbara) Student Folklore Fieldwork Project",orflr_1977_122.xml,80444/xv86361,0,0,0,0
"King (Jennifer P.) Student Folklore Fieldwork Project",orflr_1980_030.xml,80444/xv43478,0,0,0,0
"Degroot (K.A.) Student Folklore Fieldwork Project",orflr_1985_009.xml,80444/xv67849,0,0,0,0
"Student Folklore Fieldwork Project",orflr_1973_107.xml,80444/xv20458,0,0,0,0
"Nelson (Stephen H.) Student Folklore Fieldwork Project",orflr_1972_174.xml,80444/xv54110,0,0,0,0
"Jaques (Nanette) Student Folklore Fieldwork Project",orflr_1975_027.xml,80444/xv51800,0,0,0,0
"Meads (Stacy) Student Folklore Fieldwork Project",orflr_2010_034.xml,80444/xv16491,0,0,0,0
"Lindsey (Nancy) Student Folklore Fieldwork Project",orflr_1975_160.xml,80444/xv73052,0,0,0,0
"Student Folklore Fieldwork Project",orflr_1973_216.xml,80444/xv07675,0,0,0,0
"Koppensteiner (Debra) Student Folklore Fieldwork Project",orflr_1974_000.xml,80444/xv83084,0,0,0,0
"Browning (Steven R.) Student Folklore Fieldwork Project",orflr_1989_052.xml,80444/xv91125,0,0,0,0
"Asher (Sally A.) Student Folklore Fieldwork Project",orflr_1971_318.xml,80444/xv14245,0,0,0,0
"Student Folklore Fieldwork Project",orflr_1973_208.xml,80444/xv84796,0,0,0,0
"Green (Sharon A.) Student Folklore Fieldwork Project",orflr_1977_105.xml,80444/xv70223,0,0,0,0
"Moore (Edward) Student Folklore Fieldwork Project",orflr_1992_015.xml,80444/xv61187,0,0,0,0
"Sterton (Gary) Student Folklore Fieldwork Project",orflr_1975_051.xml,80444/xv50381,0,0,0,0
"Katz (Steven) Student Folklore Fieldwork Project",orflr_1974_249.xml,80444/xv53771,0,0,0,0
"Gavce (Karen D.) Student Folklore Fieldwork Project",orflr_1984_030.xml,80444/xv10943,0,0,0,0
"Knesal (Brian) Student Folklore Fieldwork Project",orflr_1975_134.xml,80444/xv43811,0,0,0,0
"Krygier (Kathryn) Student Folklore Fieldwork Project",orflr_1974_256.xml,80444/xv07684,0,0,0,0
"Student Folklore Fieldwork Project",orflr_1973_286.xml,80444/xv53253,0,0,0,0
"Thomas (Kathryn) Student Folklore Fieldwork Project",orflr_1972_060.xml,80444/xv67965,0,0,0,0
"Pressnall (Gail) Student Folklore Fieldwork Project",orflr_1976_125.xml,80444/xv93411,0,0,0,0
"Anonymous Student Folklore Fieldwork Project",orflr_1971_161.xml,80444/xv78408,0,0,0,0
"Long (David) Student Folklore Fieldwork Project",orflr_1991_031.xml,80444/xv73419,0,0,0,0
"Kisling (Jon A.) Student Folklore Fieldwork Project",orflr_1988_008.xml,80444/xv55841,0,0,0,0
"Smith (Teresa) Student Folklore Fieldwork Project",orflr_1973_085.xml,80444/xv42871,0,0,0,0
"Student Folklore Fieldwork Project",orflr_1973_267.xml,80444/xv01177,0,0,0,0
"Byrnes (Barbara) Student Folklore Fieldwork Project",orflr_1976_007.xml,80444/xv16668,0,0,0,0
"Adams (Jason) Student Folklore Fieldwork Project",orflr_1993_025.xml,80444/xv75402,0,0,0,0
"Rogers (Shannon) Student Folklore Fieldwork Project",orflr_1996_014.xml,80444/xv84692,0,0,0,0
"Bedford (Brian) Student Folklore Fieldwork Project",orflr_2008_054.xml,80444/xv52798,0,0,0,0
"Holcomb (Vincent) Student Folklore Fieldwork Project",orflr_1975_022.xml,80444/xv89151,0,0,0,0
"Yimsut (Ranachith) Student Folklore Fieldwork Project",orflr_1984_026.xml,80444/xv03173,0,0,0,0
"McFetridge (Mike) Student Folklore Fieldwork Project",orflr_1971_144.xml,80444/xv66662,0,0,0,0
"Student Folklore Fieldwork Project",orflr_1971_342.xml,80444/xv29980,0,0,0,0
"Name Student Folklore Fieldwork Project",orflr_1980_060.xml,80444/xv22634,0,0,0,0
"George (Vesla) Student Folklore Fieldwork Project",orflr_1974_235.xml,80444/xv30291,0,0,0,0
"Palmer (Scott) Student Folklore Fieldwork Project",orflr_1976_067.xml,80444/xv15661,0,0,0,0
"Student Folklore Fieldwork Project",orflr_1973_336.xml,80444/xv13244,0,0,0,0
"Fisk-May (Karen) Student Folklore Fieldwork Project",orflr_1987_017.xml,80444/xv59909,0,0,0,0
"Haynes (Sandra A.) Student Folklore Fieldwork Project",orflr_1993_026.xml,80444/xv88470,0,0,0,0
"Robinson (James C.) Student Folklore Fieldwork Project",orflr_1974_082.xml,80444/xv87936,0,0,0,0
"Grey (Linda) Student Folklore Fieldwork Project",orflr_1974_143.xml,80444/xv68078,0,0,0,0
"Clark (Victoria) Student Folklore Fieldwork Project",orflr_1973_024.xml,80444/xv81106,0,0,0,0
"Rowley (Liza) Student Folklore Fieldwork Project",orflr_2006_020.xml,80444/xv71438,0,0,0,0
"Nurge (Steve) Student Folklore Fieldwork Project",orflr_1975_165.xml,80444/xv02548,0,0,0,0
"Black (Daisy) Student Folklore Fieldwork Project",orflr_1990_002.xml,80444/xv86279,0,0,0,0
"Gent (Jeff) Student Folklore Fieldwork Project",orflr_1991_027.xml,80444/xv12423,0,0,0,0
"Dennis (Anthony) Student Folklore Fieldwork Project",orflr_2012_042.xml,80444/xv50314,0,0,0,0
"Gielish (Scott L.) Student Folklore Fieldwork Project",orflr_1974_237.xml,80444/xv92172,0,0,0,0
"Brown (Madeleine) Student Folklore Fieldwork Project",orflr_1976_027.xml,80444/xv72781,0,0,0,0
"(Hendrickson) Elizabeth Student Folklore Fieldwork Project",orflr_2012_070.xml,80444/xv68667,0,0,0,0
"Delperdang (M.N.) Student Folklore Fieldwork Project",orflr_2002_090.xml,80444/xv17242,0,0,0,0
"Unruh (Travis) Student Folklore Fieldwork Project",orflr_2008_211.xml,80444/xv95977,0,0,0,0
"La Rogue (Vangie) Student Folklore Fieldwork Project",orflr_2012_099.xml,80444/xv49975,0,0,0,0
"Anonymous Student Folklore Fieldwork Project",orflr_1971_006.xml,80444/xv84384,0,0,0,0
"Wood (Nina) Student Folklore Fieldwork Project",orflr_1971_280.xml,80444/xv23214,0,0,0,0
"Harrison (Megan) Student Folklore Fieldwork Project",orflr_2008_134.xml,80444/xv50338,0,0,0,0
"Scofield (Twilo) Student Folklore Fieldwork Project",orflr_1989_056.xml,80444/xv02490,0,0,0,0
"Valenga (Marta E.) Student Folklore Fieldwork Project",orflr_1997_010.xml,80444/xv50543,0,0,0,0
"Elman (Pete) Student Folklore Fieldwork Project",orflr_1972_109.xml,80444/xv87826,0,0,0,0
"Braddock (George W.) Student Folklore Fieldwork Project",orflr_1976_133.xml,80444/xv91946,0,0,0,0
"Speer (Shaun) Student Folklore Fieldwork Project",orflr_1976_080.xml,80444/xv67031,0,0,0,0
"Johnson (Charlotte) Student Folklore Fieldwork Project",orflr_2008_130.xml,80444/xv76947,0,0,0,0
"Tomlinson (Jennifer Lyyn) Student Folklore Fieldwork Project",orflr_2002_075.xml,80444/xv77951,0,0,0,0
"DalMolin (Sierra M.) Student Folklore Fieldwork Project",orflr_2004_017.xml,80444/xv05020,0,0,0,0
"Nisley (Claudia) Student Folklore Fieldwork Project",orflr_1982_098.xml,80444/xv65817,0,0,0,0
"Ravitsky (Jessica) Student Folklore Fieldwork Project",orflr_1996_007.xml,80444/xv87277,0,0,0,0
"Student Folklore Fieldwork Project",orflr_1973_132.xml,80444/xv59375,0,0,0,0
"Holing (Dwight W.) Student Folklore Fieldwork Project",orflr_1975_132.xml,80444/xv25711,0,0,0,0
"Smith (Bridget) Student Folklore Fieldwork Project",orflr_1976_078.xml,80444/xv91598,0,0,0,0
"Griswold (D.) Student Folklore Fieldwork Project",orflr_1975_019.xml,80444/xv44628,0,0,0,0
"Hall (Marilyn) Student Folklore Fieldwork Project",orflr_1971_110.xml,80444/xv31948,0,0,0,0
"Thornton (Tracy) Student Folklore Fieldwork Project",orflr_1992_030.xml,80444/xv46047,0,0,0,0
"Keating (Kathleen) Student Folklore Fieldwork Project",orflr_1978_013.xml,80444/xv34805,0,0,0,0
"Ban (Patricia) Student Folklore Fieldwork Project",orflr_1971_158.xml,80444/xv53762,0,0,0,0
"Student Folklore Fieldwork Project",orflr_1975_153.xml,80444/xv42214,0,0,0,0
"Rez (Charles R.) Student Folklore Fieldwork Project",orflr_1976_073.xml,80444/xv70291,0,0,0,0
"Hanstein (Taileigh) Student Folklore Fieldwork Projct",orflr_2012_066.xml,80444/xv41082,0,0,0,0
"Nickerson (Pat) Student Folklore Fieldwork Project",orflr_1975_121.xml,80444/xv61892,0,0,0,0
"Kallinger (Kevin) Student Folklore Fieldwork Project",orflr_2012_086.xml,80444/xv38632,0,0,0,0
"Student Folklore Fieldwork Project",orflr_1973_272.xml,80444/xv92736,0,0,0,0
"Sweet (Melodee) Student Folklore Fieldwork Project",orflr_1976_108.xml,80444/xv11383,0,0,0,0
"Mahfouz (Linda) Student Folklore Fieldwork Project",orflr_1974_162.xml,80444/xv84420,0,0,0,0
"Johnson (Cynthia L.) Student Folklore Fieldwork Project",orflr_1974_309.xml,80444/xv12002,0,0,0,0
"Simonsen (Elizabeth J.) Student Folklore Fieldwork Project",orflr_2002_065.xml,80444/xv14517,0,0,0,0
"Burk (Kathleen Diane) Student Folklore Fieldwork Project",orflr_2003_024.xml,80444/xv69906,0,0,0,0
"Vollum (Dan) Student Folklore Fieldwork Project",orflr_1977_055.xml,80444/xv15567,0,0,0,0
"Lundquist (Kathy Jo) Student Folklore Fieldwork Project",orflr_1971_064.xml,80444/xv20404,0,0,0,0
"Maloni (Kelsee) Student Folklore Fieldwork Project",orflr_2008_084.xml,80444/xv93826,0,0,0,0
"Rasmussen (Patricia A.) Student Folklore Fieldwork Project",orflr_1977_141.xml,80444/xv04141,0,0,0,0
"Milne (Elizabeth) Student Folklore Fieldwork Project",orflr_1975_033.xml,80444/xv66098,0,0,0,0
"Church (Leigh) Student Folklore Fieldwork Project",orflr_1989_016.xml,80444/xv88735,0,0,0,0
"Arnold (Thomas "T.J.") Student Folklore Fieldwork Project",orflr_2012_012.xml,80444/xv53787,0,0,0,0
"Wilsgard (Janis) Student Folklore Fieldwork Project",orflr_1971_276.xml,80444/xv61538,0,0,0,0
"Long (Taylor) Student Folklore Fieldwork Project",orflr_2008_017.xml,80444/xv78808,0,0,0,0
"Reiter (Douglas) Student Folklore Fieldwork Project",orflr_1974_175.xml,80444/xv29992,0,0,0,0
"Silver (Allen) Student Folklore Fieldwork Project",orflr_1984_009.xml,80444/xv18548,0,0,0,0
"DeAngelo (Kevin Harrison) Student Folklore Fieldwork Project",orflr_2009_004.xml,80444/xv04095,0,0,0,0
"Cellars (Connie) Student Folklore Fieldwork Project",orflr_1975_006.xml,80444/xv58599,0,0,0,0
"Neet (Marjorie) Student Folklore Fieldwork Project",orflr_1972_070.xml,80444/xv49060,0,0,0,0
"Bocci (Marc) and Mears (John) Student Folklore Fieldwork Project",orflr_1974_006.xml,80444/xv17813,0,0,0,0
"Hasbrouck (Judith) Student Folklore Fieldwork Project",orflr_1977_077.xml,80444/xv66625,0,0,0,0
"Schultz (Paul E.) Student Folklore Fieldwork Project",orflr_1974_085.xml,80444/xv22137,0,0,0,0
"Cheney (Carol) Student Folklore Fieldwork Project",orflr_1989_038.xml,80444/xv69674,0,0,0,0
"Tursa (Rebecca) Student Folklore Fieldwork Project",orflr_2010_014.xml,80444/xv77267,0,0,0,0
"Polifroni (Francis) Student Folklore Fieldwork Project",orflr_1971_249.xml,80444/xv83050,0,0,0,0
"Andrews (Adam Christopher) Student Folklore Fieldwork Project",orflr_2004_021.xml,80444/xv49124,0,0,0,0
"Silverstein (Sam) Student Folklore Fieldwork Project",orflr_1990_020.xml,80444/xv56845,0,0,0,0
"Chambers (Roy W.) Student Folklore Fieldwork Project",orflr_1974_127.xml,80444/xv40087,0,0,0,0
"Potts (Charles M.) and Nelson (Robert) Student Folklore Fieldwork Project",orflr_1975_103.xml,80444/xv43896,0,0,0,0
"Smith (Kayla) Student Folklore Fieldwork Project",orflr_2010_096.xml,80444/xv01351,0,0,0,0
"Brunner (Bernie) Student Folklore Fieldwork Project",orflr_1975_159.xml,80444/xv71215,0,0,0,0
"Ventura (Susan) Student Folklore Fieldwork Project",orflr_1977_091.xml,80444/xv35897,0,0,0,0
"Webb (Jane) Student Folklore Fieldwork Project",orflr_1974_197.xml,80444/xv39007,0,0,0,0
"Hall-Clinton (Victoria) Student Folklore Fieldwork Project",orflr_2008_204.xml,80444/xv24185,0,0,0,0
"Fitzgerald (Scott) Student Folklore Fieldwork Project",orflr_1976_033.xml,80444/xv78631,0,0,0,0
"Student Folklore Fieldwork Project",orflr_1973_340.xml,80444/xv12802,0,0,0,0
"Olson (Pat) Student Folklore Fieldwork Project",orflr_1988_013.xml,80444/xv94732,0,0,0,0
"Haataja (Paula) Student Folklore Fieldwork Project",orflr_1976_143.xml,80444/xv15390,0,0,0,0
"Student Folklore Fieldwork Project",orflr_1973_259.xml,80444/xv07330,0,0,0,0
"Nearing (Judith M.) Student Folklore Fieldwork Project",orflr_1973_071.xml,80444/xv09619,0,0,0,0
"Stone (Carol) Student Folklore Fieldwork Project",orflr_1974_187.xml,80444/xv15112,0,0,0,0
"Drutz (Nora) Student Folklore Fieldwork Project",orflr_2008_167.xml,80444/xv65664,0,0,0,0
"Mertz (Dave) Student Folklore Fieldwork Project",orflr_1984_032.xml,80444/xv22052,0,0,0,0
"Kurth (Melody) Student Folklore Fieldwork Project",orflr_2012_095.xml,80444/xv01977,0,0,0,0
"McCormick (Linda) Student Folklore Fieldwork Project",orflr_1972_050.xml,80444/xv74237,0,0,0,0
"Dobler (Robert) Student Folklore Fieldwork Project",orflr_2010_110.xml,80444/xv62829,0,0,0,0
"Newman (Zecharaiah) Student Folklore Fieldwork Project",orflr_2002_088.xml,80444/xv50003,0,0,0,0
"Swingen (Amy) Student Folklore Fieldwork Project",orflr_1980_052.xml,80444/xv06674,0,0,0,0
"Fagan (Susan Joan Martin) Student Folklore Thesis",orflr_1982_079b.xml,80444/xv31051,0,0,0,0
"Green (Becky E.) Student Folklore Fieldwork Project",orflr_1976_141.xml,80444/xv13153,0,0,0,0
"Student Folklore Fieldwork Project",orflr_1973_134.xml,80444/xv78549,0,0,0,0
"Student Folklore Fieldwork Project",orflr_1973_201.xml,80444/xv21313,0,0,0,0
"Serra (Sharon M.) Student Folklore Fieldwork Project",orflr_1986_020.xml,80444/xv51068,0,0,0,0
"McCarl (Robert Smith) Folklore Thesis",orflr_1974_332.xml,80444/xv46203,0,0,0,0
"Student Folklore Fieldwork Project",orflr_1973_299.xml,80444/xv52166,0,0,0,0
"Brooks Student Folklore Fieldwork Project",orflr_1984_041.xml,80444/xv85330,0,0,0,0
"Student Folklore Fieldwork Project",orflr_1973_283.xml,80444/xv74478,0,0,0,0
"Martindale (Edward "Marty") Student Folklore Fieldwork Project",orflr_1976_056.xml,80444/xv07409,0,0,0,0
"Rice (Mary) Student Folklore Fieldwork Project",orflr_1976_074.xml,80444/xv24887,0,0,0,0
"Randolph (Bonnie) Student Folklore Fieldwork Project",orflr_2006_012.xml,80444/xv97531,0,0,0,0
"Kelly (Elena) Student Folklore Fieldwork Project",orflr_2008_067.xml,80444/xv29675,0,0,0,0
"Student Folklore Fieldwork Project",orflr_1973_247.xml,80444/xv17135,0,0,0,0
"Gunter (Dan) Student Folklore Fieldwork Project",orflr_1988_001a.xml,80444/xv00027,0,0,0,0
"Hoder (Melinda) Student Folklore Fieldwork Project",orflr_1988_021.xml,80444/xv59643,0,0,0,0
"Brickell (Adam) Student Folklore Fieldwork Project",orflr_1992_016.xml,80444/xv20993,0,0,0,0
"Van Hiel (Hayley) Student Folklore Fieldwork Project",orflr_2008_191.xml,80444/xv27584,0,0,0,0
"LaRocque (Elizabeth J.) Student Folklore Fieldwork Project",orflr_1975_097.xml,80444/xv91998,0,0,0,0
"Peterson (Jay) Student Folklore Fieldwork Project",orflr_1989_025.xml,80444/xv84161,0,0,0,0
"Faust (Mary S.) Student Folklore Fieldwork Project",orflr_1971_330.xml,80444/xv76345,0,0,0,0
"Student Folklore Fieldwork Project",orflr_1975_151.xml,80444/xv72674,0,0,0,0
"Vlcek (Barbara L.) Student Folklore Fieldwork Project",orflr_1974_195.xml,80444/xv40777,0,0,0,0
"Verbano (Stefan A.) Student Folklore Fieldwork Project",orflr_2008_181.xml,80444/xv40200,0,0,0,0
"Gieber (Lonnie) Student Folklore Fieldwork Project",orflr_1976_038.xml,80444/xv06353,0,0,0,0
"Lee (Dale) Student Folklore Fieldwork Project",orflr_1973_058.xml,80444/xv96746,0,0,0,0
"Gish (Juanita) Student Folklore Fieldwork Project",orflr_1980_050.xml,80444/xv02664,0,0,0,0
"Slocum (Terrence L. II) Student Folklore Fieldwork Project",orflr_2001_009.xml,80444/xv71331,0,0,0,0
"Dahl (Erik) Student Folklore Fieldwork Project",orflr_1992_005.xml,80444/xv71951,0,0,0,0
"Wingate (Greg) Student Folklore Fieldwork Project",orflr_1973_097.xml,80444/xv43753,0,0,0,0
"Wan (Jihong) Student Folklore Fieldwork Project",orflr_1999_003.xml,80444/xv63510,0,0,0,0
"Smith (Shauna) Student Folklore Fieldwork Project",orflr_2003_002.xml,80444/xv23199,0,0,0,0
"Allara (Mitch) Student Folklore Fieldwork Project",orflr_1971_157.xml,80444/xv78338,0,0,0,0
"Krone (Sharen) Student Folklore Fieldwork Project",orflr_1981_045.xml,80444/xv60922,0,0,0,0
"Connery (David B.) Student Folklore Fieldwork Project",orflr_1987_010.xml,80444/xv11215,0,0,0,0
"McKaughan (Nancy J.) Student Folklore Fieldwork Project",orflr_1981_029.xml,80444/xv88061,0,0,0,0
"Baker (James C.) Student Folklore Fieldwork Project",orflr_1970_038.xml,80444/xv78292,0,0,0,0
"Student Folklore Fieldwork Project",orflr_1973_112.xml,80444/xv11709,0,0,0,0
"Kosmatka (David) Student Folklore Fieldwork Project",orflr_2003_029.xml,80444/xv39328,0,0,0,0
"Van Zeipel (Janet M.) Student Folklore Fieldwork Project",orflr_1973_091.xml,80444/xv55041,0,0,0,0
"Kietzmann (Donna) Student Folklore Fieldwork Project",orflr_1984_016.xml,80444/xv92098,0,0,0,0
"Van Otterloo (Sarah) Student Folklore Fieldwork Project",orflr_2006_027.xml,80444/xv48532,0,0,0,0
"Strobel (Laura) Student Folklore Fieldwork Project",orflr_1994_006.xml,80444/xv56814,0,0,0,0
"Neilson (Ron) Student Folklore Fieldwork Project",orflr_1971_072.xml,80444/xv48153,0,0,0,0
"Hawk (Mallory) Student Folklore Fieldwork Project",orflr_2012_068.xml,80444/xv18203,0,0,0,0
"Clough (Alison A.) Student Folklore Fieldwork Project",orflr_1974_224.xml,80444/xv18975,0,0,0,0
"Greenleaf (Jennifer) Student Folklore Fieldwork Project",orflr_1974_239.xml,80444/xv74426,0,0,0,0
"Sullivan (Michael P.) Student Folklore Fieldwork Project",orflr_1976_127.xml,80444/xv48001,0,0,0,0
"Vanderford (Audrey L.) Student Folklore Fieldwork Project",orflr_2000_006.xml,80444/xv60137,0,0,0,0
"Dearborn (Susan) Student Folklore Fieldwork Project",orflr_1991_017.xml,80444/xv32937,0,0,0,0
"Jackson (Sue) Student Folklore Fieldwork Project",orflr_1974_009.xml,80444/xv46762,0,0,0,0
"Bertero (Kathleen) Student Folklore Fieldwork Project",orflr_1976_012.xml,80444/xv46163,0,0,0,0
"Lee (Regan) Student Folklore Fieldwork Project",orflr_1995_003.xml,80444/xv73440,0,0,0,0
"Culler (Shaun) Student Folklore Fieldwork Project",orflr_2008_128.xml,80444/xv42218,0,0,0,0
"Roberts (Karen S.) Student Folklore Fieldwork Project",orflr_1976_076.xml,80444/xv11782,0,0,0,0
"Student Folklore Fieldwork Project",orflr_1973_169.xml,80444/xv69949,0,0,0,0
"Baker (Andrea Jo) Student Folklore Fieldwork Project",orflr_1987_002.xml,80444/xv17144,0,0,0,0
"Z Student Folklore Fieldwork Project",orflr_2010_082.xml,80444/xv83639,0,0,0,0
"Gordon (Dale) Student Folklore Fieldwork Project",orflr_1974_238.xml,80444/xv02166,0,0,0,0
"Masoott (Cindi) Student Folklore Fieldwork Project",orflr_1976_150.xml,80444/xv71884,0,0,0,0
"Warner (Courtney) Student Folklore Fieldwork Project",orflr_2003_014.xml,80444/xv15219,0,0,0,0
"McKinney (Deanna) Student Folklore Fieldwork Project",orflr_1989_023.xml,80444/xv36309,0,0,0,0
"Sercombe (Gail) Student Folklore Fieldwork Project",orflr_1974_110.xml,80444/xv25927,0,0,0,0
"Reeves (Toni Anne) Student Folklore Fieldwork Project",orflr_1975_069.xml,80444/xv84310,0,0,0,0
"Laakso (Alice M.) Student Folklore Fieldwork Project",orflr_1972_190.xml,80444/xv17572,0,0,0,0
"Student Folklore Fieldwork Project",orflr_1973_204.xml,80444/xv20858,0,0,0,0
"Sakraida (Matthew) Student Folklore Fieldwork Project",orflr_1977_121.xml,80444/xv53573,0,0,0,0
"Thomas (Carrie) Student Folklore Fieldwork Project",orflr_1983_028.xml,80444/xv07174,0,0,0,0
"Naugle (Andrew) Student Folklore Fieldwork Project",orflr_2010_017.xml,80444/xv55603,0,0,0,0
"Thill (Phillip) Student Folklore Fieldwork Project",orflr_1976_110.xml,80444/xv31164,0,0,0,0
"Student Folklore Fieldwork Project",orflr_1973_287.xml,80444/xv03353,0,0,0,0
"Mallis (Jan) Student Folklore Fieldwork Project",orflr_1974_163.xml,80444/xv91458,0,0,0,0
"L'Abbe (Larry) Student Folklore Fieldwork Project",orflr_1974_257.xml,80444/xv91024,0,0,0,0
"McGuire (Scott) Student Folklore Fieldwork Project",orflr_2008_174.xml,80444/xv90447,0,0,0,0
"Brown (Mary Lynne) Student Folklore Fieldwork Project",orflr_1986_005.xml,80444/xv12112,0,0,0,0
"Mason (John) Student Folklore Fieldwork Project",orflr_1974_267.xml,80444/xv66259,0,0,0,0
"Student Folklore Fieldwork Project",orflr_1973_364.xml,80444/xv54489,0,0,0,0
"Cooke (Katherine) Student Folklore Fieldwork Project",orflr_2006_051.xml,80444/xv82232,0,0,0,0
"Jacobsen (Bob) Student Folklore Fieldwork Project",orflr_1977_078.xml,80444/xv51348,0,0,0,0
"Linn (Alan) Student Folklore Fieldwork Project",orflr_1972_160.xml,80444/xv85891,0,0,0,0
"De Os (Brian) Student Folklore Fieldwork Project",orflr_1977_101.xml,80444/xv77194,0,0,0,0
"Steeves (Alanna) Student Folklore Fieldwork Project",orflr_2008_009.xml,80444/xv22848,0,0,0,0
"Felser (Ellen) Student Folklore Fieldwork Project",orflr_1989_019.xml,80444/xv36492,0,0,0,0
"Huntsberger (Kristianne) Student Folklore Fieldwork Project",orflr_2006_042.xml,80444/xv82052,0,0,0,0
"Hjulstad (Staci) Student Folklore Fieldwork Project",orflr_1984_029.xml,80444/xv38217,0,0,0,0
"Evans (Alice) Student Folklore Fieldwork Project",orflr_2010_076.xml,80444/xv35446,0,0,0,0
"Rodriguez (Gabe) Student Folklore Fieldwork Project",orflr_2003_003.xml,80444/xv25918,0,0,0,0
"Wright (Jim) Student Folklore Fieldwork Project",orflr_1974_304.xml,80444/xv99996,0,0,0,0
"Anderson (Mary Jane) Student Folklore Fieldwork Project",orflr_1975_074.xml,80444/xv50347,0,0,0,0
"Phipps (Cyndi) Student Folklore Fieldwork Project",orflr_1977_011.xml,80444/xv60797,0,0,0,0
"Poissant (Brad) Student Folklore Fieldwork Project",orflr_1987_042.xml,80444/xv38027,0,0,0,0
"Bartels (Sandra) Student Folklore Fieldwork Project",orflr_1989_014.xml,80444/xv12521,0,0,0,0
"Mercer (Barbara) Student Folklore Fieldwork Project",orflr_1973_067.xml,80444/xv55914,0,0,0,0
"Fisk-May (Karen) Student Folklore Fieldwork Project",orflr_1985_019.xml,80444/xv58285,0,0,0,0
"Christensen (Fred) Student Folklore Fieldwork Project",orflr_1974_329.xml,80444/xv58139,0,0,0,0
"Owens (Marie L.) Student Folklore Fieldwork Project",orflr_1975_105.xml,80444/xv19415,0,0,0,0
"Lucas (Kyle) Student Folklore Fieldwork Project",orflr_2008_062.xml,80444/xv42648,0,0,0,0
"Student Folklore Fieldwork Project",orflr_1973_151.xml,80444/xv08419,0,0,0,0
"Student Folklore Fieldwork Project",orflr_1973_285.xml,80444/xv69183,0,0,0,0
"Baumann (John P.) Student Folklore Fieldwork Project",orflr_1998_005.xml,80444/xv60742,0,0,0,0
"Campbell (Jean) Student Folklore Fieldwork Project",orflr_1974_128.xml,80444/xv46832,0,0,0,0
"Student Folklore Fieldwork Project",orflr_1973_159.xml,80444/xv46759,0,0,0,0
"Bailey (Leonard J.) Student Folklore Fieldwork Project",orflr_1977_078b.xml,80444/xv45083,0,0,0,0
"Currans (Elizabeth Gail) Student Folklore Fieldwork Project",orflr_1999_001.xml,80444/xv19436,0,0,0,0
"Elerath (Susan) and Miller (Cindy) Student Folklore Fieldwork Project",orflr_1971_040.xml,80444/xv87097,0,0,0,0
"Markham (Michael) Student Folklore Fieldwork Project",orflr_1977_062.xml,80444/xv78192,0,0,0,0
"Hill (Craig A. J.) Student Folklore Fieldwork Project",orflr_1971_142.xml,80444/xv38598,0,0,0,0
"Piller (Donn) Student Folklore Fieldwork Project",orflr_1972_141.xml,80444/xv80676,0,0,0,0
"Paleologos (Tracey) Student Folklore Fieldwork Project",orflr_1974_277.xml,80444/xv52560,0,0,0,0
"Maggiulli (Katrina) Student Folklore Fieldwork Project",orflr_2008_137.xml,80444/xv42938,0,0,0,0
"Anonymous Student Folklore Fieldwork Project",orflr_0000_002.xml,80444/xv54690,0,0,0,0
"Radmaker (Nora) Student Folklore Fieldwork Project",orflr_1972_144.xml,80444/xv06143,0,0,0,0
"Lang (Ann) Student Folklore Fieldwork Project",orflr_1986_014.xml,80444/xv93832,0,0,0,0
"Kasnick (Jeanne) Student Folklore Fieldwork Project",orflr_1976_146.xml,80444/xv29180,0,0,0,0
"Student Folklore Fieldwork Project",orflr_1973_130.xml,80444/xv57940,0,0,0,0
"Dombrovski (George) Student Folklore Fieldwork Project",orflr_1974_019.xml,80444/xv91061,0,0,0,0
"Student Folklore Fieldwork Project",orflr_1973_181.xml,80444/xv83895,0,0,0,0
"McFall (Kyle) Student Folklore Fieldwork Project",orflr_2008_066.xml,80444/xv76086,0,0,0,0
"Ziebert (Madison) Student Folklore Fieldwork Project",orflr_2010_042.xml,80444/xv64334,0,0,0,0
"Jencson (Linda) Student Folklore Fieldwork Project",orflr_1983_019.xml,80444/xv74276,0,0,0,0
"Thomas (Maria) Student Folklore Fieldwork Project",orflr_1974_297.xml,80444/xv95190,0,0,0,0
"Janusiewicz (Theresa) Student Folklore Fieldwork Project",orflr_1973_053.xml,80444/xv21755,0,0,0,0
"Dulcich (Thomas V.) Student Folklore Fieldwork Project",orflr_1975_192.xml,80444/xv02569,0,0,0,0
"Cooper (Martine) Student Folklore Fieldwork Project",orflr_1984_013.xml,80444/xv79086,0,0,0,0
"Lee (Greg G.) Student Folklore Fieldwork Project",orflr_1975_028.xml,80444/xv13018,0,0,0,0
"Student Folklore Fieldwork Project",orflr_1973_279.xml,80444/xv78359,0,0,0,0
"Fischer (Gina) Student Folklore Fieldwork Project",orflr_2008_169.xml,80444/xv60079,0,0,0,0
"West (Linda) Student Folklore Fieldwork Project",orflr_1975_061.xml,80444/xv79064,0,0,0,0
"Gassel (Elizabeth) Student Folklore Fieldwork Project",orflr_1975_090.xml,80444/xv42535,0,0,0,0
"Whisenhant (Annette) Student Folklore Fieldwork Project",orflr_1980_045.xml,80444/xv39791,0,0,0,0
"Sydoriak (Christine) Student Folklore Fieldwork Project",orflr_1974_189.xml,80444/xv05667,0,0,0,0
"Lewman (Cheryl) Student Folklore Fieldwork Project",orflr_2004_018.xml,80444/xv86624,0,0,0,0
"Anonymous Student Folklore Fieldwork Project",orflr_2007_009.xml,80444/xv89379,0,0,0,0
"Student Folklore Fieldwork Project",orflr_1973_223.xml,80444/xv90841,0,0,0,0
"Student Folklore Fieldwork Project",orflr_1971_356.xml,80444/xv85806,0,0,0,0
"Thomas (Mary) Student Folklore Fieldwork Project",orflr_1991_005.xml,80444/xv86431,0,0,0,0
"Nicholas (Matthew) Student Folklore Fieldwork Project",orflr_2008_144.xml,80444/xv77346,0,0,0,0
"Roffnagle (Lynn) Student Folklore Fieldwork Project",orflr_1975_166.xml,80444/xv91003,0,0,0,0
"Swingen (Amy) Student Folklore Fieldwork Project",orflr_1979_042.xml,80444/xv40744,0,0,0,0
"Kosmatka (David) Student Folklore Fieldwork Project",orflr_2002_001.xml,80444/xv98638,0,0,0,0
"Tennis (Emily) Student Folklore Fieldwork Project",orflr_2006_005.xml,80444/xv42013,0,0,0,0
"Hackleman (Denise L.) Student Folklore Fieldwork Project",orflr_1974_314.xml,80444/xv66955,0,0,0,0
"Butterfield (Lori) Student Folklore Fieldwork Project",orflr_1981_013.xml,80444/xv22500,0,0,0,0
"Maggiulli (Nicole) Student Folklore Fieldwork Project",orflr_2002_006.xml,80444/xv13745,0,0,0,0
"Williams (Mark) Student Folklore Fieldwork Project",orflr_1982_120.xml,80444/xv70898,0,0,0,0
"Polioudakis (Virginia A.L.) Student Folklore Fieldwork Project",orflr_1976_106.xml,80444/xv84179,0,0,0,0
"Student Folklore Fieldwork Project",orflr_1972_014.xml,80444/xv92953,0,0,0,0
"Kaufman (Deborah) Student Folklore Fieldwork Project",orflr_1974_155.xml,80444/xv61068,0,0,0,0
"Tilton (Theresa) Student Folklore Fieldwork Project",orflr_1977_130.xml,80444/xv49429,0,0,0,0
"Nelson (Sarah R.) Student Folklore Fieldwork Project",orflr_1976_152.xml,80444/xv85369,0,0,0,0
"Wrancy (Jan) Student Folklore Fieldwork Project",orflr_1976_091.xml,80444/xv79904,0,0,0,0
"Dean (Kathryn) Student Folklore Fieldwork Project",orflr_1972_028.xml,80444/xv31103,0,0,0,0
"Stark (Lily) Student Folklore Fieldwork Project",orflr_2010_054.xml,80444/xv48251,0,0,0,0
"Rodley (Tricia) Student Folklore Fieldwork Project",orflr_1990_018.xml,80444/xv28182,0,0,0,0
"O'Connell (Joseph Martin) Folklore Thesis",orflr_2010_125.xml,80444/xv70275,0,0,0,0
"Anonymous Student Folklore Fieldwork Project",orflr_2002_036.xml,80444/xv80795,0,0,0,0
"Thomas (Austin) Student Folklore Fieldwork Project",orflr_2008_179.xml,80444/xv07659,0,0,0,0
"Hughes (Marcia G.) Student Folklore Fieldwork Project",orflr_2008_046.xml,80444/xv54983,0,0,0,0
"Jernigan (Alyssa) Student Folklore Fieldwork Project",orflr_2008_172.xml,80444/xv15972,0,0,0,0
"Rose-Phillips (Eric S.) Student Folklore Fieldwork Project",orflr_2002_039.xml,80444/xv78842,0,0,0,0
"Sims (Scott H.) Student Folklore Fieldwork Project",orflr_1975_110.xml,80444/xv92474,0,0,0,0
"Carpenter (Pamela Rose) Student Folklore Fieldwork Project",orflr_1975_063.xml,80444/xv14819,0,0,0,0
"Martinson (Stevi) Student Folklore Fieldwork Project",orflr_2008_185.xml,80444/xv08114,0,0,0,0
"Goebel (Kristy) and Earl (Morton) Student Folklore Fieldwork Project",orflr_1974_062.xml,80444/xv52578,0,0,0,0
"Student Folklore Fieldwork Project",orflr_1973_137.xml,80444/xv25265,0,0,0,0
"Amato (Katya) Student Folklore Fieldwork Project",orflr_1974_212.xml,80444/xv84405,0,0,0,0
"Batchelder (Sarah) Student Folklore Fieldwork Project",orflr_1997_011.xml,80444/xv52093,0,0,0,0
"Higcins (Jay) Student Folklore Fieldwork Project",orflr_1975_177.xml,80444/xv17211,0,0,0,0
"Walking Bull (Gilbert C.) Student Folklore Fieldwork Project",orflr_1976_161.xml,80444/xv33093,0,0,0,0
,,Totals,2467,1198,1776,5441
