Title,Document Name,Ark Identifier,July,August,September,Total
"White (Anne Terry) Papers",oru_ax468.xml,80444/xv97488,418,136,51,605
"McGraw (Eloise and William) Papers",oru_ax243.xml,80444/xv20868,40,282,192,514
"Sundeleaf (Richard) papers and architectural records",oru_coll196.xml,80444/xv47212,156,98,155,409
"Oregon Folklife Program Records",oru_coll378.xml,80444/xv68731,85,197,96,378
"Woodman (Ruth Cornwall) Papers",oru_ax690.xml,80444/xv04796,104,145,103,352
"Hoedads Cooperative Inc. records",oru_coll322.xml,80444/xv54919,28,273,51,352
"Jackson County, Oregon Records",oru_bx067.xml,80444/xv16766,56,175,96,327
"University Archives photographs",oru_uaref3.xml,80444/xv36846,39,226,38,303
"Archibald (Joseph) papers",oru_a215.xml,80444/xv88927,23,255,20,298
"Morse (Wayne L.) papers",oru_coll001.xml,80444/xv42426,63,128,106,297
"Williams (Jean) papers",oru_ax387.xml,80444/xv92852,96,93,106,295
"Bowerman (Bill) Papers",oru_ua003.xml,80444/xv98511,77,75,132,284
"Office of the President: Prince Lucien Campbell records",oru_ua001_004.xml,80444/xv51675,27,26,190,243
"Del Valle (Pedro) papers",oru_coll126.xml,80444/xv35240,46,99,97,242
"Duniway (Abigail Scott) Papers",oru_coll232b.xml,80444/xv63619,47,65,129,241
"Chambreau (Edward) Collection",oru_coll056.xml,80444/xv73195,77,88,75,240
"Rey (H.A.) Papers",oru_ax828.xml,80444/xv65672,62,76,89,227
"Corinne (Tee A.) Papers",oru_coll263.xml,80444/xv98508,61,65,93,219
"Cox (William R.) papers",oru_coll032.xml,80444/xv74564,43,49,127,219
"Cayuse, Yakima, and Rogue River Wars Papers",oru_bx047.xml,80444/xv85849,39,62,114,215
"Fox (Gardner) literary manuscripts, comic books and other material",oru_coll008.xml,80444/xv29623,40,75,75,190
"Gearhart (Sally Miller) Papers",oru_coll305.xml,80444/xv81757,33,66,90,189
"Southwest Oregon Research Project (SWORP) Collection",oru_coll268.xml,80444/xv14723,58,64,65,187
"Lord & Schryver architectural records",oru_coll098.xml,80444/xv36943,42,44,94,180
"Russ (Joanna) Papers",oru_coll261.xml,80444/xv52000,30,46,102,178
"Amoss (Ulius L.) papers",oru_coll005.xml,80444/xv35579,40,26,105,171
"Behn (Harry) Papers",oru_ax420.xml,80444/xv12322,54,53,59,166
"Bowman (Walter S.) photographs",oru_ph004.xml,80444/xv78677,42,44,79,165
"Megler (A. J. and Joseph G.) legal document",oru_ca1868jul20.xml,80444/xv90698,50,60,53,163
"Disque (Brice P.) papers",oru_coll115.xml,80444/xv69776,16,78,65,159
"Whiteley (Opal) Papers",oru_ax097.xml,80444/xv66355,47,40,66,153
"Worthington (Marjorie) papers",oru_coll152.xml,80444/xv04122,39,22,90,151
"Applegate (Oliver Cromwell) papers",oru_ax005.xml,80444/xv77642,47,36,64,147
"Woodard (William P.) papers",oru_coll153.xml,80444/xv82095,54,22,70,146
"Price (Margaret Evans) Papers",oru_ax735.xml,80444/xv25666,51,71,23,145
"Jane C. Grant papers",oru_coll041.xml,80444/xv91334,51,42,51,144
"Uchida (Yoshiko) Papers",oru_ax549.xml,80444/xv44125,40,41,62,143
"Moorhouse (Lee) photographs",oru_ph036.xml,80444/xv94299,38,50,53,141
"Ku Klux Klan Tillamook, Oregon Chapter No. 8 Records",oru_bx046.xml,80444/xv53018,38,55,48,141
"Davenport Family papers",oru_ax242.xml,80444/xv88243,51,42,48,141
"Seredy (Kate) Papers",oru_ax517.xml,80444/xv37289,33,33,74,140
"Fisher (Leonard Everett) Papers",oru_ax538.xml,80444/xv11292,36,44,60,140
"Kyne (Peter Bernard) Papers",oru_ax732.xml,80444/xv03086,46,44,48,138
"Cantwell (Robert) Papers",oru_coll020.xml,80444/xv41731,38,41,59,138
"Cosgrave (John O'Hara) Papers",oru_ax718.xml,80444/xv72176,44,63,30,137
"Breese (Edward Y.) papers",oru_coll136.xml,80444/xv25671,23,42,71,136
"Chase (Mary) Papers",oru_ax542.xml,80444/xv53706,40,58,37,135
"Circuit Riders, Inc. records",oru_bx167.xml,80444/xv69783,61,45,28,134
"Stevenson (Janet Marshall) Papers",oru_ax265.xml,80444/xv86534,46,47,40,133
"Therkelsen (Cachot) collection",oru_coll094.xml,80444/xv14378,36,46,50,132
"Ayer (Margaret) Papers",oru_ax506.xml,80444/xv31819,24,21,86,131
"Ainsworth (John C.) papers",oru_coll250.xml,80444/xv61910,41,37,53,131
"Haycox (Ernest) papers",oru_coll164.xml,80444/xv68407,24,47,59,130
"Feminist and Lesbian Periodical Collection",oru_coll257.xml,80444/xv94741,42,35,50,127
"Lawrence (Ellis Fuller) papers",oru_ax056.xml,80444/xv35243,33,31,62,126
"United States of America vs. Ernst Von Weizs√§cker, et al. Records",oru_bx083.xml,80444/xv47381,18,45,61,124
"Warner (Gertrude Bass) papers",oru_ax701.xml,80444/xv26937,85,24,14,123
"Palmer (Joel) papers",oru_ax057.xml,80444/xv32992,33,46,44,123
"Furlong (Charles Wellington) papers",oru_ax698.xml,80444/xv23562,28,40,55,123
"Rumely (Edward A.) papers",oru_coll122.xml,80444/xv26002,24,47,52,123
"School of Architecture and Allied Arts (AAA) Student Drawings Collection",oru_aaa001.xml,80444/xv39794,41,44,37,122
"Forman (Harrison) Papers",oru_coll024.xml,80444/xv36544,40,23,58,121
"Andrews (Clarence Leroy) Papers",oru_coll067.xml,80444/xv38653,38,38,43,119
"Adair Family Reminiscences",oru_cbad11.xml,80444/xv77983,45,48,26,119
"Kimbark (Edward Wilson) papers",oru_coll092.xml,80444/xv04111,18,31,70,119
"Lynch (Peg) papers",oru_coll066.xml,80444/xv37635,33,25,61,119
"Smith (William C.) Papers",oru_ax311.xml,80444/xv19159,30,45,44,119
"Smythe (Richard Haviland) Papers",oru_coll134.xml,80444/xv85171,30,29,59,118
"Stern (Bernhard J.) papers",oru_coll026.xml,80444/xv62136,29,36,53,118
"Storrs (John) Architectural Drawings",oru_coll108.xml,80444/xv60892,23,44,50,117
"United States Work Projects Administration Oregon Federal Art Project Collection",oru_coll238.xml,80444/xv96452,24,42,51,117
"Neuberger (Richard) papers",oru_ax078.xml,80444/xv35233,40,38,38,116
"Root (E. Merrill) Papers",oru_coll051.xml,80444/xv99873,28,28,60,116
"Widowed Services Program/Displaced Homemaker Center and Widowed Services Program Records",oru_ua006.xml,80444/xv82099,26,35,53,114
"Olsen (Jack) Papers",oru_ax322.xml,80444/xv17792,34,44,34,112
"Merritt (Melvin Leroy) papers",oru_ax066.xml,80444/xv36942,6,68,38,112
"Glidden (Frederick D.) Papers",oru_coll148.xml,80444/xv02401,11,26,74,111
"Newton (Dwight Bennett) Papers",oru_coll192.xml,80444/xv19854,23,48,39,110
"Miller (Casey) and Swift (Kate) papers",oru_coll291.xml,80444/xv80889,21,29,58,108
"Parton (Margaret) papers",oru_coll036.xml,80444/xv75255,41,49,18,108
"Butterworth (Wally) papers",oru_coll129.xml,80444/xv60544,34,34,40,108
"Flynn (John T.) Papers",oru_coll116.xml,80444/xv00698,25,28,54,107
"Pinkerton (Robert E. and Kathrene) Papers",oru_ax591.xml,80444/xv36267,46,34,25,105
"LeFevre (Robert) papers",oru_coll202.xml,80444/xv29769,24,32,49,105
"Stevens (Hazard) papers",oru_ax042.xml,80444/xv40020,18,17,69,104
"Sawyer (Robert W.) papers",oru_ax100.xml,80444/xv99188,17,33,54,104
"Baynes (Pauline) papers",oru_a308.xml,80444/xv48573,13,18,72,103
"Mason (Arthur and Mary Frank) Papers",oru_ax402.xml,80444/xv33535,42,39,22,103
"Lane (Joseph) papers",oru_ax183.xml,80444/xv58488,33,24,45,102
"Unwin (Nora S.) Papers",oru_ax358.xml,80444/xv01724,33,44,25,102
"McKay (Douglas) papers",oru_ax063.xml,80444/xv03770,32,43,26,101
"George Lawrence Company records",oru_bx200.xml,80444/xv46273,33,37,30,100
"Stimely (Keith) Collection",oru_coll183.xml,80444/xv98853,25,17,58,100
"Hogan (Inez) Papers",oru_coll044.xml,80444/xv65332,25,36,39,100
"Wiener (Paul Lester) papers",oru_bx155.xml,80444/xv66707,43,36,20,99
"Stamper (Harry S.) Jr. Papers",oru_coll361.xml,80444/xv24615,13,66,20,99
"University of Oregon Archives negatives",oru_ua149.xml,80444/xv46093,23,42,33,98
"Leighton (Margaret Carver) Papers",oru_ax285.xml,80444/xv79698,29,28,41,98
"First National Bank of Oregon (Portland) early history",oru_a242.xml,80444/xv94320,21,39,38,98
"PCUN records",oru_coll335.xml,80444/xv06887,36,30,30,96
"Rajneesh Artifacts and Ephemera Collection",oru_coll275.xml,80444/xv60199,24,19,53,96
"Ernst (Alice Henson) papers",oru_coll039.xml,80444/xv59872,23,37,35,95
"Gordon (Robert W.) Collection",oru_ax039.xml,80444/xv07188,18,27,50,95
"Smith (Wallace) papers",oru_ax269.xml,80444/xv33294,26,30,38,94
"Rochester (Anna) Papers",oru_ax624.xml,80444/xv75247,17,18,59,94
"Moore (Rosalie) Papers",oru_coll215.xml,80444/xv32155,22,22,49,93
"Ivory (James) papers",oru_coll283.xml,80444/xv67388,40,24,27,91
"Heller (Hans) papers",oru_ax398.xml,80444/xv30465,28,32,31,91
"Berger (Josef) papers",oru_coll058.xml,80444/xv62253,20,21,50,91
"Meltzer (Milton) Papers",oru_ax533.xml,80444/xv80041,21,14,56,91
"Graves (Morris) papers",oru_coll326.xml,80444/xv90567,31,39,20,90
"University Archives sports information and media guides",oru_uaref5.xml,80444/xv18228,35,30,25,90
"Glaser (William and Lillian) Papers",oru_ax874.xml,80444/xv33872,37,30,22,89
"Appel (Benjamin) Papers",oru_ax491.xml,80444/xv40368,14,21,54,89
"Tee-Van (Helen Damrosch) Papers",oru_ax715.xml,80444/xv66364,20,29,39,88
"Mountaingrove (Ruth) Papers",oru_coll309.xml,80444/xv51562,23,23,41,87
"Woolley (Catherine) Papers",oru_ax642.xml,80444/xv36952,17,42,27,86
"Price (Christine) Papers",oru_ax448.xml,80444/xv72860,29,39,18,86
"Wiese (Kurt) Papers",oru_ax445.xml,80444/xv40030,28,31,27,86
"Hutchins (Grace) Papers",oru_ax625.xml,80444/xv07874,19,44,22,85
"Crook (George) papers",oru_a024.xml,80444/xv29760,30,26,29,85
"Skinner (James E. and Susan L.) Papers",oru_ax209.xml,80444/xv03096,27,34,23,84
"Daly (Maureen) Papers",oru_ax753.xml,80444/xv86541,21,32,31,84
"Pierce (Walter M.) papers",oru_coll068.xml,80444/xv92701,43,15,25,83
"Leach (Lilla Irvin) Papers",oru_ax756.xml,80444/xv23046,13,12,58,83
"Grey (Zane) Papers",oru_ax462.xml,80444/xv12662,18,28,37,83
"Keally (Francis) Papers",oru_ax381.xml,80444/xv32162,21,28,33,82
"Atwater (Montgomery Meigs) Papers",oru_ax630.xml,80444/xv73878,6,41,34,81
"Alexander (Charles) papers",oru_ax006.xml,80444/xv10267,20,31,30,81
"Collins (Mary) papers",oru_ax201.xml,80444/xv83016,21,50,10,81
"Underhill (Ruth Murray) Papers",oru_ax570.xml,80444/xv42416,32,27,21,80
"W.P.A. Oregon Historical Records Survey Records",oru_bx066.xml,80444/xv84139,29,22,29,80
"Lopp (William Thomas) papers",oru_ax058.xml,80444/xv38312,9,34,37,80
"Hyman (Trina Schart) Papers",oru_coll065.xml,80444/xv14725,15,28,37,80
"Slobodkin (Louis) Papers Addendum",oru_coll178.xml,80444/xv41401,1,59,20,80
"Ingebretsen (James C.) Papers",oru_coll147.xml,80444/xv95777,36,13,30,79
"Stafford (Kim Robert) Collection",oru_coll206.xml,80444/xv99529,26,22,31,79
"Pitz (Henry C.) Papers",oru_ax392.xml,80444/xv81744,31,26,21,78
"Burton (Virginia) Papers",oru_ax839.xml,80444/xv98850,20,33,24,77
"Kennell (Ruth Epperson) Papers",oru_ax872.xml,80444/xv41053,27,30,19,76
"Klamath Tribal Council Records",oru_bx051.xml,80444/xv18475,21,22,33,76
"Weddell (Suzanne E.) papers",oru_coll047.xml,80444/xv60894,9,42,25,76
"Carr (Mary Jane) Papers",oru_ax121.xml,80444/xv34558,31,33,12,76
"Dowell (Benjamin Franklin) papers",oru_ax031.xml,80444/xv41730,23,14,39,76
"Wilson (Eleanor) Papers",oru_ax611.xml,80444/xv71831,28,31,16,75
"Cooper (Arvazena A.) Papers",oru_cbc784.xml,80444/xv52684,12,15,48,75
"Hart (Merwin K.) Papers",oru_coll121.xml,80444/xv74575,16,22,36,74
"Brookman (Herman) architecture files",oru_ax330.xml,80444/xv84833,9,25,40,74
"Ashmore Family papers",oru_ax564.xml,80444/xv09583,19,24,31,74
"Rosenberg (Louis Conrad) Collection",oru_ax509.xml,80444/xv01726,13,22,38,73
"Ballard (W. Todhunter) papers",oru_coll049.xml,80444/xv69785,18,10,45,73
"Wilson (Edward Arthur) papers",oru_ax775.xml,80444/xv19622,25,39,8,72
"Zerzan (John) Papers",oru_coll273.xml,80444/xv81752,23,20,29,72
"Marsden (Edward) papers",oru_ax069.xml,80444/xv69775,26,12,34,72
"Hudson's Bay Company Collection",oru_f978h869.xml,80444/xv58833,13,20,38,71
"Clark (Robert D.) Papers",oru_coll285.xml,80444/xv74577,22,18,31,71
"Henry Davidson Sheldon Papers",oru_coll155.xml,80444/xv81416,8,15,48,71
"Yaquina Deep Sea Fishing Company stock certificate",oru_ca1889sept7.xml,80444/xv70843,0,48,22,70
"Parker (Horatio Hyde) papers",oru_ax076.xml,80444/xv02400,24,29,17,70
"Bogart (Mayo Methot) memorabilia",oru_cab633.xml,80444/xv70385,7,34,29,70
"Wyndham (Lee and Robert) Papers",oru_ax472.xml,80444/xv08913,16,37,17,70
"PogaÃÅny (Willy A.) Papers",oru_coll199.xml,80444/xv14381,11,16,42,69
"Elgin (Suzette Haden) Papers",oru_coll307.xml,80444/xv57659,24,24,21,69
"Ross (Marion Dean) Papers",oru_coll231.xml,80444/xv30446,23,29,17,69
"Ward (Lynd) Papers",oru_ax724.xml,80444/xv70459,20,23,26,69
"Burgess Family papers",oru_coll209.xml,80444/xv39941,25,23,21,69
"Detweiler (Charles) Papers",oru_ax333.xml,80444/xv83455,2,3,63,68
"Wilson (Hazel Hutchins) Papers",oru_ax377.xml,80444/xv33531,27,19,22,68
"Lurton Blassingame Literary Agency Records",oru_ax043.xml,80444/xv82437,17,22,29,68
"Hobart (Alice Tisdale) Papers",oru_ax197.xml,80444/xv89611,12,15,40,67
"Morey (Walter Nelson) papers",oru_coll230.xml,80444/xv97819,13,20,34,67
"University Archives alphabetical subject files",oru_uaref1.xml,80444/xv99267,24,20,23,67
"University Archives biographical files",oru_uaref2.xml,80444/xv70349,31,22,13,66
"Summers (James) Papers",oru_ax495.xml,80444/xv44814,13,36,17,66
"O'Dell (Scott) Papers",oru_ax809.xml,80444/xv48581,5,6,55,66
"Archer (Jules) Papers",oru_ax314.xml,80444/xv77986,28,3,35,66
"Warner (Gertrude Bass) papers",oru_ua022.xml,80444/xv70507,12,26,28,66
"Moore (Lilian) Papers",oru_ax434.xml,80444/xv64655,18,22,25,65
"SO CLAP! (Southern Oregon Country Lesbian Archival Project) Collection",oru_coll266.xml,80444/xv68074,17,21,27,65
"Stone (Willis E.) Papers",oru_coll118.xml,80444/xv22930,24,22,19,65
"Waldo (John B.) Papers",oru_coll303.xml,80444/xv49267,17,21,27,65
"Cole (Hallet E.) Collection on Zeppelins and Ligther-Than-Air Craft",oru_coll339.xml,80444/xv61577,21,30,14,65
"Porter (Charles Orlando) papers",oru_ax088.xml,80444/xv68064,22,17,26,65
"Bentley (Percy Dwight) papers",oru_coll145.xml,80444/xv22923,22,22,20,64
"Cressman (Luther) Papers",oru_ua005.xml,80444/xv17458,13,16,35,64
"Clements (Calvin) Papers",oru_ax493.xml,80444/xv83807,7,8,49,64
"Burnet (Dana) Papers",oru_coll141.xml,80444/xv10964,17,16,31,64
"Steiner (George) Papers",oru_ax537.xml,80444/xv05485,13,30,21,64
"Applegate (Lindsay) papers",oru_ax004.xml,80444/xv44808,24,20,19,63
"Duvoisin (Roger) and Fatio (Louise) Papers",oru_ax596.xml,80444/xv59179,10,18,35,63
"Zim (Herbert Spencer and Sonia Bleeker) Papers",oru_ax558.xml,80444/xv50293,23,6,34,63
"Emery (Anne) Papers",oru_coll185.xml,80444/xv81755,20,31,12,63
"Tunis (Edwin) Papers",oru_ax776.xml,80444/xv26010,12,18,33,63
"Alaska Mining and Prospecting Company Records",oru_bx001.xml,80444/xv87560,25,21,17,63
"Sutton, Whitney and Aandahl Architectural records",oru_bx172.xml,80444/xv94063,13,13,36,62
"Teal (Joseph Nathan) papers",oru_ax171.xml,80444/xv20394,11,20,31,62
"Rutland (Eva) Papers",oru_coll063.xml,80444/xv78335,14,15,33,62
"Roberts (Archibald) collection",oru_ax824.xml,80444/xv21878,6,15,41,62
"Gates (Doris) papers",oru_coll180.xml,80444/xv32161,14,17,31,62
"Warner Creek Fire Collection",oru_coll287.xml,80444/xv93031,20,21,21,62
"Lyle Jr. (Eugene P.) papers",oru_coll010.xml,80444/xv46490,8,20,33,61
"Davies (Mary Carolyn) papers",oru_ax407.xml,80444/xv01000,24,19,18,61
"Crain (Lucille Cardin) papers",oru_coll095.xml,80444/xv68414,18,15,28,61
"Nichols (Ernest F. Loring "Red") papers",oru_ax539.xml,80444/xv66931,15,14,32,61
"Mills (Randall V.) Papers",oru_coll088.xml,80444/xv71485,18,3,40,61
"Hogan (Ray) papers",oru_ax838.xml,80444/xv51568,17,11,33,61
"Oregon Stage Coach Company records",oru_bx050.xml,80444/xv19375,19,24,18,61
"Flebbe (Beulah) papers",oru_ax502.xml,80444/xv78460,27,22,11,60
"Ruhtenberg (Polly King) Papers",oru_coll081.xml,80444/xv58495,6,11,43,60
"Barnett (Homer) Papers",oru_ua002.xml,80444/xv99538,16,15,29,60
"Jones (Elizabeth Orton) Oral Memoirs",oru_coll319.xml,80444/xv16223,11,26,23,60
"Dost (Jeanne) papers",oru_coll366.xml,80444/xv94845,8,8,44,60
"Ware (Harlan) papers",oru_ax565.xml,80444/xv01165,13,33,14,60
"Montgomery (Mary Phelps) letter Walter F. Burrell",oru_ca1905jan18.xml,80444/xv00668,16,32,12,60
"Holden (Ashley E.) papers",oru_coll138.xml,80444/xv91666,27,17,15,59
"Pratt (John C.) Collection of Warren Heywood Williams Architectural Drawings",oru_coll150.xml,80444/xv28058,10,13,36,59
"Pettengill (Samuel B.) papers",oru_coll015.xml,80444/xv01044,28,17,14,59
"Hawkins (John and Ward) papers",oru_coll071.xml,80444/xv06860,26,13,20,59
"Haenigsen (Harry) Papers",oru_ax778.xml,80444/xv43110,10,12,37,59
"Burton/Lake/Garton family papers",oru_coll301.xml,80444/xv63629,15,25,19,59
"Benary-Isbert (Margot) Papers",oru_ax394.xml,80444/xv45156,13,7,38,58
"Wilson (O. Meredith) Papers",oru_ua010.xml,80444/xv80390,11,14,33,58
"Wheeler (Laura Maude) Papers",oru_ax372.xml,80444/xv14031,26,18,13,57
"Jones (Harold) Papers",oru_ax610.xml,80444/xv08220,19,25,13,57
"Foster (Genevieve) Papers",oru_ax840.xml,80444/xv98503,11,15,30,56
"Selsam (Millicent Ellis) papers",oru_ax457.xml,80444/xv57130,11,5,40,56
"Henderson (Le Grand) papers",oru_coll021.xml,80444/xv69787,8,4,44,56
"Lockley (Fred) papers",oru_cbl812.xml,80444/xv67922,18,14,24,56
"Ryles (Nancy)",oru_coll364.xml,80444/xv58880,10,6,40,56
"May (Charles Paul) Papers",oru_ax489.xml,80444/xv05142,20,22,14,56
"Lagemann (John K.) papers",oru_ax660.xml,80444/xv89892,9,33,13,55
"Overhulse (Boyd R.) papers",oru_ax515.xml,80444/xv67266,5,6,43,54
"Adams (Frank R.) Papers",oru_ax527.xml,80444/xv46871,10,17,27,54
"Whitehouse (Harold C.) papers",oru_ax373.xml,80444/xv38319,9,20,25,54
"Sterling (Dorothy) Papers",oru_ax852.xml,80444/xv88597,14,11,29,54
"Montgomery (Rutherford) Papers",oru_ax352.xml,80444/xv58845,12,9,33,54
"Pruett (James Hugh) papers",oru_ax091.xml,80444/xv91574,22,15,17,54
"Chadwick (Joseph) correspondence",oru_a200.xml,80444/xv70285,19,7,28,54
"Beeson (Welborn) Papers",oru_ax799.xml,80444/xv34548,16,25,12,53
"Beatty (Hetty Burlingame) Papers",oru_ax452.xml,80444/xv42076,6,11,36,53
"Werth (Kurt) Papers",oru_coll100.xml,80444/xv63283,10,11,31,52
"Lenniger Literary Agency records",oru_ax073.xml,80444/xv19852,28,16,8,52
"University High School records",oru_ua085.xml,80444/xv15664,13,21,18,52
"Dunn (Frederick Stanley) scrapbooks",oru_coll246.xml,80444/xv11032,15,9,28,52
"Knight (Granville F.) Papers",oru_coll082.xml,80444/xv42427,8,18,25,51
"Crosby (Alexander L.) papers",oru_coll013.xml,80444/xv24979,16,17,18,51
"Petersham (Maud and Miska) Illustrations",oru_ax534.xml,80444/xv54056,16,20,15,51
"Whitcup (Leonard) Sheet Music Collection",oru_coll074.xml,80444/xv79537,24,12,15,51
"Applegate (Jesse A.) letter",oru_sfm014.xml,80444/xv56518,18,15,18,51
"Price (Edith Ballinger) Papers",oru_coll214.xml,80444/xv52677,6,19,26,51
"Williams (Chester S.) papers",oru_coll018.xml,80444/xv67041,9,11,31,51
"Ross (Marion Dean) Chapter of the Society of Architectural Historians",oru_coll316.xml,80444/xv21865,21,11,18,50
"Office of the President: Harry K. Newburn and Orlando John Hollis (interim) records",oru_ua001_008.xml,80444/xv18054,10,14,26,50
"Lytle (Robert Day) Papers",oru_ax788.xml,80444/xv69090,11,27,12,50
"Green (Paul) screenplays and scripts",oru_ax429.xml,80444/xv77653,7,14,29,50
"Fuller (Ethel Romig) papers",oru_ax650.xml,80444/xv57543,17,5,27,49
"Camp Waldport Records",oru_bx034.xml,80444/xv20185,8,24,17,49
"Werner (Vivian Lescher) Papers",oru_ax641.xml,80444/xv10276,19,16,14,49
"Bulla (Clyde Robert) papers",oru_a297.xml,80444/xv82774,11,13,25,49
"Reck (Franklin M.) Papers",oru_ax692.xml,80444/xv01722,11,12,25,48
"Holling (Holling Clancy) Papers",oru_ax304.xml,80444/xv45499,16,8,24,48
"Holberg (Ruth Langland) papers",oru_coll179.xml,80444/xv45502,18,16,14,48
"Lee (Manning) Papers",oru_ax530.xml,80444/xv06510,16,26,6,48
"National Association for the Advancement of Colored People (NAACP), Portland Records",oru_coll295.xml,80444/xv24502,22,7,19,48
"Moorhouse (Lee) letters received",oru_a082.xml,80444/xv16241,22,13,12,47
"Levinger (Lee Joseph) Papers",oru_ax310.xml,80444/xv11983,15,18,14,47
"Newberry (Clare Turlay) Papers",oru_ax681.xml,80444/xv41400,15,23,9,47
"No√´l (Auguste Louis) Architectural Plans",oru_ax619.xml,80444/xv64311,14,21,12,47
"DeYoung and Roald Architectural Plans and Photographs",oru_bx131.xml,80444/xv17804,8,9,30,47
"Welch (William Moses) Papers",oru_ax173.xml,80444/xv00017,20,18,9,47
"Hader (Berta and Elmer) Papers",oru_ax441.xml,80444/xv50977,15,15,16,46
"Warren (Charles Marquis) Papers",oru_ax714.xml,80444/xv56789,26,9,11,46
"Anthony (Edward) papers",oru_ax653.xml,80444/xv15298,2,1,43,46
"Wilson (Donald) papers",oru_ax628.xml,80444/xv20996,15,22,9,46
"Buckley (Frederic Robert) papers",oru_ax319.xml,80444/xv94308,11,24,11,46
"Nesmith (James Willis) legal document",oru_ca1865aug7.xml,80444/xv51577,8,22,15,45
"Ellsworth (Mathew "Harris") Papers",oru_ax033.xml,80444/xv74563,4,9,32,45
"Beekman Family papers",oru_ax010.xml,80444/xv88079,9,8,28,45
"Jefferson Center for Education and Research records",oru_coll317.xml,80444/xv84390,12,21,12,45
"Isaac (Leo Anthony) papers",oru_ax730.xml,80444/xv23461,17,11,17,45
"Mountaingrove (Ruth) Videotape Autobiography Collection",oru_coll265.xml,80444/xv27369,10,21,14,45
"Lyons (Eugene) Papers",oru_coll117.xml,80444/xv30454,12,10,22,44
"Floethe (Louise Lee and Richard) Papers",oru_ax447.xml,80444/xv13351,16,19,8,43
"Cornucopia Mines records",oru_bx005.xml,80444/xv84936,15,14,14,43
"Burger (Carl) Papers",oru_ax577.xml,80444/xv37637,8,7,28,43
"Stratemeyer Syndicate Records",oru_ax815.xml,80444/xv83120,7,11,25,43
"Purinton (Frank R.) Papers",oru_coll210.xml,80444/xv55756,12,8,23,43
"Miller (Robert Aubrey) papers",oru_ax070.xml,80444/xv05770,9,18,16,43
"Jagendorf (M. A.) papers",oru_coll045.xml,80444/xv51999,6,13,23,42
"Porter (William) diary",oru_a096.xml,80444/xv61209,11,22,9,42
"Barnes (Eugene) and David Dougherty manuscript",oru_coll393.xml,80444/xv82495,7,30,5,42
"Herzog (Harry Albert) architectural plans, specifications, and photographs",oru_ax599.xml,80444/xv55763,14,13,15,42
"Warner (Mason Y.) papers",oru_coll245.xml,80444/xv29077,14,21,7,42
"Ogle (Lucille) Papers",oru_coll201.xml,80444/xv86543,12,11,19,42
"Robinson (Gerald) Photographs",oru_ph264.xml,80444/xv39350,17,10,15,42
"King (Willford I.) papers",oru_coll089.xml,80444/xv64995,13,2,27,42
"Jarvis (Bruce and Anna) Papers",oru_ax386.xml,80444/xv36271,16,14,12,42
"Brann (Esther) Papers",oru_ax432.xml,80444/xv76619,24,8,10,42
"Thompson (Herbert C.) papers",oru_ax067.xml,80444/xv00020,6,25,10,41
"Moreau (Jacqueline) papers",oru_coll459.xml,80444/xv57366,20,11,10,41
"WomanShare records",oru_coll269.xml,80444/xv08663,14,10,17,41
"Flack (Marjorie) Illustrations",oru_ax867.xml,80444/xv87226,12,11,18,41
"Howell (Leslie D.) architectural drawings",oru_coll146.xml,80444/xv90299,10,13,18,41
"Hendrickson (David) Papers",oru_coll043.xml,80444/xv81751,16,10,14,40
"Cloutier (James) photographs",oru_ph263.xml,80444/xv79663,8,5,27,40
"Bourne (Jonathan) Papers",oru_ax019.xml,80444/xv08900,15,9,16,40
"Lewis (Charles C.) letter and photographs",oru_ca1895aug18.xml,80444/xv71456,7,18,15,40
"Pennell (Joseph Stanley) papers",oru_ax194.xml,80444/xv91067,18,16,6,40
"Thompson (David E.) Landscape Architecture Project Files",oru_ax851.xml,80444/xv83122,8,16,15,39
"Curry (Thomas A.) Papers",oru_ax318.xml,80444/xv84823,8,20,11,39
"Allen (Don B. and Terry Diener) Papers",oru_ax500.xml,80444/xv33189,14,17,8,39
"Smith (William Carlson) papers",oru_ax364.xml,80444/xv70077,9,22,7,38
"Davidson (C. Girard) papers",oru_coll162.xml,80444/xv35576,11,13,14,38
"Loomis (Noel) papers",oru_coll165.xml,80444/xv67416,2,6,30,38
"Wood (Hugh B.) Papers",oru_ua011.xml,80444/xv99020,10,10,18,38
"Butcher (Claude R.) papers",oru_coll137.xml,80444/xv16433,8,13,17,38
"Fealy (Barbara) Landscape Architect Records",oru_coll262.xml,80444/xv76647,18,12,8,38
"Yaukey (Grace Sydenstricker) Papers",oru_ax498.xml,80444/xv07534,12,10,15,37
"Hoffman (Rolla) Papers",oru_ax703.xml,80444/xv40026,18,9,10,37
"Du Jardin (Rosamond) papers",oru_coll252.xml,80444/xv75415,7,12,18,37
"Frankenberg (Robert C.) Papers",oru_coll042.xml,80444/xv30113,11,17,9,37
"Newhouse (Carol) Photographs and Papers",oru_coll431.xml,80444/xv68844,16,10,11,37
"Adshead (Gladys Lucy) Papers",oru_ax446.xml,80444/xv43785,11,16,10,37
"Office of the President: William Beaty Boyd records",oru_ua001_013.xml,80444/xv89511,6,3,28,37
"Wilkin (Eloise) Papers",oru_coll213.xml,80444/xv32847,6,19,12,37
"Little (John) papers",oru_coll325.xml,80444/xv64572,15,11,11,37
"Fuller (Arthur D.) papers",oru_ax324.xml,80444/xv69622,10,14,13,37
"Sheldon and Fife Family papers",oru_ax079.xml,80444/xv30794,4,19,14,37
"Simester (Edith Winifred) papers",oru_a183.xml,80444/xv18821,2,9,26,37
"Oregon Women's Political Caucus records",oru_coll369.xml,80444/xv08181,13,4,19,36
"Crawford (Medorem) papers",oru_ax129.xml,80444/xv96109,10,16,10,36
"Cook (Will) Papers",oru_ax332.xml,80444/xv50622,11,18,7,36
"Sterling (Philip) Papers",oru_ax751.xml,80444/xv72865,6,13,17,36
"Moore, Hampton, Dillard family papers",oru_a153.xml,80444/xv79434,16,9,11,36
"McCamant (Wallace) Papers",oru_ax155.xml,80444/xv60198,9,19,8,36
"Bock (Laura J.) papers",oru_ua018.xml,80444/xv01614,8,14,14,36
"Johnston (Dorothy Grunbock) Papers",oru_ax693.xml,80444/xv73890,10,17,9,36
"Ames (Lee J.) Illustrations",oru_ax727.xml,80444/xv08566,10,8,17,35
"Helman (Abel D.) papers",oru_a048.xml,80444/xv28051,3,9,23,35
"Oregon Daily Emerald records",oru_ua076.xml,80444/xv65963,5,16,14,35
"Gloss (Molly) Papers",oru_coll296.xml,80444/xv25658,10,12,13,35
"Linder (Ben) Collection",oru_coll304.xml,80444/xv56051,24,9,2,35
"Robins (Thomas M.) papers",oru_ax278.xml,80444/xv40631,13,13,9,35
"University Archives alphabetical subject single files",oru_uaref6.xml,80444/xv68792,9,12,13,34
"Warner (Gertrude Bass) lantern slides",oru_ph014.xml,80444/xv81365,10,9,15,34
"Phillips (Fred) testimony",oru_coll385.xml,80444/xv24484,13,15,6,34
"Robnett (George W.) Papers",oru_coll077.xml,80444/xv29423,8,4,22,34
"CBS TV <emph render="italic">Gunsmoke</emph> scripts",oru_ax617.xml,80444/xv01004,9,10,15,34
"Western Pine Association Records",oru_bx105.xml,80444/xv82771,7,10,17,34
"Yeon (John) architectural drawings",oru_coll333.xml,80444/xv87240,9,9,16,34
"Rupp (Norman) papers",oru_ax094.xml,80444/xv00691,17,12,5,34
"Sutton (Sarah) printed diary: Crossing the Plains",oru_casu87.xml,80444/xv37802,15,9,10,34
"Slobodkin (Louis) Papers",oru_ax733.xml,80444/xv74231,8,12,14,34
"Crowell (Pers) Papers",oru_ax228.xml,80444/xv93037,22,4,8,34
"Milligan (Marian) papers",oru_coll370.xml,80444/xv87689,6,9,19,34
"Bates (Kate Stevens) Papers",oru_ax202.xml,80444/xv22580,9,15,10,34
"Stordahl (Axel) papers",oru_ax528.xml,80444/xv53662,13,8,12,33
"Arntson (Herbert E.) papers",oru_coll064.xml,80444/xv03777,4,6,23,33
"McGarrity family photographs",oru_ph330.xml,80444/xv33191,5,12,16,33
"Stearns (Orson A.) reminiscences of pioneer days of Phoenix, Oregon and sketch of Samuel Colver",oru_cbst31.xml,80444/xv31900,4,8,21,33
"Preis (Arthur) papers",oru_ax283.xml,80444/xv93582,10,10,13,33
"Oregon NOW (National Organization for Women) records",oru_coll371.xml,80444/xv40481,15,10,8,33
"Telfer (John) papers",oru_a122.xml,80444/xv13635,9,18,6,33
"Research Collection for Conservative and Libertarian Studies",oru_coll254.xml,80444/xv10150,17,8,8,33
"Langille (William A.) Papers",oru_ax635.xml,80444/xv06504,16,11,6,33
"G. Heitkemper Company records",oru_bx195.xml,80444/xv47634,13,8,12,33
"People's Transportation Co. bills and manifests.",oru_b113.xml,80444/xv36135,1,2,30,33
"Fisher (Alzo John) Papers",oru_ax430.xml,80444/xv80035,5,12,16,33
"Erickson (Ruth) and Stevenson (Eleanor) papers",oru_ax763.xml,80444/xv45935,12,16,4,32
"Walsh (William E.) papers",oru_ax494.xml,80444/xv22027,3,3,26,32
"Will (Clark Moor) papers",oru_coll062.xml,80444/xv05822,16,12,4,32
"Pyke Family Papers",oru_ax766.xml,80444/xv36260,10,13,9,32
"Fries (Amos) papers",oru_ax234.xml,80444/xv38409,8,21,3,32
"Fritz (Jean) papers",oru_ax664.xml,80444/xv22741,8,19,5,32
"Call (Hughie) Papers",oru_coll073.xml,80444/xv36607,14,12,6,32
"Barron (Ann) manuscript",oru_a216.xml,80444/xv44290,10,13,9,32
"Bensing (Frank C.) papers",oru_ax615.xml,80444/xv68493,14,11,7,32
"Goltra (Elizabeth) papers",oru_a034.xml,80444/xv62592,14,11,7,32
"Carroll (Ruth and Latrobe) Papers",oru_ax710.xml,80444/xv19166,12,9,11,32
"Bond (George) Journal",oru_sfm023.xml,80444/xv24289,7,16,8,31
"Westover Terraces construction photograph albums",oru_ph203_035.xml,80444/xv89283,17,6,8,31
"Grand Army of the Republic, Department of Oregon, Women's Relief Corps, Meade Corps #18 Records",oru_b071.xml,80444/xv11977,10,8,13,31
"Burnam (Tom) papers",oru_ax811.xml,80444/xv12564,23,5,3,31
"Boutelle (Frazier Augustus) papers",oru_ax012.xml,80444/xv43100,11,14,6,31
"Brown (Beverly) papers",oru_coll318.xml,80444/xv24774,5,14,12,31
"Gray (James T.) papers",oru_ax207.xml,80444/xv48582,9,9,13,31
"Cormack (Maribelle) Papers",oru_ax418.xml,80444/xv47893,12,9,10,31
"Snow (Charles H.) papers",oru_ax298.xml,80444/xv46316,7,12,12,31
"Mullendore (William C.) Papers",oru_coll125.xml,80444/xv02410,16,10,5,31
"Raymond (Almira Adeline David) letters from Oregon",oru_a104.xml,80444/xv28240,6,17,8,31
"Tracy (Ray Palmer) papers",oru_ax566.xml,80444/xv91210,12,11,8,31
"Bean and Condon Family Papers",oru_coll154.xml,80444/xv79708,4,6,21,31
"Tichenor (William) reminiscences",oru_cbt435.xml,80444/xv53607,7,12,11,30
"Ottenheimer (Albert M.) papers",oru_coll132.xml,80444/xv87913,7,12,11,30
"University Archives publications",oru_uaref4.xml,80444/xv68600,6,9,15,30
"White (John R.) papers",oru_ax192.xml,80444/xv99700,4,14,12,30
"Oliver (Jay C. and Lucile C.) Papers",oru_ax647.xml,80444/xv18142,12,11,7,30
"Walden (Amelia Elizabeth) Papers",oru_coll054.xml,80444/xv06514,12,12,6,30
"Mansfield (Norma Bicknell and Robert Stuart) Papers",oru_ax765.xml,80444/xv14377,7,12,11,30
"Jensen (Gertrude Glutsch) Papers",oru_ax658.xml,80444/xv72168,11,8,11,30
"Nelson (Vera Joyce) papers",oru_ax662.xml,80444/xv86465,5,15,10,30
"Soule (Isobel Walker) papers",oru_ax774.xml,80444/xv96072,5,17,8,30
"Gerke (Walter H. and Florence Holmes) landscape architecture drawings and photographs",oru_coll144.xml,80444/xv01042,12,10,8,30
"Craig (Mary Francis) Papers",oru_ax435.xml,80444/xv89959,12,9,9,30
"Moon (Seymour E. and Sarah) Papers",oru_ax646.xml,80444/xv16090,8,6,15,29
"Coffield (Glen Stemmons) Papers",oru_coll217.xml,80444/xv81753,6,18,5,29
"Theta Nu Epsilon. University of Oregon chapter records",oru_ua135.xml,80444/xv56237,7,12,10,29
"Ogden (George Washington) papers",oru_ax484.xml,80444/xv20010,7,10,12,29
"Weil (Lisl) Papers",oru_ax612.xml,80444/xv97829,11,7,11,29
"Lampman (Ben Hur) papers",oru_ax426.xml,80444/xv42025,12,8,9,29
"Oregon State Academy of Sciences records",oru_coll419.xml,80444/xv14779,18,4,7,29
"Barron (Bryton) Papers",oru_ax463.xml,80444/xv96124,16,4,9,29
"Lynch (Lee) papers",oru_coll259.xml,80444/xv26419,10,7,12,29
"Van Wagenen (Fred D.) letter",oru_ca1896sept13.xml,80444/xv77481,0,26,2,28
"Purcell (William G.) Selected Papers",oru_ax267.xml,80444/xv95434,5,11,12,28
"Hawes (D.W.) letter to W.P. Goodbar concerning the sale of slaves",oru_ca1857feb14.xml,80444/xv18457,14,7,7,28
"Bond and Associates Landscape Architects Records",oru_coll297.xml,80444/xv51382,10,10,8,28
"Wilson (Charles Morrow) papers",oru_ax772.xml,80444/xv95629,6,12,10,28
"Blackwood (Lillian Caldwell) letters and photographs",oru_a010.xml,80444/xv04354,11,10,7,28
"Jones (Elizabeth Orton) papers",oru_coll200.xml,80444/xv73507,14,8,6,28
"Rutherford (William D.) papers",oru_coll299.xml,80444/xv49950,11,12,5,28
"Evarts (Hal George, Jr.) Papers",oru_ax823.xml,80444/xv32839,4,3,21,28
"Case (Victoria) Papers",oru_ax230.xml,80444/xv67390,11,10,7,28
"Hoffman (William) journal",oru_a052.xml,80444/xv93715,13,12,3,28
"Scovel (Frederick and Myra) Papers",oru_ax707.xml,80444/xv68070,8,11,9,28
"Hawkins (Quail) Papers",oru_ax819.xml,80444/xv48918,8,14,5,27
"Fessier (Michael) Papers",oru_ax428.xml,80444/xv05489,5,6,16,27
"Melrose (Paul and Esther) Papers",oru_ax761.xml,80444/xv34210,6,12,9,27
"Newby (William T.) papers",oru_a088.xml,80444/xv26683,11,9,7,27
"James (James J.) Papers",oru_ax553.xml,80444/xv76956,6,20,1,27
"Kerr (Raymond E.) Papers",oru_ax345.xml,80444/xv16080,6,8,13,27
"Annixter (Jane and Paul) Papers",oru_ax654.xml,80444/xv49602,5,8,14,27
"Cameron (Courtney Owen) papers",oru_ax573.xml,80444/xv66284,15,9,3,27
"McConnell (Frederic C.) papers",oru_ax513.xml,80444/xv50140,6,10,11,27
"Owen (Benjamin Franklin) journal",oru_a093.xml,80444/xv92347,9,5,13,27
"Bludgett (John W.) papers",oru_coll223.xml,80444/xv99545,9,8,10,27
"Rapp (William J.) papers",oru_ax604.xml,80444/xv50134,3,11,12,26
"Frye (Helen) papers",oru_coll348.xml,80444/xv44726,7,5,14,26
"Clise (James W.) Papers",oru_coll114.xml,80444/xv02407,6,15,5,26
"Brown (Samuel Henry) papers",oru_ax120.xml,80444/xv00022,13,11,2,26
"Pate (Joseph Benjamin) papers",oru_ax790.xml,80444/xv85070,6,11,9,26
"Bendick (Jeanne) Papers",oru_ax550.xml,80444/xv04455,8,8,10,26
"DeMoss Family Lyric Bards records",oru_coll070.xml,80444/xv70474,12,5,9,26
"Athanas (W. Verne) papers",oru_ax212.xml,80444/xv62493,12,6,8,26
"Cadbury (William) faculy papers",oru_ua228.xml,80444/xv59875,16,3,7,26
"Kaufman (William I.) papers",oru_coll220.xml,80444/xv98856,10,12,4,26
"Adamson (Lee J.) papers",oru_coll086.xml,80444/xv71491,11,12,3,26
"Kubli General Store account books",oru_bx012.xml,80444/xv47354,10,5,11,26
"Beattie (William Gilbert) papers",oru_ax117.xml,80444/xv97818,4,12,10,26
"Kizer (Benjamin Hamilton) papers",oru_ax054.xml,80444/xv95001,8,7,11,26
"Lambert (Charles Edward) correspondences received",oru_a069.xml,80444/xv60855,13,9,4,26
"Moninger (Margaret) Papers",oru_ax705.xml,80444/xv37627,14,4,7,25
"Case (Robert Ormond) Papers",oru_ax467.xml,80444/xv45834,8,8,9,25
"Holberg (Richard) illustrations",oru_ax866.xml,80444/xv96087,4,8,13,25
"Andrews (Roy C.) Papers",oru_ax002.xml,80444/xv11976,9,9,7,25
"Davis (C. Gilman) papers",oru_coll057.xml,80444/xv95085,12,5,8,25
"Akin (James) papers",oru_a001.xml,80444/xv31472,13,7,5,25
"Spears (Raymond Smiley) Papers",oru_coll156.xml,80444/xv86547,20,2,3,25
"University Archives biographical single files",oru_uaref7.xml,80444/xv33004,9,11,5,25
"McCutcheon (Shaw) cartoons",oru_a221.xml,80444/xv97198,19,3,3,25
"Scheffer (Francis) letter to Hawes and Bartlett concerning the sale of a slave",oru_ca1857apr18.xml,80444/xv77862,9,7,9,25
"Sions (Harry) papers",oru_ax836.xml,80444/xv18893,9,13,3,25
"Johnson (Charles E.) papers",oru_ua008.xml,80444/xv75363,2,13,10,25
"Smith (Charles E. and Viola L.) Papers",oru_ax437.xml,80444/xv35925,3,18,4,25
"Neall (James and Hannah Lloyd) papers",oru_coll347.xml,80444/xv97171,6,13,6,25
"Wagner (Jonathan) papers",oru_ax369.xml,80444/xv46148,8,6,11,25
"Fortner (Ethel Nestell) papers",oru_coll182.xml,80444/xv55535,3,3,19,25
"Borthwick and Saunders Family papers",oru_ax016.xml,80444/xv08139,0,18,6,24
"Daugherty (James) papers",oru_ax450.xml,80444/xv37393,6,12,6,24
"Fadeley (Nancie) papers",oru_coll349.xml,80444/xv82852,12,4,8,24
"Croke (Father James) letters",oru_a023.xml,80444/xv19860,12,11,1,24
"Wakeman (Letha Evangeline Ward) Papers",oru_ax795.xml,80444/xv01716,7,11,6,24
"Plowman (Edward Grosvenor) papers",oru_ax700.xml,80444/xv17337,6,3,15,24
"Ernst (Alice Henson) letters to Hazel Mills",oru_coll387.xml,80444/xv66366,10,8,6,24
"Pressman (Hope Hughes) papers",oru_ua019.xml,80444/xv47760,8,5,11,24
"Huss (Walter) papers",oru_coll357.xml,80444/xv89453,17,4,3,24
"Bannard (Margaret) Collection",oru_cbb226.xml,80444/xv02408,6,10,8,24
"Littell (Robert) papers",oru_ax400.xml,80444/xv44049,13,8,3,24
"Prescott, Jr. (Robert) papers",oru_coll198.xml,80444/xv40707,5,16,3,24
"Holdridge (Herbert C.) papers",oru_coll124.xml,80444/xv93378,8,7,8,23
"Cornell (William) diary",oru_a021.xml,80444/xv99105,7,15,1,23
"Dougherty (Joanna Foster) Papers",oru_bx132.xml,80444/xv19165,12,7,4,23
"Lacy family papers",oru_ax412.xml,80444/xv31451,14,6,3,23
"Blakely (James) papers",oru_cab583.xml,80444/xv32516,16,1,6,23
"Millard (Bailey) papers",oru_ax431.xml,80444/xv26434,7,11,5,23
"Walrad (Jane Mullen) diary",oru_a128.xml,80444/xv45956,9,10,4,23
"McComas (Evans Smith) Papers",oru_ax181.xml,80444/xv25657,6,14,3,23
"Theophilus Magruder v. Jacob Vanderpool Case Documents",oru_b122.xml,80444/xv11309,16,5,2,23
"Kehoe (Joseph) Papers",oru_ax396.xml,80444/xv47204,7,7,9,23
"Noble (Harold Joyce) papers",oru_ax160.xml,80444/xv49719,7,9,7,23
"Townsend National Recovery Plan, Inc. records",oru_bx115.xml,80444/xv77462,13,6,4,23
"Scott Family Papers",oru_coll302.xml,80444/xv55084,7,8,7,22
"Phillips (Victor) sermons",oru_f252p539.xml,80444/xv23745,5,13,4,22
"Helck (C. Peter) papers",oru_coll181.xml,80444/xv93560,6,15,1,22
"Frame (Murray Scott and Alice Seymore Brown) Papers",oru_ax421.xml,80444/xv10955,7,8,7,22
"Kruse (Anne Applegate) manuscript of "The Applegate Story"",oru_f978k945.xml,80444/xv40731,8,4,10,22
"Shalett (Sidney) papers",oru_ax248.xml,80444/xv52978,5,11,6,22
"Dye (Alexander Vincent) papers",oru_ax134.xml,80444/xv32009,10,5,7,22
"Putnam (George) papers",oru_ax827.xml,80444/xv84722,15,1,6,22
"Collins (Richard) Papers",oru_ax691.xml,80444/xv72864,6,12,4,22
"J. William Terry papers",oru_ax830.xml,80444/xv43310,4,9,9,22
"Student Cooperative records",oru_ua174.xml,80444/xv29495,5,7,10,22
"Hogner (Nils) papers",oru_ax717.xml,80444/xv88088,7,9,6,22
"Bean (Ormond R.) Papers",oru_ua014.xml,80444/xv80493,1,6,15,22
"Florence Crittenton Refuge Home minutes",oru_b090.xml,80444/xv04956,10,2,10,22
"Hammond (Eleanor) Papers",oru_coll038.xml,80444/xv88250,3,3,16,22
"Nelson (Lee) Papers",oru_coll334.xml,80444/xv48730,3,13,5,21
"Delta Nu Alpha Transportation Fraternity. University of Oregon Chapter records",oru_ua101.xml,80444/xv01617,8,6,7,21
"DeWitt (Cornelius) papers",oru_ax347.xml,80444/xv57571,0,15,6,21
"Perry (Lawrence) papers",oru_ax388.xml,80444/xv14990,10,3,8,21
"Odd Fellows Hall Association (Portland, Or.) contract",oru_ca1869june7.xml,80444/xv42233,13,0,8,21
"Norton (Henry M.) Papers",oru_coll072.xml,80444/xv64996,7,4,10,21
"Women's Christian Temperance Union, Gardiner, Oregon branch treasurer's book",oru_b094.xml,80444/xv20706,9,3,9,21
"Anderson (Elizabeth Southworth) report",oru_ca1915july17.xml,80444/xv69531,17,1,3,21
"Turngren (Annette) Papers",oru_ax557.xml,80444/xv79019,1,12,8,21
"Miles (Stephen B.) Papers",oru_coll034.xml,80444/xv97825,8,5,8,21
"Jackson (Jean) papers",oru_ax379.xml,80444/xv91812,9,9,3,21
"Garner (Alan) papers",oru_coll399.xml,80444/xv01708,3,7,11,21
"Allen (Sally Elliott) papers",oru_ax239.xml,80444/xv47570,7,5,9,21
"Bright (Verne) papers",oru_ax263.xml,80444/xv53375,1,3,17,21
"Brown (Benjamin) diary",oru_a012.xml,80444/xv57095,3,10,7,20
"Baker (James Chamberlain) papers",oru_ax114.xml,80444/xv59457,9,10,1,20
"Lawrence, Tucker and Wallmann records",oru_coll113.xml,80444/xv58836,3,8,9,20
"McClure (Andrew S.) journal",oru_a074.xml,80444/xv32131,4,11,5,20
"Wright (Elizabeth Curtis) papers",oru_a301.xml,80444/xv15743,4,15,1,20
"Friermood (Elisabeth Hamilton) Papers",oru_ax453.xml,80444/xv09589,8,8,4,20
"Fort (Guy O.) correspondence",oru_sfm245.xml,80444/xv22677,7,0,13,20
"Meacham (Walter) papers",oru_ax065.xml,80444/xv48269,4,7,9,20
"Biggs (Earl R.) Papers",oru_ax470.xml,80444/xv78667,3,8,9,20
"Robinson (Horace) papers",oru_ua025.xml,80444/xv68179,7,7,6,20
"Aitchison (Beatrice) papers",oru_bx137.xml,80444/xv60943,9,1,10,20
"Ingerson (Vera Frances) Papers",oru_ax516.xml,80444/xv73198,10,4,6,20
"Harrison (Fred) legislative speeches",oru_coll381.xml,80444/xv80554,17,0,3,20
"Clackamas County polling record",oru_ca1857nov9.xml,80444/xv29129,7,6,7,20
"Jackson (Boyd J.) papers",oru_ax055.xml,80444/xv72853,8,10,2,20
"Coole (Arthur and Ella) Papers",oru_ax793.xml,80444/xv01037,4,11,5,20
"Bean (Robert Sharp) papers",oru_ax008.xml,80444/xv04052,5,10,5,20
"Watson (Morris) papers",oru_ax744.xml,80444/xv03268,2,14,4,20
"Morse (Esther) Papers",oru_ax860.xml,80444/xv68410,3,4,13,20
"Vaughn (Warren N.) Recollections",oru_cbv465.xml,80444/xv93698,5,8,7,20
"Chaney (Ralph Works) papers",oru_ax482.xml,80444/xv46041,13,7,0,20
"Robbins (Kate L.) papers",oru_a105.xml,80444/xv57805,10,10,0,20
"Fortnightly Club of Eugene records",oru_coll329.xml,80444/xv17648,8,7,5,20
"Dodson (William Daniel Boone) papers",oru_ax488.xml,80444/xv92562,16,3,0,19
"Hurley (G. Victor) papers",oru_ax343.xml,80444/xv19580,12,4,3,19
"UO Documenting Freshman Year Experience Project Journals",oru_ua012.xml,80444/xv56450,0,4,15,19
"U.S. Office of Indian Affairs, Malheur Agency Records",oru_bx053.xml,80444/xv51307,6,3,10,19
"Gorman (Mary) papers",oru_ax340.xml,80444/xv95385,9,9,1,19
"Walton (Pauline) diaries and correspondence",oru_ax674.xml,80444/xv29797,3,9,7,19
"Pommerenke (Herbert H.) papers",oru_ax722.xml,80444/xv97949,9,5,5,19
"Ronald Clarke collection on Rajneesh",oru_coll407.xml,80444/xv39016,13,0,6,19
"Lampman (Evelyn Sibley) papers",oru_coll011.xml,80444/xv82781,9,7,3,19
"Garfield (Brian) papers",oru_ax294.xml,80444/xv11126,6,7,6,19
"Erb Memorial Union records",oru_ua061.xml,80444/xv45349,7,5,7,19
"University of Oregon. Office of the Dean of Personnel Administration. National Japanese American Student Relocation Council Records",oru_ua009.xml,80444/xv04124,6,7,6,19
"Dwiggins (Don) Selected Manuscripts",oru_coll090.xml,80444/xv06856,8,3,8,19
"Fear family papers",oru_ax034.xml,80444/xv41198,5,13,1,19
"Bonneville Dam construction photograph album",oru_ph203_020.xml,80444/xv58159,10,8,1,19
"McAllister (Joseph B.) papers",oru_a156.xml,80444/xv46322,3,13,3,19
"International Longshoremen's Association, Local Pacific Coast District records",oru_coll412.xml,80444/xv59204,13,4,2,19
"First National Bank of Eugene records",oru_bx197.xml,80444/xv16168,5,4,10,19
"Santiam Academy student manuscripts",oru_f378sa59.xml,80444/xv78897,6,2,11,19
"Allingham (George) letter to William Allingham",oru_ca1851jan19.xml,80444/xv51885,16,3,0,19
"Nicolai Bros. Co. records",oru_bx028.xml,80444/xv19284,5,8,6,19
"Hargreaves (Sheba May) papers",oru_coll194.xml,80444/xv47348,7,11,1,19
"Alger (Maurice P.) papers",oru_ax477.xml,80444/xv25143,0,4,15,19
"Department of Home Economics records",oru_ua057.xml,80444/xv84320,4,5,10,19
"Franchere (Ruth Myers) Papers",oru_ax548.xml,80444/xv46186,10,7,2,19
"Horning (Walter Harold) Papers",oru_ax189.xml,80444/xv23947,6,6,6,18
"Blough (Glenn O.) Papers",oru_ax736.xml,80444/xv05825,4,6,8,18
"Carew (Dorothy) Papers",oru_ax848.xml,80444/xv00354,9,6,3,18
"Clark (Harvey) indenture",oru_ca1855july13.xml,80444/xv36526,4,9,5,18
"Anderson (Jean Fuller) Papers",oru_coll312.xml,80444/xv99554,0,9,9,18
"Ullman (Albert Conrad) Papers",oru_coll040.xml,80444/xv40365,5,1,12,18
"Women's Workshop records",oru_ua137.xml,80444/xv63327,10,4,4,18
"Hatch (Edwin Thompson) letter to Solomon Hirsch",oru_ca1896may17.xml,80444/xv27581,6,10,2,18
"Aikman (Duncan) papers",oru_ax629.xml,80444/xv56042,11,4,3,18
"School of Journalism and Communication records",oru_ua013.xml,80444/xv56661,0,9,9,18
"Booth (Edwin) Papers",oru_coll184.xml,80444/xv33865,9,5,4,18
"Plowhead (Ruth Gipson) Papers",oru_ax713.xml,80444/xv69096,9,3,6,18
"Loren Holcombe Milliman papers",oru_coll175.xml,80444/xv14040,12,3,3,18
"Davidson (Sydney Arthur Jr.) papers",oru_a210.xml,80444/xv40237,1,11,6,18
"Young (Benjamin) papers",oru_ax046.xml,80444/xv94506,3,7,8,18
"Wilson (Bushrod Washington) letters to Joseph P. Wilson",oru_a135.xml,80444/xv44183,5,10,3,18
"Office of Governmental Affairs records",oru_ua104.xml,80444/xv74194,9,5,4,18
"Baker (William Salter) bill of sale",oru_ca1850aug20.xml,80444/xv05337,10,7,1,18
"Turner (William Oliver) papers",oru_ax556.xml,80444/xv66912,8,4,5,17
"Bloch (Kurt) papers",oru_coll019.xml,80444/xv26235,12,2,3,17
"Hendriksen (Margie) papers",oru_coll365.xml,80444/xv49383,3,5,9,17
"Frazier (Robert B.) Papers",oru_ax802.xml,80444/xv67380,3,10,4,17
"Main (Idabelle) papers",oru_coll029.xml,80444/xv98166,12,5,0,17
"Aldrich (Edwin B.) correspondence",oru_ax083.xml,80444/xv63500,5,6,6,17
"Credle (Ellis) Papers",oru_ax657.xml,80444/xv42762,5,8,4,17
"S.W.I.N.E (Students Wildly Indignant about Nearly Everything) records",oru_ua107.xml,80444/xv07122,3,8,6,17
"Pine Mountain Observatory records",oru_ua093.xml,80444/xv52310,0,11,6,17
"Bush (Asahel) papers",oru_ax184.xml,80444/xv24209,12,5,0,17
"Ellison-White Chautauqua Bureau records",oru_b075.xml,80444/xv18798,5,7,5,17
"Career Center records",oru_ua139.xml,80444/xv14556,0,5,12,17
"Richard Frazier Crawford Beyond Black & White exhibit photographs",oru_ph334.xml,80444/xv98855,11,5,1,17
"Chambers Communications Corp. records",oru_coll427.xml,80444/xv40438,4,3,10,17
"Tetherow (Solomon) Journal",oru_a123.xml,80444/xv52172,8,5,4,17
"Idaho National Harvester Company photographs",oru_ph318.xml,80444/xv26696,4,7,6,17
"Sterne (Emma Gelders) Papers",oru_ax391.xml,80444/xv00697,4,7,6,17
"Associated Students of University of Oregon (ASUO) records",oru_ua150.xml,80444/xv38604,3,6,8,17
"Billing (Arthur and Mabel) Papers",oru_ax652.xml,80444/xv53710,9,2,6,17
"Department of Theatre Arts records",oru_ua088.xml,80444/xv92739,8,5,4,17
"Teal (Joseph Nathan) scrapbooks",oru_cat221.xml,80444/xv70394,1,13,3,17
"Duncan (Robert Blackford) papers",oru_ax535.xml,80444/xv91775,4,12,1,17
"Holm (Donald R.) papers",oru_ax405.xml,80444/xv18460,5,4,8,17
"University Friars records",oru_ua154.xml,80444/xv74911,1,7,8,16
"Centennial Planning Council records",oru_ua087.xml,80444/xv29684,7,5,4,16
"Sweetser (Albert and Carrie) papers",oru_ax075.xml,80444/xv12463,3,6,7,16
"Charbonneau (Louis) papers",oru_ax656.xml,80444/xv30334,9,4,3,16
"Myers (Jefferson) papers",oru_coll191.xml,80444/xv44027,8,2,6,16
"Szasz (Margaret) Collection on the Klamath Indian Tribe",oru_coll314.xml,80444/xv32604,13,2,1,16
"Gillian (James H.) letter",oru_ca1861dec19.xml,80444/xv37011,10,5,1,16
"Houston (Branch) Papers",oru_coll249.xml,80444/xv20875,1,4,11,16
"Hall (Rosalys Haskell) Papers",oru_ax458.xml,80444/xv35239,4,3,9,16
"Bobbe (Dorothie de Bear) papers",oru_ax808.xml,80444/xv91961,7,5,4,16
"Dunn (Robert Williams) papers",oru_ax794.xml,80444/xv98248,1,8,7,16
"University Theatre records",oru_ua148.xml,80444/xv65969,0,8,8,16
"Hartman (George Arthur) letters from the Philippines",oru_a235.xml,80444/xv65045,4,5,7,16
"Laurean and Eutaxian Societies' records",oru_ua125.xml,80444/xv68237,2,9,5,16
"Eakin (Jane) diary",oru_a030.xml,80444/xv06134,4,7,5,16
"Banta (I.) Papers",oru_a007.xml,80444/xv64302,9,3,4,16
"Society of the Sigma Xi. University of Oregon Chapter records",oru_ua147.xml,80444/xv40765,6,6,4,16
"Department of Religious Studies records",oru_ua071.xml,80444/xv53320,7,5,4,16
"Alpha Delta Sigma. W.F.G. Thacher Chapter records",oru_ua099.xml,80444/xv48809,1,6,9,16
"Josslin (William Leslie) scrapbooks",oru_caj7.xml,80444/xv41058,5,9,2,16
"Wilson (Joseph Gardner) letter",oru_ca1870feb26.xml,80444/xv72561,3,8,5,16
"Wilson (Woodrow) letter to Luella Clay Carson",oru_ca1894apr11.xml,80444/xv12918,3,1,12,16
"Rorty (James) papers",oru_ax769.xml,80444/xv71063,5,5,6,16
"Conrad (Earl) papers",oru_ax460.xml,80444/xv44842,4,5,7,16
"University of Oregon Board of Regents minutes",oru_ua023.xml,80444/xv57763,3,6,7,16
"Portland, Alaska Gold Mining Company Records",oru_b058.xml,80444/xv46519,8,3,5,16
"Savery (Constance) papers",oru_coll471.xml,80444/xv84518,0,7,9,16
"Applegate (John) letter",oru_ca1865may7.xml,80444/xv54943,12,3,1,16
"Democratic Party of Oregon Records",oru_bx168.xml,80444/xv48230,2,5,9,16
"Belknap (Rollin Simeon) letter",oru_ca1872june5.xml,80444/xv90795,8,3,4,15
"Starkey (Robert) scrapbook",oru_cast28.xml,80444/xv82351,3,7,5,15
"Morrison (Dorothy Nafus) Literary Manuscripts",oru_ax862.xml,80444/xv12669,5,6,4,15
"Davis (Marguerite) Papers",oru_coll229.xml,80444/xv04805,7,6,2,15
"Applegate (Elisha L.) scrapbook",oru_caap52.xml,80444/xv42742,10,3,2,15
"Applegate (Moray Lindsay) letters to Herbert C. Thompson and other correspondence",oru_a005.xml,80444/xv47756,0,2,13,15
"Benade (Dr. James Martin and Miriam) Papers",oru_ax807.xml,80444/xv00008,1,8,6,15
"Colver Family Papers",oru_ax126.xml,80444/xv30445,10,3,2,15
"Condon Lectures Series records",oru_ua141.xml,80444/xv70104,3,4,8,15
"Howard (Nathaniel Clinton) letters",oru_a055.xml,80444/xv64941,6,7,2,15
"Thomas Brady, Sr. collection of conservative materials",oru_coll404.xml,80444/xv93695,2,13,0,15
"Hull (Alexander) papers",oru_ax052.xml,80444/xv95675,9,0,6,15
"Russell (Thomas O.) papers",oru_ax059.xml,80444/xv71143,5,5,5,15
"Hinman (Alanson) papers",oru_a051.xml,80444/xv60884,7,3,5,15
"Metzler (Ken) papers",oru_ua007.xml,80444/xv99816,0,8,7,15
"Academic Distinctions Committee records",oru_ua143.xml,80444/xv35086,5,4,6,15
"Center for the Study of Women in Society records",oru_ua106.xml,80444/xv88198,0,10,5,15
"Huntington (Harriet E.) Papers",oru_ax454.xml,80444/xv66019,4,7,4,15
"Chapman (Maristan) papers",oru_coll203.xml,80444/xv00445,4,3,8,15
"Thielsen Family papers",oru_ax053.xml,80444/xv83489,7,2,6,15
"Faculty Club records",oru_ua095.xml,80444/xv53155,6,5,4,15
"Greeley (Gertrude Jewett) Oral History",oru_cbg819.xml,80444/xv43441,9,6,0,15
"Harvey (Maria Eloisa McLoughlin Rae) "Life of John Mcloughlin" manuscript",oru_cbh262.xml,80444/xv72158,2,9,4,15
"Wilson (Frederick Wallace) papers",oru_ax177.xml,80444/xv94659,3,5,7,15
"Crothers (John Y.) Papers",oru_coll159.xml,80444/xv57465,2,11,2,15
"American Association of University Professors. University of Oregon Chapter records",oru_ua098.xml,80444/xv29721,6,5,4,15
"Chastain (Madye Lee) Papers",oru_ax545.xml,80444/xv30458,0,8,7,15
"Friendly (Leonard) papers",oru_ax236.xml,80444/xv93249,3,3,9,15
"School of Law records",oru_ua132.xml,80444/xv66809,0,9,6,15
"Dyson (Joseph W.) Papers",oru_ax334.xml,80444/xv52682,7,2,6,15
"La Follette (Cameron) papers",oru_coll432.xml,80444/xv24786,9,0,6,15
"Porter Family correspondence",oru_a115.xml,80444/xv50238,5,2,8,15
"Martin (Arthur) papers",oru_ax157.xml,80444/xv42102,8,6,0,14
"Davis (Jerome) papers",oru_ax022.xml,80444/xv87313,4,7,3,14
"Zagorin (Bob) Audio Recordings for Radio",oru_coll300.xml,80444/xv34841,3,2,9,14
"Philologian Society records",oru_ua128.xml,80444/xv19259,5,5,4,14
"Ireland, Arthur P. scrapbooks",oru_cair65.xml,80444/xv95617,11,0,3,14
"Reynolds (Edward Samuel "Tige") papers",oru_ax165.xml,80444/xv00219,3,6,5,14
"Woolverton family papers",oru_a149.xml,80444/xv89617,9,3,2,14
"Onthank (Karl) Conservation Papers",oru_ax356.xml,80444/xv48912,7,4,3,14
"Office of Multicultural Academic Success (OMAS) records",oru_ua109.xml,80444/xv55612,0,5,9,14
"Johnson (Dr. Charles F.) Papers",oru_ax268.xml,80444/xv81407,4,5,5,14
"Olcott (Ben Wilson) papers",oru_ax081.xml,80444/xv07812,5,7,2,14
"Creative Writing Program records",oru_ua163.xml,80444/xv38885,5,5,4,14
"S.S. Baranof, Alaska trip photograph album",oru_ph203_034.xml,80444/xv23619,6,0,8,14
"Mackenzie (Virginia M.) Papers",oru_coll160.xml,80444/xv70467,10,4,0,14
"Stewart (Mrs. A. E.) letter to Dr. Ella K. Dearborn",oru_ca1905aug17.xml,80444/xv43341,7,7,0,14
"Hockett (W.A.) Papers",oru_cbh659.xml,80444/xv08901,6,1,7,14
"Hall (Pearl) Collection of Bernard Daly Material",oru_coll037.xml,80444/xv16528,4,5,5,14
"Mills (Marmion) papers",oru_ax220.xml,80444/xv04925,7,7,0,14
"Cunningham (Julia) Papers",oru_ax655.xml,80444/xv22588,3,6,5,14
"Allen (Eric William) papers",oru_ax182.xml,80444/xv14013,9,3,2,14
"Wilson (J. Christy) Papers",oru_coll161.xml,80444/xv24635,3,7,4,14
"Henry (Vera) papers",oru_ax376.xml,80444/xv88092,2,8,4,14
"Miller (Joaquin) papers",oru_ax864.xml,80444/xv33016,4,2,8,14
"MECha records",oru_ua079.xml,80444/xv78228,0,5,9,14
"Perry (Arthur) papers",oru_a095.xml,80444/xv00372,9,2,3,14
"Simon (Howard and Mina Lewiton) Papers",oru_ax702.xml,80444/xv14380,7,3,4,14
"First National Bank of Athena, Oregon records",oru_bx116.xml,80444/xv06802,7,2,5,14
"Smith (William J.) Photographs",oru_ph025.xml,80444/xv86878,1,8,5,14
"Jaquet (Myra Anna) papers",oru_a180.xml,80444/xv53361,6,8,0,14
"Unknown",oru_coll438.xml,80444/xv07275,1,7,6,14
"Terrell (Grace) Papers",oru_ax264.xml,80444/xv49943,6,7,1,14
"Faculty bulletins and scrapbooks",oru_ua078.xml,80444/xv54974,3,7,4,14
"Wetherbee Family papers",oru_a129.xml,80444/xv20321,8,1,5,14
"Greenwillow books records",oru_coll140.xml,80444/xv72943,3,7,4,14
"Petite (Irving) papers",oru_ax581.xml,80444/xv47918,7,5,2,14
"Weaver (James) Papers",oru_coll321.xml,80444/xv61706,4,5,4,13
"Moms' and Dads' Club records",oru_ua122.xml,80444/xv75827,2,6,5,13
"Wolff (William) letter",oru_ca1872aug21.xml,80444/xv62149,9,4,0,13
"Bogart (Barbara Allen) papers",oru_coll392.xml,80444/xv72952,6,2,5,13
"Oregon Bach Festival records",oru_ua090.xml,80444/xv92300,1,7,5,13
"Jordan Schnitzer Museum of Art records",oru_ua120.xml,80444/xv66830,2,6,5,13
"Tanner (Albert Hawes) papers",oru_a120.xml,80444/xv04916,9,3,1,13
"Norris (Joseph) account book",oru_b051.xml,80444/xv05581,5,7,1,13
"Brown (Bill) Papers",oru_ax424.xml,80444/xv09243,7,5,1,13
"Black Student Union records",oru_ua082.xml,80444/xv97735,0,5,8,13
"Aitken Family Papers",oru_ax754.xml,80444/xv39347,9,1,3,13
"Gruger (Frederic Rodrigo) papers",oru_ax868.xml,80444/xv30572,2,5,6,13
"Ellison-White Chautauqua Bureau scrapbooks",oru_cael59.xml,80444/xv06961,2,4,7,13
"Opitz (Edmund A.) Papers",oru_coll009.xml,80444/xv02746,5,2,6,13
"Wally Beau Orchestra papers",oru_ax806.xml,80444/xv38940,4,7,2,13
"School of Architecture and Allied Arts scrapbooks",oru_ua077.xml,80444/xv48019,2,5,6,13
"Smith (A. C.) letter to James Slater",oru_ca1872feb16b.xml,80444/xv96829,9,2,2,13
"James H. Gilbert records",oru_ua157.xml,80444/xv40090,0,7,6,13
"Basic Rights Oregon (BRO) records",oru_coll356.xml,80444/xv51098,4,4,5,13
"McKinley (Charles) Papers",oru_ax627.xml,80444/xv41047,1,11,1,13
"Herman (Binger) manuscript of the Baltimore Colony (Oregon) pioneers",oru_cbh426.xml,80444/xv24899,6,5,2,13
"Weatherford and Wyatt records",oru_ax061.xml,80444/xv20434,8,2,3,13
"Department of Philosophy records",oru_ua065.xml,80444/xv20437,2,5,6,13
"Gardiner Mill Company Records",oru_bx183.xml,80444/xv13689,4,3,6,13
"Hampton (Edwin William) correspondence",oru_a046.xml,80444/xv22167,6,7,0,13
"Sigma Chi. Beta Iota Chapter records",oru_ua136.xml,80444/xv42239,0,8,5,13
"Educational Opportunity Services records",oru_ua160.xml,80444/xv86373,0,5,8,13
"Kidd (Walter Evans) Papers",oru_ax203.xml,80444/xv55410,0,12,1,13
"Keen (Ruth Hopson) Papers",oru_coll278.xml,80444/xv16690,4,9,0,13
"Evans (Elwood) notebook",oru_a036.xml,80444/xv82034,9,3,1,13
"Boren (Lemuel Evans) papers",oru_a223.xml,80444/xv10614,1,12,0,13
"Folts (Merton B.) papers",oru_coll060.xml,80444/xv49266,5,7,1,13
"Bensell (Royal Augustus) diary and scrapbook",oru_ax118.xml,80444/xv73632,7,2,4,13
"Young (James Webb) papers",oru_ax739.xml,80444/xv40640,7,3,2,12
"Old Oregon photographs",oru_ph323.xml,80444/xv21906,7,0,5,12
"Alumni Association records",oru_ua145.xml,80444/xv16754,0,6,6,12
"YWCA (Young Women's Christian Association), UO Chapter records",oru_ua112.xml,80444/xv37661,3,5,4,12
"Farnham (Hubert Henry) papers",oru_ax028.xml,80444/xv00283,1,6,5,12
"Hatch (Raymond W.) architectural photograph albums",oru_ph306.xml,80444/xv96465,10,2,0,12
"Upward Bound records",oru_ua035.xml,80444/xv77935,2,6,4,12
"Oregon Militia, 1st Brigade, 1st Regiment, Company A records",oru_b077.xml,80444/xv33026,1,6,5,12
"Cheyenne and Arapahoe Indian Agency letter",oru_ca1872aug25.xml,80444/xv53964,9,1,2,12
"Center for the Advanced Study of Educational Administration records",oru_ua165.xml,80444/xv75283,0,4,8,12
"Dyson (George Allan) Papers",oru_ax244.xml,80444/xv53700,5,5,2,12
"Bialk (Elisa) Papers",oru_ax503.xml,80444/xv73885,4,2,6,12
"Department of American Studies records",oru_ua031.xml,80444/xv44497,2,5,5,12
"Griffin (John Smith) papers",oru_ca1842dec26.xml,80444/xv48248,11,1,0,12
"The Bulletin [Bend] Newspaper subject files about Rajneeshpuram",oru_coll281.xml,80444/xv21557,7,2,3,12
"Groesbeck (Adam and Clara) Papers",oru_ax818.xml,80444/xv41740,3,4,5,12
"Green (Beyrl Albert) papers",oru_ax559.xml,80444/xv71777,3,6,3,12
"Propeller Club of the United States. University of Oregon Chapter records",oru_ua102.xml,80444/xv43798,0,6,6,12
"Rudd (Lydia A.) journal",oru_a107.xml,80444/xv23263,3,6,3,12
"Lipps (Oscar H.) papers",oru_ax151.xml,80444/xv27368,7,3,2,12
"Gurney (Nancy) papers",oru_a310.xml,80444/xv02068,2,4,6,12
"Onthank (Karl) Family Papers",oru_ax622.xml,80444/xv71495,8,4,0,12
"Department of Geological Sciences records",oru_ua054.xml,80444/xv06658,0,6,6,12
"Breen (Quirinus) faculty papers",oru_ua224.xml,80444/xv90179,4,5,3,12
"Chamberlain (Hazel) papers",oru_a195.xml,80444/xv86193,9,2,1,12
"Russian, East European, and Eurasian Studies Center (REESC) records",oru_ua046.xml,80444/xv71316,3,5,4,12
"King (Ernest LaMarr) manuscripts",oru_f385k581.xml,80444/xv93865,8,0,4,12
"MacLeod (Ruth) papers",oru_ax349.xml,80444/xv36224,4,7,1,12
"Dunn (Nancy) papers",oru_coll362.xml,80444/xv77227,7,1,4,12
"Holmes (Kenneth L.) correspondence and subject files",oru_coll382.xml,80444/xv87884,4,7,1,12
"Stadelman Fruit Co. records",oru_bx118.xml,80444/xv14355,5,1,6,12
"Mortar Board Society records",oru_ua116.xml,80444/xv65692,0,5,7,12
"Looney (Jesse) letter to John C. Bond",oru_ca1843oct27.xml,80444/xv25610,4,2,6,12
"Calbreath Family papers",oru_ax193.xml,80444/xv91525,2,1,9,12
"Mills (Abbot Low) papers",oru_ax191.xml,80444/xv65213,6,6,0,12
"Bankson (Russell A.) papers",oru_ax250.xml,80444/xv21841,10,0,2,12
"Workman (Jerome) correspondence",oru_a150.xml,80444/xv47830,9,2,1,12
"Condit (Benson Claire) papers",oru_bx171.xml,80444/xv48394,11,0,1,12
"Hedges (Joseph) letter to William Fouts",oru_ca1852apr12.xml,80444/xv31961,8,3,1,12
"Smith (Richard Shore) correspondence of the First National Bank of Eugene, Oregon",oru_a113.xml,80444/xv45141,4,7,1,12
"Miller (Max) papers",oru_ax605.xml,80444/xv77069,5,4,3,12
"Pioneer Memorial Park Association records",oru_ua089.xml,80444/xv70217,3,5,4,12
"Hukari (Arvo) letters to Dorcas Aurelia DeWitt",oru_a272.xml,80444/xv11581,8,2,1,11
"Clark (Frank J.) papers",oru_ax017.xml,80444/xv79269,1,0,10,11
"Young (Frederic George) letter to Fred Lockley",oru_ca1916june25.xml,80444/xv98184,11,0,0,11
"YMCA (Young Men's Christian Association), World University Service. UO Chapter records",oru_ua111.xml,80444/xv04669,0,5,6,11
"Helck (C. Peter) papers",oru_ax841.xml,80444/xv41094,2,7,2,11
"Clergy and Laity Concerned About Vietnam records",oru_coll323.xml,80444/xv63043,1,5,5,11
"Labor Education and Research Center (LERC) records",oru_ua110.xml,80444/xv72775,0,5,6,11
"Way (Isabel Stewart) papers",oru_ax371.xml,80444/xv21426,3,3,5,11
"Dellenback (John) papers",oru_coll288.xml,80444/xv67321,5,2,4,11
"Purse (Grace Guile) papers",oru_coll033.xml,80444/xv07189,8,2,1,11
"Pioneer Cemetery Plot book",oru_ua074.xml,80444/xv79953,1,5,5,11
"Curry (Thomas Albert, Sr.) papers",oru_ax315.xml,80444/xv51992,5,5,1,11
"R. D. Hume and Company records",oru_bx184.xml,80444/xv73269,5,3,3,11
"Eugene Mall photographs",oru_ph328.xml,80444/xv97147,2,2,7,11
"Cummins (Henry) papers",oru_ax130.xml,80444/xv80136,2,3,6,11
"Judy (Laura) Biography of Caroline Thurman Buffum",oru_cbb864.xml,80444/xv33534,2,6,3,11
"Brownsville Woolen Mill records",oru_bx004.xml,80444/xv86862,3,4,4,11
"Lingenfelter (Williams Evans) correspondence",oru_a070.xml,80444/xv29202,10,1,0,11
"Huddleston (James) papers",oru_a057.xml,80444/xv43515,1,6,4,11
"Atlantic Union Committee records",oru_ua084.xml,80444/xv06027,0,7,4,11
"Bach (Alice) Papers",oru_coll233.xml,80444/xv19846,8,2,1,11
"Garelick (May) Papers",oru_coll235.xml,80444/xv42423,5,5,1,11
"Department of Sociology records",oru_ua073.xml,80444/xv10507,1,5,5,11
"Steffan (Jacqueline) Papers",oru_ax293.xml,80444/xv23954,3,5,3,11
"Morgan (Howard Vincent) papers",oru_ax764.xml,80444/xv10183,2,5,4,11
"Vietnam Feature Service records",oru_bx169.xml,80444/xv64007,2,0,9,11
"Wood (Joseph Warren) journal",oru_a137.xml,80444/xv75268,2,4,5,11
"McBride (Thomas Allen) papers",oru_a291.xml,80444/xv27612,7,4,0,11
"Gamber (John) papers",oru_ax135.xml,80444/xv35443,11,0,0,11
"Steinberger (Justus) papers",oru_a118.xml,80444/xv93228,11,0,0,11
"Waldron (George Clyde) correspondence",oru_a126.xml,80444/xv47857,0,3,8,11
"Stoughton (A. Ella) diary",oru_a119.xml,80444/xv28656,3,0,8,11
"Capital National Bank records",oru_bx198.xml,80444/xv86489,2,1,8,11
"Dyer (Clara Pearl) papers",oru_a198.xml,80444/xv84486,2,0,9,11
"Social Science Club records",oru_ua097.xml,80444/xv86651,0,6,5,11
"Chalmers (Henry) papers",oru_coll241.xml,80444/xv87048,1,3,7,11
"Jacobs (Leonebel) papers",oru_coll402.xml,80444/xv51708,5,1,5,11
"Department of Public Safety records",oru_ua070.xml,80444/xv41882,0,5,6,11
"Abbett (James T.) sermons",oru_a225.xml,80444/xv24200,9,0,2,11
"Dodds (Joseph Leroy) correspondence",oru_a292.xml,80444/xv82501,0,3,8,11
"Muckleston (Edith Wherry) papers",oru_coll264.xml,80444/xv20214,5,5,1,11
"Stangland (Arthur G.) and Artie Stangland (Artie Appleton) papers",oru_ax271.xml,80444/xv51132,10,0,1,11
"Jennings (Dean Southern) papers",oru_ax734.xml,80444/xv33685,5,4,2,11
"Murphy (Francis Hayes) papers",oru_ax074.xml,80444/xv79235,2,5,4,11
"Eliot (Thomas Lamb) papers",oru_a169.xml,80444/xv31314,0,7,4,11
"Steele (Peter) papers",oru_ax829.xml,80444/xv36431,11,0,0,11
"Trimble (Charles Garnet) papers",oru_a174.xml,80444/xv70739,10,0,1,11
"Nathan (Dorothy) Papers",oru_ax414.xml,80444/xv70808,6,2,3,11
"Foreign Student Friendship Foundation records",oru_ua158.xml,80444/xv56713,0,5,6,11
"Kraemer family papers",oru_a161.xml,80444/xv59353,10,0,0,10
"Department of Mathematics records",oru_ua063.xml,80444/xv21472,0,5,5,10
"Pi Beta Women's Fraternity. Pi Chapter records",oru_ua117.xml,80444/xv66140,0,5,5,10
"Danish Brotherhood and Danish Sisterhood Lodges of Junction City, Oregon records",oru_coll409.xml,80444/xv46109,2,3,5,10
"McLelland (Isabel Couper) Papers",oru_ax419.xml,80444/xv47211,5,2,3,10
"Office of Academic Affairs records",oru_ua156.xml,80444/xv92379,0,5,5,10
"Sherwood Placer Mining Co. records",oru_b064.xml,80444/xv81677,10,0,0,10
"Huberman (Leo) papers",oru_ax688.xml,80444/xv53298,1,5,4,10
"Averill (Edgar F.) Papers",oru_ax188.xml,80444/xv91322,4,3,3,10
"Ryder (C. J.) letter to Myron Eells",oru_ca1891june1.xml,80444/xv76223,10,0,0,10
"Groseclose (Elgin) papers",oru_coll102.xml,80444/xv49268,2,1,7,10
"Woodlawn Plywood Co. and the Northern Timber Co. records",oru_bx189.xml,80444/xv86828,9,0,1,10
"High School Debating League records",oru_ua175.xml,80444/xv62506,0,5,5,10
"Knight (Damon) papers",oru_coll340.xml,80444/xv31439,0,9,1,10
"Winger (Roy) papers",oru_ax411.xml,80444/xv38833,9,0,1,10
"Giffen Family Papers",oru_a298.xml,80444/xv54727,10,0,0,10
"Pi Mu Epsilon. Oregon Alpha Chapter records",oru_ua118.xml,80444/xv95742,0,5,5,10
"Day (Clarence Burton) Papers",oru_ax785.xml,80444/xv24296,5,1,4,10
"Alpha Tau Omega. Oregon Gamma Phi Chapter records",oru_ua146.xml,80444/xv84524,2,4,4,10
"Van Scoy (W. T.) letter to Charles Drain",oru_ca1904dec8.xml,80444/xv92932,5,3,2,10
"Robert D. Clark Honors College records",oru_ua144.xml,80444/xv60391,0,6,4,10
"Baldwin (Henry) historical sketches",oru_cbb193.xml,80444/xv61093,3,2,5,10
"Humphrey (George) personal account books",oru_a058.xml,80444/xv05453,3,6,1,10
"Mu Alpha Sinfonia. Psi Chapter records",oru_ua172.xml,80444/xv76266,0,4,6,10
"Wright (Robert Vincent) Papers",oru_ax433.xml,80444/xv68820,6,4,0,10
"Applegate (Jesse) notes and communications on Oregon history",oru_a003.xml,80444/xv18707,0,3,7,10
"Tuck (Ernest Everett) Papers",oru_ax608.xml,80444/xv15748,0,8,2,10
"Gillian (James H.) letter",oru_ca1862dec11.xml,80444/xv42617,2,7,1,10
"Carroll (Harry) papers",oru_ax224.xml,80444/xv21334,8,0,2,10
"Misselwitz (Henry) papers",oru_ax357.xml,80444/xv57098,3,4,3,10
"Huffman (Bertram) papers",oru_ax676.xml,80444/xv36517,7,0,3,10
"Hanzen (Henry M.) papers",oru_ax507.xml,80444/xv73171,0,1,9,10
"McDaniel (Charles T.) papers",oru_a181.xml,80444/xv92654,1,7,2,10
"Gulley (Emmett) papers",oru_ax341.xml,80444/xv97711,0,1,9,10
"Oregon Canning Company records",oru_bx019.xml,80444/xv04000,8,0,2,10
"Hapgood and Company records",oru_bx010.xml,80444/xv92089,0,6,4,10
"Guide to the School of Librarianship records",oru_ua114.xml,80444/xv17843,1,5,4,10
"Koontz Garage and Machine Shop records",oru_bx177.xml,80444/xv71960,7,0,3,10
"Cady (Henry Olin) letters from China",oru_a194.xml,80444/xv27569,0,1,9,10
"Rettie (Dwight Fay) papers",oru_coll167.xml,80444/xv76654,4,4,2,10
"Tinsley (Russell) papers",oru_ax670.xml,80444/xv45425,8,2,0,10
"Gates (John) papers",oru_ax036.xml,80444/xv16821,6,4,0,10
"Shaver (John) journal",oru_a109.xml,80444/xv25588,6,3,1,10
"American Association for Health, Physical Education and Recreation (AAHPER), NW District records",oru_bx113.xml,80444/xv66458,8,0,2,10
"University of Oregon Regents records",oru_ua123.xml,80444/xv17672,0,5,5,10
"Phi Beta Kappa. Oregon Alpha Chapter records",oru_ua108.xml,80444/xv62814,0,5,5,10
"Tolischus (Otto David) papers",oru_ax368.xml,80444/xv25186,2,5,3,10
"Phi Beta. Pi Delta Chapter records",oru_ua100.xml,80444/xv19635,0,5,5,10
"Independent Order of Odd Fellows, Grand Lodge of Oregon records",oru_b073.xml,80444/xv92059,3,5,2,10
"Harding Drug Store records",oru_bx011.xml,80444/xv46362,7,0,3,10
"Aitchison (Clyde Bruce) papers",oru_ax102.xml,80444/xv03634,4,5,1,10
"Columbia Mines Company Records",oru_bx103.xml,80444/xv49940,3,4,2,9
"Hedden Store records",oru_bx016.xml,80444/xv49655,8,0,1,9
"Wells (William Bittle) papers",oru_ax095.xml,80444/xv33524,0,4,5,9
"Alderson (William L.) papers",oru_ax195.xml,80444/xv77365,1,8,0,9
"Leland Land Company records",oru_bx099.xml,80444/xv96859,9,0,0,9
"Parkhust (Ruth Evelyn Morse) and Parkhurst (Austin Flint) papers",oru_coll228.xml,80444/xv23303,6,1,2,9
"Marquis (John Clyde) papers",oru_ax758.xml,80444/xv43914,1,6,2,9
"Preston (William) ledger",oru_b059.xml,80444/xv34893,4,2,3,9
"Clackamas County Probate Court land deed to James Athey",oru_ca1850sept16.xml,80444/xv51419,5,0,4,9
"Administrative Manual records",oru_ua017.xml,80444/xv96511,0,5,4,9
"Kelly-Seavey Family Papers",oru_coll186.xml,80444/xv31486,4,2,3,9
"American Heritage Publishing Co. records",oru_bx160.xml,80444/xv61672,5,0,4,9
"Reiss (Malcolm) papers",oru_coll016.xml,80444/xv42449,9,0,0,9
"Norblad, Jr. (A. Walter) papers",oru_ax455.xml,80444/xv03991,8,0,1,9
"Colman (Hila) Papers",oru_ax750.xml,80444/xv15061,3,5,1,9
"Unknown",oru_ua045.xml,80444/xv88391,0,5,4,9
"Durno (Edwin Russell) papers",oru_ax190.xml,80444/xv93740,3,3,3,9
"Department of Geography records",oru_ua053.xml,80444/xv24188,0,5,4,9
"Faubion (Nina) Papers",oru_ax185.xml,80444/xv68331,6,1,2,9
"Sherman (Sharon) papers",oru_ua215.xml,80444/xv38021,4,5,0,9
"Failing and Beekman Oratory Contest records",oru_ua126.xml,80444/xv44506,0,5,4,9
"Research Committee records",oru_ua129.xml,80444/xv82824,0,5,4,9
"Kenin (Harry M.) recollections",oru_a241.xml,80444/xv70712,9,0,0,9
"Josephine County, Oregon Assessment Roll",oru_b101.xml,80444/xv36621,8,0,1,9
"U.S. District Court, Oregon. Commissioner's record book",oru_b123.xml,80444/xv34951,0,2,7,9
"Department of Linguistics records",oru_ua060.xml,80444/xv20553,0,5,4,9
"Fowler Street houses photographs",oru_ph200_058.xml,80444/xv00359,8,1,0,9
"Abell (Ron) Memoir on Wayne Morse 1968 Re-election",oru_sfm242.xml,80444/xv33996,7,2,0,9
"Sanford J. Greenburger Literary Agency records",oru_ax801.xml,80444/xv97085,0,2,7,9
"Lloyd (William W.) Reminiscences",oru_sfm133.xml,80444/xv22581,2,3,4,9
"MEChA Mujeres records",oru_ua080.xml,80444/xv22793,0,5,4,9
""Mack" letter to "Dear Sister"",oru_ca1863feb22.xml,80444/xv01623,7,0,2,9
"Downs (Darley) Papers",oru_coll111.xml,80444/xv27711,2,5,2,9
"Howard (Elizabeth) Literary Manuscripts",oru_ax663.xml,80444/xv37974,3,6,0,9
"LaDuke (Winona) papers",oru_coll372.xml,80444/xv73406,0,4,5,9
"Commencement records",oru_ua127.xml,80444/xv83819,0,5,4,9
"Fort Yamhill letterpress copy book",oru_b078.xml,80444/xv92727,7,1,1,9
"William McCash Research Collection Relating to his book, Bombs Over Brookings (2005)",oru_coll308.xml,80444/xv36954,5,0,4,9
"Comparative Literature Program records",oru_ua155.xml,80444/xv65823,0,5,4,9
"Greene (Thomas G.) papers",oru_ax254.xml,80444/xv11520,1,3,5,9
"West Coast Mines Company Records",oru_b134.xml,80444/xv45153,2,3,4,9
"Oregon Industrial Accident Commission records",oru_bx060.xml,80444/xv23184,7,0,2,9
"Department of Women's and Gender Studies records",oru_ua121.xml,80444/xv26330,0,5,4,9
"Half Century Club records",oru_ua091.xml,80444/xv85760,0,5,4,9
"Morris (Wistar) letter to Aaron E. Wait",oru_ca1894july31.xml,80444/xv94650,8,1,0,9
"Oregon Marching Band records",oru_ua192.xml,80444/xv64480,3,3,3,9
"O'Connor (Hugh) papers",oru_ax620.xml,80444/xv65631,1,6,2,9
"U.S. District Court documents regarding the Whitman Massacre trial",oru_b121.xml,80444/xv01110,6,0,3,9
"Burkes (DeWitt C.) papers",oru_ax106.xml,80444/xv15682,4,3,2,9
"Johnson (Ebenezer) Papers",oru_ax659.xml,80444/xv85519,2,5,2,9
"Nolen (Barbara) Papers",oru_ax771.xml,80444/xv90643,3,6,0,9
"Department of Biology records",oru_ua038.xml,80444/xv04324,0,5,4,9
"Cochran (John) bill of sale",oru_ca1865july1.xml,80444/xv85391,9,0,0,9
"College of Human Development and Performance records",oru_ua162.xml,80444/xv23330,0,5,4,9
"Appointment of James Blakely",oru_ca1856apr20.xml,80444/xv42288,9,0,0,9
"Moore (Robert) bond",oru_ca1844may8.xml,80444/xv87322,6,2,1,9
"Johnson (Maurice L.) political papers",oru_a274.xml,80444/xv23773,6,0,3,9
"Smith (Delazon) letters to William H. Smith of Rochester, NY",oru_a112.xml,80444/xv79025,6,0,3,9
"Oregon Voice records",oru_ua042.xml,80444/xv99670,9,0,0,9
"Parents and Friends of Gays and Lesbians (PFLAG) of Ashland, Oregon records",oru_coll418.xml,80444/xv07034,4,5,0,9
"Oregon University System (OUS) Academic Council records",oru_ua161.xml,80444/xv71972,0,5,4,9
"Chinnock (James Thornton) papers",oru_ax124.xml,80444/xv64111,3,2,4,9
"Gault (William C.) papers",oru_coll023.xml,80444/xv70565,4,4,1,9
"Hartshorn (Florence M.) photographs",oru_ph203_005.xml,80444/xv88589,2,4,3,9
"Jones (Holway R.) Papers",oru_coll226.xml,80444/xv64988,3,5,1,9
"Redman (Charles M.) letter to Hadley and Owens",oru_ca1862jan23.xml,80444/xv79788,3,2,4,9
"Office of the President: Donald Milton Erb records",oru_ua001_007.xml,80444/xv19711,2,2,5,9
"Department of Anthropology records",oru_ua032.xml,80444/xv57754,0,5,4,9
"Barry (Iris Thorpe) papers",oru_ax227.xml,80444/xv82629,0,6,3,9
"University Film Society records",oru_ua081.xml,80444/xv78283,0,5,4,9
"Condon (Miriam L.) papers",oru_a237.xml,80444/xv63479,0,1,8,9
"Nevin (Evelyn C.) Papers",oru_ax817.xml,80444/xv80727,2,2,5,9
"Mary Cleveland (Schooner) bill of lading",oru_ca1861oct7.xml,80444/xv02313,1,3,5,9
"Nighswander (Francis) papers",oru_a091.xml,80444/xv59514,6,2,1,9
"Hoyt (Vance) papers",oru_ax312.xml,80444/xv91995,2,6,1,9
"Joseph (Nannine) Papers",oru_ax821.xml,80444/xv78332,2,3,4,9
"Bratton (Helen) Papers",oru_ax614.xml,80444/xv38997,4,4,1,9
"Love Without Lovers play script",oru_coll435.xml,80444/xv34625,4,4,1,9
"McCollach (C. C.) letters and scrapbook",oru_a075.xml,80444/xv57070,6,0,3,9
"Elarth (Harold Hanne) papers",oru_ax286.xml,80444/xv09127,5,0,4,9
"The University Teaching and Learning Center records",oru_ua159.xml,80444/xv33087,0,5,4,9
"Department of Psychology records",oru_ua069.xml,80444/xv03555,0,5,4,9
"Student orations",oru_ua130.xml,80444/xv17639,0,5,4,9
"Russell (Silas) diary",oru_a283.xml,80444/xv83551,0,2,7,9
"Guide to the Museum of Natural and Cultural History records",oru_ua119.xml,80444/xv07226,0,5,4,9
"Moment (Samuel) Papers",oru_coll193.xml,80444/xv66698,0,4,4,8
"Biddle (Henry J.) papers",oru_ax645.xml,80444/xv30789,5,1,2,8
"Faricy (William T.) papers",oru_coll030.xml,80444/xv91387,1,3,4,8
"Bill Devall papers",oru_coll375.xml,80444/xv48385,8,0,0,8
"Phelps (Naomi) papers",oru_ax222.xml,80444/xv15752,2,5,1,8
"Nebel (Frederick) papers",oru_ax355.xml,80444/xv62301,3,0,5,8
"Portland Lone Fir Cemetary Co. records",oru_b147.xml,80444/xv84106,5,2,1,8
"Darst (Paul) diary",oru_a026.xml,80444/xv72329,6,2,0,8
"Thompson (Robert) letter to William and Thomas Stephens",oru_ca1852apr14.xml,80444/xv06784,2,3,3,8
"Brogan (Philip) papers",oru_coll454.xml,80444/xv16955,3,0,5,8
"Orchesis records",oru_ua176.xml,80444/xv18478,0,4,4,8
"Horsefeldt (Alva Arthur) papers",oru_ax050.xml,80444/xv70581,5,3,0,8
"Parents and Friends of Gays and Lesbians (PFLAG) of Grants Pass, Oregon records",oru_coll417.xml,80444/xv14459,2,3,3,8
"McCall (Virginia Nielsen) papers",oru_ax348.xml,80444/xv45620,4,1,3,8
"Information Technology records",oru_ua164.xml,80444/xv22830,0,4,4,8
"Geary (Edward R.) letter to John McLellan",oru_ca1851apr17.xml,80444/xv10299,2,6,0,8
"Redington (John W.) papers",oru_ax093.xml,80444/xv97079,8,0,0,8
"Angell (Homer) papers",oru_ax001.xml,80444/xv19897,8,0,0,8
"Howe family papers",oru_ax051.xml,80444/xv49893,1,2,5,8
"Wolcott-Gibbs family papers",oru_ax277.xml,80444/xv20178,0,3,5,8
"Tugman (William M.) papers",oru_ax607.xml,80444/xv02383,2,6,0,8
"Holmes (Robert Denison) papers",oru_ax048.xml,80444/xv50442,0,4,4,8
"Sisley (Becky) faculty papers",oru_ua230.xml,80444/xv31414,6,2,0,8
"Hanson (Irene Forsythe) papers",oru_coll028.xml,80444/xv30790,3,3,2,8
"Starkweather (Harvey Gordon) papers",oru_cbst28h.xml,80444/xv50329,4,0,4,8
"Johnson (Avery) papers",oru_ax820.xml,80444/xv13943,1,5,2,8
"Eugene Fruit Growers Association records",oru_coll413.xml,80444/xv90682,6,0,2,8
"Mu Phi Epsilon. Nu Chapter records",oru_ua168.xml,80444/xv31634,0,4,4,8
"Packwood (William H.) papers",oru_ca1915jan24.xml,80444/xv59585,8,0,0,8
"League of Women Voters of Oregon Records",oru_bx173.xml,80444/xv81061,1,1,6,8
"Blocklinger (Peggy O'More) Papers",oru_ax297.xml,80444/xv74228,2,5,1,8
"Hirsch (Harold S.) Interviews",oru_coll426.xml,80444/xv10092,3,5,0,8
"Wetjen (Albert Richard) papers",oru_a130.xml,80444/xv15991,2,6,0,8
"Long (Eleanor D.) papers",oru_coll219.xml,80444/xv94366,2,3,3,8
"McCutcheon (John) cartoons",oru_a233.xml,80444/xv98452,6,0,2,8
"Barclay (Forbes) correspondence",oru_a008.xml,80444/xv07687,1,7,0,8
"Combellack (Frederick Malcolm) faculty papers",oru_ua226.xml,80444/xv32788,6,2,0,8
"Crouch (Washington H.) commission to captain",oru_ca1856apr18.xml,80444/xv20666,3,0,5,8
"Loomis (Daniel Pittinger) papers",oru_ax413.xml,80444/xv75897,8,0,0,8
"Beta Phi Mu. University of Oregon Chapter records",oru_ua134.xml,80444/xv56536,0,4,4,8
"University of Oregon Medical, Nursing, and Dental Schools records",oru_ua184.xml,80444/xv73706,2,1,5,8
"Nesmith (James Willis) correspondence",oru_sfm186.xml,80444/xv73730,0,8,0,8
"Hayes (Barbara M.) biography of John David Hayes",oru_a296.xml,80444/xv91098,8,0,0,8
"Umpqua County, Or., Elkton Precinct records",oru_ca1855june4.xml,80444/xv97326,8,0,0,8
"Oregon Commonwealth Federation Records",oru_bx033.xml,80444/xv09991,0,8,0,8
"Wilson (Hubert Wilson) papers",oru_a209.xml,80444/xv89865,5,3,0,8
"Institute of Molecular Biology records",oru_ua169.xml,80444/xv83251,0,4,4,8
"Wheeler (Howard Duryee) autobiography",oru_a197.xml,80444/xv01693,0,3,5,8
"Dunn (F. B.) General Store ledger and day book",oru_b022.xml,80444/xv78167,0,0,8,8
"Bean (Harold C.) papers",oru_coll400.xml,80444/xv19784,0,2,6,8
"Cleator (Frederick William) papers",oru_ax013.xml,80444/xv75931,2,3,3,8
"Campbell (John F.) letter",oru_ca1863aug6.xml,80444/xv13238,6,0,2,8
"Community Action Program records",oru_ua140.xml,80444/xv11569,0,4,4,8
"Staggs (Ira) papers",oru_ax317.xml,80444/xv95556,0,1,7,8
"Fenton (Katherine Lucas) scrapbook",oru_caf367.xml,80444/xv03814,2,4,2,8
"George (Melvin Clarke) papers",oru_ax136.xml,80444/xv73837,4,1,3,8
"Condon (Thomas) papers",oru_a022.xml,80444/xv65438,3,5,0,8
"Asian Studies Program records",oru_ua138.xml,80444/xv93786,0,4,4,8
"Larcom (Lucy) letter",oru_ca1884sept15.xml,80444/xv73791,3,0,5,8
"Pennoyer (Sylvester) scrapbook",oru_cap834.xml,80444/xv70068,5,0,3,8
"Scherf (Margaret) Papers",oru_ax666.xml,80444/xv67731,6,1,1,8
"Clarke (James Freeman) papers",oru_ca1876may8.xml,80444/xv77200,8,0,0,8
"Kafoury (Gretchen) papers",oru_coll353.xml,80444/xv47219,2,1,5,8
"Department of Foreign Languages records",oru_ua195.xml,80444/xv28417,7,0,0,7
"Fuecker (Fred Michael) papers",oru_ax514.xml,80444/xv85681,3,3,1,7
"First Christian Church (Albany, OR), Christian Endeavor Society records",oru_b003.xml,80444/xv87789,7,0,0,7
"Bendick (Robert) Papers",oru_ax505.xml,80444/xv74908,2,4,1,7
"Villard House account book",oru_b126.xml,80444/xv11239,4,3,0,7
"J. E. Haseltine and Co. records",oru_bx193.xml,80444/xv43588,5,0,2,7
"Hermann (Binger) letter",oru_ca1886jan29.xml,80444/xv26876,2,0,5,7
"Thebaud (Joseph V.) papers",oru_a258.xml,80444/xv60534,7,0,0,7
"International Military Tribunal for Far East records of the Sadao Araki military tribunal",oru_bx084.xml,80444/xv93579,0,2,5,7
"Savery (Constance Winifred) papers",oru_a309.xml,80444/xv39859,7,0,0,7
"Olympia Light and Power Co. records",oru_bx089.xml,80444/xv69332,0,3,4,7
"Baker, Fentress & Company records",oru_bx093.xml,80444/xv13217,4,0,3,7
"Denny (Owen Nickerson) correspondence",oru_a189.xml,80444/xv73397,3,2,2,7
"J.W. Sweeney Construction Company photographs",oru_ph317.xml,80444/xv56448,0,2,5,7
"Preston (John B.) letter to Daniel Lownsdale",oru_ca1852dec29.xml,80444/xv81594,0,0,7,7
"Mahaffie (Charles) Interstate Commerce Commission memoranda",oru_ax416.xml,80444/xv09042,1,3,3,7
"Livermore (Lot) papers",oru_coll324.xml,80444/xv65383,3,3,1,7
"Rough and Ready Quartz Mining Company Records",oru_b060.xml,80444/xv79351,0,3,4,7
"Burnett (Josiah A.) papers",oru_a014.xml,80444/xv20501,3,3,1,7
"Odell (William Holman) letter",oru_ca1871apr28.xml,80444/xv41925,1,3,3,7
"KOAC Radio Station (University of Oregon) records",oru_ua193.xml,80444/xv93356,6,1,0,7
"Sachs Bros. and Reames Bros. accounts ledger",oru_b142.xml,80444/xv78469,0,4,3,7
"Loyal Legion of Loggers and Lumbermen records",oru_bx040.xml,80444/xv95785,0,7,0,7
"Taylor Family papers",oru_a121.xml,80444/xv56096,0,5,2,7
"Douglas (Wallace Ulysses) papers",oru_ax522.xml,80444/xv62243,0,2,5,7
"Oregon Infantry. 1st Regiment, Company B records",oru_bx037.xml,80444/xv87478,7,0,0,7
"Esterly (Henry Minor) papers",oru_ax684.xml,80444/xv67196,6,0,1,7
"Polhemus (James Suydam) papers",oru_ax300.xml,80444/xv99456,5,2,0,7
"Portland Reporter records",oru_coll405.xml,80444/xv38079,3,0,4,7
"Register-Guard records",oru_bx007.xml,80444/xv32446,3,0,4,7
"MacPherson (Hector) papers",oru_ax156.xml,80444/xv03845,5,1,1,7
"McClure (John) land sale agreement",oru_ca1853oct27.xml,80444/xv53744,0,3,4,7
"Blackman (Henry) bond of indemnity",oru_ca1887may20.xml,80444/xv38812,0,3,4,7
"Win McCormack collection on Rajneeshpuram",oru_coll406.xml,80444/xv54486,4,0,3,7
"Daugherty (Charles Michael) Papers",oru_ax748.xml,80444/xv55417,1,4,2,7
"Belsky (Joy) papers",oru_coll332.xml,80444/xv14651,0,2,5,7
"Dwiggins (Clare Victor) papers",oru_ax526.xml,80444/xv28155,4,3,0,7
"Roblin (Charles E.) correspondence",oru_ax166.xml,80444/xv13150,6,1,0,7
"Carlyle (Elizabeth) letters from China",oru_a165.xml,80444/xv90249,6,1,0,7
"Bulfinch (Charles F.) papers",oru_a252.xml,80444/xv21554,2,2,3,7
"Dixon (Algernon Cyrus) Papers",oru_ax196.xml,80444/xv56779,0,2,5,7
"Eugene Shakespeare Club records",oru_coll227.xml,80444/xv23968,0,2,5,7
"Nye (Laurence E.) papers",oru_ax569.xml,80444/xv06686,7,0,0,7
"Stern (Philip Van Doren) papers",oru_ax803.xml,80444/xv00030,6,1,0,7
"Teagarden (Lyrel) Papers",oru_ax749.xml,80444/xv70120,1,6,0,7
"United States Spruce Production Corporation, Spruce Products Division records",oru_bx088.xml,80444/xv84082,3,3,1,7
"Dolph (Joseph N.) letter to J. D. Lee",oru_ca1884may1.xml,80444/xv12167,3,2,2,7
"Abilene and Southern Railway Co. Defendant records",oru_bx153.xml,80444/xv62054,0,1,6,7
"Pacific Stationery and Print Company records",oru_bx021.xml,80444/xv12612,3,0,4,7
"Geiger (William) letters",oru_a041.xml,80444/xv61734,0,2,5,7
"Speare (Dorothy) papers",oru_ax366.xml,80444/xv91101,0,1,6,7
"Kleinholz (George) collection of Bonus Expeditionary Force ephemera and artifacts",oru_a158.xml,80444/xv51226,2,0,5,7
"Brownsville, Oregon town council records",oru_b099.xml,80444/xv41729,5,2,0,7
"Letter In Memory of William M. Turner",oru_cbt859.xml,80444/xv81292,3,1,3,7
"Johnson (H.) Journal",oru_sfm067.xml,80444/xv57122,0,2,5,7
"Nicklin (John H.) Letter",oru_ca1851feb25.xml,80444/xv38663,5,2,0,7
"Norblad (Albin Walter) papers",oru_ax680.xml,80444/xv84472,1,3,3,7
"Drake (June D.) and Drake Brothers Photographs",oru_ph031.xml,80444/xv40798,0,0,7,7
"Baker (Della M.) Reminiscences",oru_cbb172.xml,80444/xv09591,0,3,4,7
"Shelton (Albert L.) papers",oru_coll053.xml,80444/xv63622,2,2,3,7
"Wagner (Jacob) legislative correspondence",oru_a182.xml,80444/xv37493,3,4,0,7
"Mazamas records",oru_coll403.xml,80444/xv20092,7,0,0,7
"Handsaker (Samuel) papers",oru_cbh192a.xml,80444/xv56329,6,1,0,7
"Trimble (Jacquelyn) papers",oru_ax669.xml,80444/xv17306,3,3,0,6
"Duniway (Abigail Scott) letter to Barbara M. Booth",oru_ca1914apr11.xml,80444/xv61572,3,0,3,6
"James (Cheryl D.) Defense Committee papers",oru_a307.xml,80444/xv03488,5,0,1,6
"Schaper (Edward A.) Papers",oru_coll218.xml,80444/xv15751,1,3,2,6
"Watt (Ahio Scott) reminiscences",oru_cbw34.xml,80444/xv24334,0,2,4,6
"Parkyn (Herbert) letters to Robert M. Brereton",oru_ca1907jan11.xml,80444/xv92236,3,2,1,6
"Mills (Abbot Low Jr.) papers",oru_ax205.xml,80444/xv84844,5,1,0,6
"Cauthorn (James D.) Journal",oru_a017.xml,80444/xv25634,5,1,0,6
"Chublarian (Rouben) Papers",oru_coll130.xml,80444/xv04118,1,2,3,6
"University of Oregon Basketball Exhibition Tour of the Far East records",oru_ua202.xml,80444/xv88018,6,0,0,6
"Applegate (Alex M.) diary",oru_a004.xml,80444/xv05322,2,1,3,6
"Taylor (Albert M.) papers",oru_ax716.xml,80444/xv62939,4,2,0,6
"Mitchell (John Hipple) letter",oru_ca1893jan31.xml,80444/xv30133,2,3,1,6
"Office of the President: Victor Pierpont Morris (acting) and O. Meredith Wilson records",oru_ua001_009.xml,80444/xv55895,0,0,6,6
"Bend Publishing Co. records",oru_b012.xml,80444/xv22857,0,0,6,6
"University Library Committee records",oru_ua214.xml,80444/xv74948,0,0,6,6
"Ankeny (Levi) letter to Joseph N. Teal",oru_ca1904july15.xml,80444/xv34384,5,0,1,6
"Goldstone (Nathan C.) Papers",oru_ax390.xml,80444/xv52004,0,2,4,6
"Allen Family papers",oru_ax009.xml,80444/xv22592,0,2,4,6
"Castor (Henry) papers",oru_ax847.xml,80444/xv61627,3,1,2,6
"Savage (Carlton) papers",oru_coll216.xml,80444/xv88739,0,5,1,6
"School of Architecture and Allied Arts (AAA) records",oru_ua033.xml,80444/xv66732,0,2,4,6
"Clarke (Samuel Asahel) papers",oru_cbc556.xml,80444/xv10107,5,0,1,6
"Gordon (Wyona Eliza Surfus) Papers",oru_cbg659.xml,80444/xv10609,3,0,3,6
"Congdon (Herbert W.) papers",oru_ax593.xml,80444/xv74133,1,4,1,6
"Glen (Charles) Sutherlin, Oregon and vicinity photograph albums",oru_ph203_030.xml,80444/xv90989,0,1,5,6
"Stein (HarveÃÅ) Papers",oru_ax729.xml,80444/xv91330,1,3,2,6
"Sweetser (Carrie) papers",oru_coll237.xml,80444/xv59289,0,2,4,6
"Department of Military Science and ROTC program records",oru_ua064.xml,80444/xv39035,3,3,0,6
"Crawford (William James) Papers",oru_ax636.xml,80444/xv39337,0,2,4,6
"Saylor (Frederick H.) papers",oru_casa99.xml,80444/xv76605,0,3,3,6
"Jewett (Garry W.) papers",oru_ax147.xml,80444/xv94400,3,2,1,6
"Quayle (William Alfred) selected papers",oru_coll006.xml,80444/xv81494,2,1,3,6
"Hayward (Nancy) Selected Papers of",oru_coll007.xml,80444/xv78118,3,2,1,6
"Rostel (Carl Gotthilf Berthold) papers",oru_ax086.xml,80444/xv72595,6,0,0,6
"Hawks (William) and Canfield (George S.) real estate correspondence",oru_bx013.xml,80444/xv93127,2,4,0,6
"Willamette Cattle Company correspondence and receipts",oru_b081.xml,80444/xv52716,1,1,4,6
"Oregon AFL-CIO records",oru_bx165.xml,80444/xv01766,0,1,5,6
"Dresser (Robert B.) papers",oru_ax816.xml,80444/xv88720,5,0,1,6
"Waller (Alvin F.) letter",oru_ca1850sept11.xml,80444/xv11273,4,0,2,6
"Mary Cleveland (Schooner) bill of lading",oru_ca1863may6.xml,80444/xv40002,0,4,2,6
"Coffin (Stephen) deed",oru_ca1850june17.xml,80444/xv18572,3,1,2,6
"Toothaker (Frank M.) Papers",oru_ax217.xml,80444/xv86546,6,0,0,6
"Buell (Robert L.) papers",oru_ax471.xml,80444/xv31231,4,0,2,6
"Coos Bay and Coquille Transportation Co. records",oru_b111.xml,80444/xv77017,0,0,6,6
"Lane County Farmers Union Cooperative Warehouse Co. records",oru_bx017.xml,80444/xv69082,0,2,4,6
"Hembree (W. Harry) Papers",oru_cbh371.xml,80444/xv76273,2,2,2,6
"Barrett (Willis Chapel) papers",oru_ax115.xml,80444/xv49411,4,2,0,6
"Hill (Margaret) papers",oru_coll425.xml,80444/xv07937,5,0,1,6
"Sheldon (John B.) blacksmith account book",oru_b063.xml,80444/xv28109,4,1,1,6
"California State Telegraph Company. Toll House Station (Ashland, Oregon) records",oru_b015.xml,80444/xv82943,3,1,2,6
"Dunagan (Willis) diaries and legal papers",oru_ax133.xml,80444/xv75381,0,4,2,6
"Cheney (Monona) Papers",oru_ax275.xml,80444/xv46864,0,2,4,6
"Oregon Capitol Reconstruction Commission records",oru_a224.xml,80444/xv23635,6,0,0,6
"Seely (Nellie "Nell" Miller) papers",oru_ax585.xml,80444/xv08654,0,1,5,6
"Young (Stanley Paul) papers",oru_ax295.xml,80444/xv73892,3,1,2,6
"Wilhelm (Kate) papers",oru_coll464.xml,80444/xv40197,0,6,0,6
"Machetanz (Sara Burleson) papers",oru_a219.xml,80444/xv39344,2,3,1,6
"Tappan (David S. and Luella R.) Papers",oru_coll103.xml,80444/xv96455,3,0,3,6
"Nickless (Will) Papers",oru_ax863.xml,80444/xv03432,2,2,2,6
"Herman (Binger) papers",oru_a199.xml,80444/xv42471,4,0,2,6
"Socialist Party of Albany (Or) Local No. 2 records",oru_b154.xml,80444/xv26742,0,0,6,6
"Johnson-Bushnell family papers",oru_coll171.xml,80444/xv20880,1,2,3,6
"Deming (Edwin) papers",oru_ax595.xml,80444/xv58639,5,1,0,6
"Fort Klamath Creamery Co. records",oru_b027.xml,80444/xv12045,1,1,4,6
"Hedden Family papers",oru_coll221.xml,80444/xv06832,2,0,4,6
"Willamette Greenway Advisory Committee records",oru_coll222.xml,80444/xv70632,6,0,0,6
"Deady (Matthew Paul) letter to Melvin C. George",oru_ca1884apr11.xml,80444/xv92367,3,1,2,6
"Levinger (Elma Ehlrich) Papers",oru_ax309.xml,80444/xv79016,0,1,4,5
"Distinguished Service Awards and Honorary Degrees Committee records",oru_ua055.xml,80444/xv71478,5,0,0,5
"Cavanah (Frances) Papers",oru_ax544.xml,80444/xv33186,4,1,0,5
"Smith (Fabritus) diaries",oru_a191.xml,80444/xv24249,0,1,4,5
"Baldwin (Annette) letters",oru_a144.xml,80444/xv30255,2,1,2,5
"Streiff (Albert) papers",oru_ax563.xml,80444/xv39529,0,0,5,5
"Evans (S.D., Mrs.) Account",oru_cbev16.xml,80444/xv35241,0,2,3,5
"Searles (Lin J.) papers",oru_coll075.xml,80444/xv31411,3,0,2,5
"Gorman (Martin W.) papers",oru_coll169.xml,80444/xv01034,3,1,1,5
"Soronowsky (Ze'ev) papers",oru_coll395.xml,80444/xv39129,0,3,2,5
"Savage family correspondence",oru_coll396.xml,80444/xv85244,2,2,1,5
"Apperson (John T.) correspondence",oru_a002.xml,80444/xv64151,1,4,0,5
"Wartime Posters collection",oru_coll467.xml,80444/xv35211,1,3,1,5
"Bruckart (John Ray) papers",oru_coll059.xml,80444/xv32851,1,0,4,5
"Oregon. Statewide Relief Council records",oru_b107.xml,80444/xv94903,0,0,5,5
"Corey (Ray Howard) scrapbooks",oru_ph267.xml,80444/xv61828,0,3,2,5
"Spears (C. Eleanor) papers",oru_coll096.xml,80444/xv95159,4,0,1,5
"Independent Order of Odd Fellows, Blue Mountain Lodge of Canyon City, Or. correspondence",oru_ca1873jan30.xml,80444/xv65594,0,0,5,5
"Sutherland (John) papers",oru_cbsu84.xml,80444/xv10961,2,0,3,5
"Disque, Jr. (Brice P.) papers",oru_ax291.xml,80444/xv36822,0,2,3,5
"Grover (Lafayette) diary",oru_a042.xml,80444/xv51208,1,4,0,5
"Emeny (Brooks) correspondence",oru_a033.xml,80444/xv19094,5,0,0,5
"Kearny (Philip) diary",oru_a065.xml,80444/xv61965,5,0,0,5
"Nicolai Investment Co. records",oru_bx029.xml,80444/xv24926,0,2,3,5
"Rockey, Cady Family Missionary papers",oru_coll460.xml,80444/xv96432,0,1,4,5
"Fetter (Elizabeth Head) papers",oru_ax743.xml,80444/xv16271,3,2,0,5
"Burch (Albert) papers",oru_a171.xml,80444/xv52862,2,3,0,5
"Afro-American Institute records",oru_sfm244.xml,80444/xv78717,5,0,0,5
"Carkin (John H.) papers",oru_ax600.xml,80444/xv71786,2,1,2,5
"Glisan (Rodney) letter to A. B. Hallock",oru_ca1860jan17.xml,80444/xv48175,3,1,1,5
"Goodsell (Henry Guy) sermons",oru_ax037.xml,80444/xv46331,2,2,1,5
"Santiam Gold and Silver Mining Company stock certificate",oru_ca1865nov29.xml,80444/xv76986,5,0,0,5
"Sugar Pine Mill and Fixture Company records",oru_b069.xml,80444/xv60781,2,0,3,5
"Cooper (Lewis C.) deed",oru_ca1858mar10.xml,80444/xv63369,0,2,3,5
"DeNeffe (Frederick) papers",oru_ax673.xml,80444/xv57711,0,3,2,5
"Griffin & Stouffer accout book",oru_b139.xml,80444/xv91940,5,0,0,5
"Burns, Jr. (Tom) papers",oru_coll352.xml,80444/xv31176,0,0,5,5
"Kathrine Beck papers",oru_coll414.xml,80444/xv87158,0,5,0,5
"Lawrence (Edna) papers",oru_a205.xml,80444/xv74963,3,2,0,5
"Wertenbaker (Charles) papers",oru_ax469.xml,80444/xv17694,0,3,2,5
"Oregon Folk League records",oru_b096.xml,80444/xv14865,0,0,5,5
"Charter Day records",oru_ua016.xml,80444/xv04412,0,0,5,5
"Mott (James Wheaton) papers",oru_ax077.xml,80444/xv86001,3,1,1,5
"Pacific Cooperative Poultry Producers and Pacific Egg Producers records",oru_bx111.xml,80444/xv16146,3,0,2,5
"Kalez (Jay) papers",oru_ax404.xml,80444/xv48611,1,0,4,5
"Department of History records",oru_ua056.xml,80444/xv44094,5,0,0,5
"Everding and Farrell Co. records",oru_bx009.xml,80444/xv50921,1,0,4,5
"Estes (Amy) music manuscript",oru_f784es85.xml,80444/xv63769,1,2,2,5
"Curren (Polly) Papers",oru_ax871.xml,80444/xv69440,1,2,2,5
"Patrick Lumber Company sales books",oru_bx022.xml,80444/xv25195,5,0,0,5
"Department of Physics records",oru_ua171.xml,80444/xv77114,0,5,0,5
"Kiddle (Clyde L.) papers",oru_a288.xml,80444/xv30584,4,0,1,5
"U.S. General Land Office notice to settlers",oru_ca1853apr30.xml,80444/xv76828,0,0,5,5
"Alderman (Lewis R.) papers",oru_ax473.xml,80444/xv41970,3,0,2,5
"Woltman (Frederick Enos) papers",oru_ax768.xml,80444/xv04919,0,2,3,5
"Perry Family correspondence",oru_coll337.xml,80444/xv45816,2,0,3,5
"Dyar (Ralph) papers",oru_ax255.xml,80444/xv05810,2,1,2,5
"Geer (Theodore T.) letter to Fred T. Merrill and Company",oru_ca1899feb14.xml,80444/xv02117,0,2,3,5
"Dunn (George Washington) legislative correspondence",oru_ax030.xml,80444/xv31002,5,0,0,5
"Kyne (Peter Bernard) war correspondence",oru_coll398.xml,80444/xv56988,5,0,0,5
"Knight (Paul) papers",oru_ax822.xml,80444/xv86477,5,0,0,5
"American Association of University Women. Eugene-Lane Branch records.",oru_coll330.xml,80444/xv76034,0,1,4,5
"Grover (A. J.) letter to Edwin Beebe",oru_ca1863apr18.xml,80444/xv56079,5,0,0,5
"Patton (Lowell) papers",oru_ax481.xml,80444/xv03823,3,2,0,5
"Fort Hoskins Army Post records",oru_bx087.xml,80444/xv56729,0,0,5,5
"Stern (Henry R.) papers",oru_ax637.xml,80444/xv29055,0,1,4,5
"Appenzeller (Alice R.) correspondence",oru_coll389.xml,80444/xv84503,1,3,1,5
"Hillcrest Orchard records",oru_coll355.xml,80444/xv20462,0,2,3,5
"Jennings (Berryman) letter to "Commandant"",oru_ca1848feb8.xml,80444/xv87020,0,0,5,5
"Segar (Roscoe W.) papers",oru_coll247.xml,80444/xv52514,0,5,0,5
"Cykler (Emanuel) papers",oru_f780c9.xml,80444/xv53381,0,0,5,5
"Morris family photographs",oru_ph333.xml,80444/xv66025,0,0,5,5
"Smith (Dennis) letters from Peking, China",oru_ax422.xml,80444/xv77954,2,1,2,5
"McAlister (Harry L.) mementos of the Spanish-American War, Philippines campaign",oru_cam119.xml,80444/xv24600,5,0,0,5
"Gard (Jesse Jewell) papers",oru_ax339.xml,80444/xv78652,2,1,2,5
"Earl Kilpatrick papers",oru_ua189.xml,80444/xv02722,0,4,1,5
"Etter (Orval) papers",oru_coll338.xml,80444/xv84011,0,4,1,5
"Victor (Frances Fuller) letter to Lenore E. Gale",oru_ca1900sept11.xml,80444/xv22009,1,2,2,5
"People's Transportation Co. records",oru_bx039.xml,80444/xv51248,0,0,5,5
"Eberle (Irmengarde) Papers",oru_ax459.xml,80444/xv38324,3,1,1,5
"Round Table Club of Eugene Records",oru_coll271.xml,80444/xv60205,2,1,2,5
"La Creole Academy records",oru_ca1892dec13.xml,80444/xv38043,0,0,5,5
"Oregon Federation of Women's Clubs records",oru_bx174.xml,80444/xv27432,0,5,0,5
"Morrissette (Pat Victor) notes on a trip to Hawaii",oru_a083.xml,80444/xv90390,2,1,1,4
"Young (Joseph) prisoner of war diaries",oru_a305.xml,80444/xv01266,0,2,2,4
"Applegate Quartz Mining Co. account book, time roll, and check book",oru_b010.xml,80444/xv47146,0,0,4,4
"Van Wagonen (Maria) collection of letters of J. R. Young and C. Scriber, 24th Regiment, New York Volunteers",oru_a125.xml,80444/xv68182,0,1,3,4
"Cornett (Marshall) papers",oru_ax576.xml,80444/xv99960,1,0,3,4
"Terry (Chester N.) letter",oru_ca1873mar19.xml,80444/xv65698,0,0,4,4
"Guernsey-Newton Co. records",oru_b029.xml,80444/xv71942,0,0,4,4
"Shindler (Gabriel) letter to G. H. Collier",oru_ca1891june10.xml,80444/xv72277,0,0,4,4
"Dye (Eva Emery) letter",oru_ca1909may8.xml,80444/xv62777,0,1,3,4
"Prescott (Nettie) scrapbooks of theater programs",oru_cap923.xml,80444/xv01101,0,3,1,4
"Independent Order of Odd-Fellows, Spencer Butte Lodge No. 9 records",oru_coll379.xml,80444/xv10345,4,0,0,4
"Oregon. State Defense Council. Lane County, District no. 10, Eugene records",oru_bx036.xml,80444/xv57989,1,0,3,4
"National Hells Canyon Association. Washington, D.C. Office records",oru_bx042.xml,80444/xv29275,0,0,4,4
"Holt (Julia A.) Letters",oru_sfm113.xml,80444/xv89953,0,1,3,4
"Olsen (Theodore V.) Papers",oru_ax393.xml,80444/xv13653,0,3,1,4
"Columbia Transportation Company records",oru_bx094.xml,80444/xv99124,2,0,2,4
"Yakima Amusement Company records",oru_bx031.xml,80444/xv95968,0,0,4,4
"Felsheim (Louis) papers",oru_ax232.xml,80444/xv38500,2,2,0,4
"Willamette University warrants for service as teachers",oru_ca1863july16b.xml,80444/xv89624,0,0,4,4
"Royal (Denise) Papers",oru_ax721.xml,80444/xv34555,0,4,0,4
"Geer (Theodore Thurston) receipt",oru_ca1898apr28.xml,80444/xv75683,0,2,2,4
"Lockley (Fred) letter to Charles S. Jackson",oru_ca1916june20.xml,80444/xv82614,0,0,4,4
"Haefner (Henry E.) Papers",oru_cbh118a.xml,80444/xv91663,2,2,0,4
"Bullfrog Information Service records",oru_bx166.xml,80444/xv87268,0,4,0,4
"Walling (Jesse D.) papers",oru_a127.xml,80444/xv02658,0,2,2,4
"Spangler (Harrison) papers",oru_ax399.xml,80444/xv72573,0,0,4,4
"MacDonald (William) letter",oru_ca1900apr30.xml,80444/xv31765,0,3,1,4
"Gramatky (Hardie) Papers",oru_ax438.xml,80444/xv32971,2,2,0,4
"Friendly (Leonard) collection of American popular music",oru_bx104.xml,80444/xv20269,0,0,4,4
"Hallock (A.B.) Journal",oru_a035.xml,80444/xv12738,0,2,2,4
"U. S. National Recovery Administration. Graphic Arts Regional Code Authority, Oregon records",oru_ax603.xml,80444/xv43087,0,2,2,4
"Baillie (Hugh) papers",oru_ax631.xml,80444/xv21093,0,1,3,4
"Putnam (Lemuel P.) papers",oru_ax586.xml,80444/xv31072,0,1,3,4
"Baldinger (Wallace) papers",oru_ua204.xml,80444/xv92327,3,1,0,4
"Ball (William David) papers",oru_ax704.xml,80444/xv91268,0,0,4,4
"McDonald (James) letter to J. S. Smith",oru_ca1870jan29.xml,80444/xv29205,4,0,0,4
"Laurgaard (Olaf) papers",oru_ax018.xml,80444/xv23315,0,2,2,4
"Finerty (John) papers",oru_ax525.xml,80444/xv37875,2,2,0,4
"Riis (John) letter to Charles S. Jackson",oru_ca1914july14.xml,80444/xv60485,3,1,0,4
"Snow (Myra) papers",oru_a186.xml,80444/xv51652,0,2,2,4
"Reik (Elsie I.) papers",oru_a166.xml,80444/xv20531,1,0,3,4
"Thiessen (Henry) diary and account book",oru_a253.xml,80444/xv01336,1,1,2,4
"Marple (Warren H.) papers",oru_ax746.xml,80444/xv13470,1,1,2,4
"Coe (Urling Campbell) papers",oru_a193.xml,80444/xv68441,3,1,0,4
"Linn County Fire Patrol Association records",oru_b133.xml,80444/xv52597,0,2,2,4
"Dispatch Line bill of lading",oru_ca1872mar1.xml,80444/xv36416,4,0,0,4
"Sconce (Haywood) papers",oru_ax363.xml,80444/xv42956,2,1,1,4
"Ireland (Asher) field diaries",oru_a060.xml,80444/xv35287,2,0,2,4
"Pacific Telephone and Telegraph Company fundamental plan survey",oru_a304.xml,80444/xv14834,4,0,0,4
"Brooks (Anne Tedlock) Papers",oru_ax107.xml,80444/xv31822,2,1,1,4
"Green (Bernie) papers",oru_coll004.xml,80444/xv54693,0,3,1,4
"Semon (Henry) legislative correspondence",oru_ax485.xml,80444/xv90792,0,0,4,4
"Eastham (Edward L.) papers",oru_a160.xml,80444/xv41476,4,0,0,4
"Lane County Business Council minutes",oru_ca1876dec12.xml,80444/xv96029,0,0,4,4
"Bingham (Edwin R.) papers",oru_ua209.xml,80444/xv17266,0,0,4,4
"Brentano (Lowell and Frances Hyams) papers",oru_ax568.xml,80444/xv22601,3,0,1,4
"Crocker (Mollie Truax) Papers",oru_cbc872.xml,80444/xv00699,2,2,0,4
"Hopkins (Louis P.) autobiography and mementos",oru_ax229.xml,80444/xv18911,3,1,0,4
"Oregon High School Debating League records",oru_b151.xml,80444/xv77032,0,0,4,4
"Weston (George) letter",oru_ca1865apr28.xml,80444/xv69268,4,0,0,4
"Gragg (Joseph) Papers",oru_ax139.xml,80444/xv28735,0,1,3,4
"Murray Warner Essay Contest records",oru_ua153.xml,80444/xv81790,4,0,0,4
"White (Robert L.) papers",oru_a131.xml,80444/xv16464,0,0,4,4
"Miller (Henry) letters to Fulgham (Henry N.)",oru_a080.xml,80444/xv71737,2,2,0,4
"Follett Publishing Company, Children's Department Records",oru_ax865.xml,80444/xv26635,0,2,2,4
"Office of Greek Life records",oru_ua096.xml,80444/xv25946,0,4,0,4
"Crust (William S.) letter to Mr. and Mrs. Curtis",oru_ca1868jun2.xml,80444/xv07879,4,0,0,4
"Myer (Nathaniel) diary of a trip to the Rogue River Valley",oru_a086.xml,80444/xv24346,1,2,1,4
"American Institute of Architects, Southwest Oregon Chapter records",oru_coll401.xml,80444/xv81430,4,0,0,4
"Van Every (Dale) papers",oru_ax634.xml,80444/xv38229,0,2,2,4
"McLoughlin House postcards",oru_ph200_059.xml,80444/xv64313,2,1,1,4
"Royal (James Henry Bascom) papers",oru_a106.xml,80444/xv90636,0,4,0,4
"Salem Musical Union treasurer's book",oru_b124.xml,80444/xv72576,2,0,2,4
"Silver King Mining Company Records",oru_coll336.xml,80444/xv99581,3,1,0,4
"Jennings (Berryman) letter to R. H. Malory",oru_ca1857oct24.xml,80444/xv43173,4,0,0,4
"Porter (Sarah) diary",oru_a097.xml,80444/xv36163,3,1,0,4
"Arneson (Arnold) papers",oru_ax105.xml,80444/xv64987,0,3,1,4
"Mills, Jr. (Abbot Low) manuscript",oru_a236.xml,80444/xv80203,3,1,0,4
"Simmonds (Reginald A'court) papers",oru_ax478.xml,80444/xv55526,0,2,2,4
"Gibbs (Addison Crandall) deed",oru_ca1850nov18.xml,80444/xv02441,0,0,4,4
"Western Wood Products Association records",oru_coll410.xml,80444/xv03002,2,0,2,4
"Gilsheuser (Henry) papers",oru_ax325.xml,80444/xv10208,0,0,4,4
"Cranfill (Isom) papers",oru_ax127.xml,80444/xv63276,0,2,2,4
"Miller (Joaquin) poem",oru_ca1874jan1.xml,80444/xv00875,1,0,3,4
"Colvig (William M.) papers",oru_a018.xml,80444/xv78106,4,0,0,4
"Boyd (Nathan E.) diaries",oru_a011.xml,80444/xv58584,4,0,0,4
"Turnbull (George Stanley) manuscript",oru_f070_9t8.xml,80444/xv48297,1,3,0,4
"Clackamas County, Or. District 4. Justices' Court. docket",oru_b177.xml,80444/xv35540,0,0,4,4
"Graham (Loyal M.) papers",oru_ax040.xml,80444/xv76498,0,0,3,3
"Turner Cornet Band records",oru_b187.xml,80444/xv38333,0,1,2,3
"Campus Operations records",oru_ua051.xml,80444/xv95782,3,0,0,3
"Marmur (Jacland) papers",oru_ax825.xml,80444/xv41333,0,0,3,3
"Townsend Club No. 1 Albany, Or. records",oru_bx134.xml,80444/xv73962,0,3,0,3
"Ames (Fred Elijah) papers",oru_ax104.xml,80444/xv32154,0,3,0,3
"Milton Shannon (General Store) scrapbook",oru_b127.xml,80444/xv48477,3,0,0,3
"Oregon Steamship Company bill of lading",oru_ca1878oct21.xml,80444/xv44696,1,2,0,3
"Steiwer (Frederick) papers",oru_ax080.xml,80444/xv22955,0,0,3,3
"Saul Marks and Company letters received",oru_b045.xml,80444/xv38806,3,0,0,3
"Martin (Hannah) legislative correspondence",oru_ax671.xml,80444/xv01684,0,0,3,3
"Castle (Frank P.) papers",oru_ax331.xml,80444/xv86889,3,0,0,3
"Mills (Abbot Low Jr.), Federal Reserve Board of Governors records",oru_ax199.xml,80444/xv02789,0,1,2,3
"Smith (Alvin Thompson) letters",oru_a111.xml,80444/xv88601,2,1,0,3
"Proposals of Nesmith County, Oregon",oru_a271.xml,80444/xv85836,3,0,0,3
"Shackleford (Shelby) papers",oru_ax777.xml,80444/xv36352,0,0,3,3
"Marshall (Mel) papers",oru_ax741.xml,80444/xv48886,1,0,2,3
"Patterson (H.) and Company ledger",oru_b054.xml,80444/xv04721,1,0,2,3
"Meltzer (Milton) papers",oru_coll025.xml,80444/xv45523,1,0,2,3
"Wooden (Lee) correspondence",oru_a185.xml,80444/xv60455,0,3,0,3
"Collins (James Harrison) correspondence",oru_ax014.xml,80444/xv54443,3,0,0,3
"Lofton (Blanche) papers",oru_ax282.xml,80444/xv93777,2,1,0,3
"Lea (Fanny Heaslip) papers",oru_coll022.xml,80444/xv04913,1,2,0,3
"Davis (Eleanor) papers",oru_coll351.xml,80444/xv26672,3,0,0,3
"Shufeldt (Edith) papers",oru_a208.xml,80444/xv17110,0,0,3,3
"Stearns and Chenoweth records",oru_bx025.xml,80444/xv60870,0,0,3,3
"Teaching collection of legal document samples",oru_coll391.xml,80444/xv01858,0,0,3,3
"Lewis Investment Company records",oru_bx098.xml,80444/xv18856,1,0,2,3
"Roberts (William Milnor) papers",oru_ax211.xml,80444/xv97665,0,0,3,3
"<emph render="italic">The Student Insurgent</emph> records",oru_ua179.xml,80444/xv13363,0,0,3,3
"David McCully Butcher Store account book",oru_b044.xml,80444/xv70645,2,0,1,3
"Brown (Lyndon O.) papers",oru_ax476.xml,80444/xv11492,0,3,0,3
"Burns (Tom J.) papers",oru_ax108.xml,80444/xv70574,3,0,0,3
"Applegate (Albert) letters",oru_a147.xml,80444/xv10061,0,3,0,3
"Woltman (Frederick Enos) correspondence and clippings",oru_coll397.xml,80444/xv10461,3,0,0,3
"Applegate (Jesse). Views on Oregon history, etc., Yoncalla, 1878",oru_sfm052.xml,80444/xv12374,0,3,0,3
"Methodist Mission Store account book",oru_b048.xml,80444/xv48217,1,2,0,3
"Faculty Advisory Council records",oru_ua050.xml,80444/xv71398,0,0,3,3
"Yates (J. C.) farm and household account book",oru_a138.xml,80444/xv33682,0,0,3,3
"Kelly (John) correspondence",oru_ax148.xml,80444/xv31430,3,0,0,3
"Ryan (Queene B. Lister) papers",oru_ax231.xml,80444/xv80303,0,3,0,3
"Robotham (John S.) papers",oru_coll437.xml,80444/xv35089,0,0,3,3
"Lutheran Schools Committee records",oru_b138.xml,80444/xv51327,0,0,3,3
"Miller (Joaquin) papers",oru_sfm182.xml,80444/xv55215,0,1,2,3
"Carter (William Alexander) papers",oru_ax110.xml,80444/xv48556,1,2,0,3
"Hoyem (Oliver) papers",oru_coll046.xml,80444/xv47937,2,1,0,3
"Corbett (H.W. ) and H.W Failing collection of bills of lading, shipping tickets and freight bills relating to Pacific Northwest vessels",oru_cab497.xml,80444/xv45886,0,0,3,3
"Baldwin (John) papers",oru_ua205.xml,80444/xv43481,0,0,3,3
"Portland Hebrew Sick Benefit Association treasurer's books",oru_b128.xml,80444/xv32028,3,0,0,3
"Coe (Henry Waldo) correspondence",oru_ax112.xml,80444/xv30276,0,1,2,3
"Cornelius (Thomas R.) letter",oru_ca1856feb20.xml,80444/xv58367,0,3,0,3
"Register-Guard records on higher education consolidation",oru_bx006.xml,80444/xv63293,2,1,0,3
"White (Clarence H.) papers",oru_ax175.xml,80444/xv94448,3,0,0,3
"Caruthers (Finis) deed",oru_ca1854nov13.xml,80444/xv25726,3,0,0,3
"Neebe (Joseph Henry) papers",oru_ax711.xml,80444/xv67907,0,0,3,3
"Whisnant (Archibald McNeill) manuscripts",oru_ax098.xml,80444/xv34414,0,1,2,3
"Hughes (Rodney "Rod") manuscripts",oru_coll394.xml,80444/xv44558,3,0,0,3
"Creighton and McCully family papers",oru_a260.xml,80444/xv26828,0,0,3,3
"Carr (Eugene) papers",oru_ax574.xml,80444/xv11917,2,0,1,3
"Knight (Ruth Adams) papers",oru_ax784.xml,80444/xv95840,3,0,0,3
"Associated General Contractors of America. Oregon-Columbia Chapter records",oru_bx109.xml,80444/xv68347,0,2,1,3
"Kafader (John) blacksmith account book",oru_b037.xml,80444/xv32458,0,3,0,3
"Gaylord (Orange) diary",oru_a040.xml,80444/xv95426,0,3,0,3
"Adam R. Shipley and Company records",oru_b065.xml,80444/xv31774,0,3,0,3
"Obsidians, Inc. Records",oru_bx196.xml,80444/xv32849,3,0,0,3
"McHargue Butcher Shop account book",oru_b047.xml,80444/xv15600,3,0,0,3
"Hensolt (Edith A.) papers",oru_ax588.xml,80444/xv29864,2,1,0,3
"Smith (Carl F.) papers",oru_casm6.xml,80444/xv18011,2,1,0,3
"Paules (Earl G.) papers",oru_ax540.xml,80444/xv11764,0,1,2,3
"Elliot (Norman) papers",oru_ax335.xml,80444/xv48892,3,0,0,3
"Independent Order of Odd Fellows, Hannibal, Missouri, Lodge #8 certificate",oru_ca1840nov10.xml,80444/xv69754,3,0,0,3
"Portland and Milwaukie Macadamized Road Co. records",oru_b130.xml,80444/xv68554,0,0,3,3
"John (David) diary and account book",oru_ax180.xml,80444/xv86233,0,0,3,3
"West (Oswald) papers",oru_ax174.xml,80444/xv05194,3,0,0,3
"Van de Velde (Paul) papers",oru_ax587.xml,80444/xv01812,1,1,1,3
"Rands (Harold A.) papers",oru_ax089.xml,80444/xv69735,0,1,2,3
"Oregon Freelance Club records",oru_bx117.xml,80444/xv04061,0,0,3,3
"Burbank (A.R.) diaries",oru_a013.xml,80444/xv97135,0,1,2,3
"Thornton (Jessy Quinn) papers",oru_cbt395.xml,80444/xv67349,0,3,0,3
"Radio Station KOIN records",oru_b057.xml,80444/xv12493,0,0,3,3
"Martin (Lillie M.) manuscripts",oru_f813m364.xml,80444/xv91278,0,1,2,3
"Moore (Robert) certification of claim",oru_ca1843aug22.xml,80444/xv15725,0,3,0,3
"Bechtell (Lake M.) papers",oru_bx161.xml,80444/xv96585,0,1,2,3
"Rogers (Cameron) papers",oru_ax362.xml,80444/xv19204,1,0,2,3
"Snowden (Samuel A.) correspondence",oru_a114.xml,80444/xv93502,0,0,3,3
"Chicago Tribune-New York News Syndicate, Inc., Fiction Department records",oru_bx141.xml,80444/xv47171,1,0,2,3
"Mills (Thelma) papers",oru_ax857.xml,80444/xv51235,2,0,1,3
"Eugene Print Collection",oru_ph213.xml,80444/xv47927,0,0,3,3
"Holmes (Llewellyn "Lew" P.) papers",oru_ax552.xml,80444/xv41943,0,1,2,3
"Asklepiads Pre-Med Society records",oru_ua207.xml,80444/xv88888,0,0,3,3
"Oregon. Governor's State Committee on Children and Youth records",oru_b167.xml,80444/xv13308,0,0,3,3
"Feller (Charles) papers",oru_ax320.xml,80444/xv73760,0,2,1,3
"Ward (Roy Allen) speeches",oru_a276.xml,80444/xv27496,0,0,3,3
"Minto (John) letter to William P. Lord",oru_ca1892jan15.xml,80444/xv73672,0,2,1,3
"Pease (George) bill of sale",oru_ca1865sep1.xml,80444/xv42053,0,2,1,3
"Neuhausen (Thomas Brues) papers",oru_ax084.xml,80444/xv21649,1,0,2,3
"Macleay Estate Co. correspondence and miscellaneous papers",oru_bx185.xml,80444/xv45065,3,0,0,3
"Williams (George Henry) address",oru_ca1896may16.xml,80444/xv47985,1,1,1,3
"Prieger (Oscar A.) manuscript and letters",oru_a100.xml,80444/xv79977,0,3,0,3
"Novick (Jane) papers",oru_coll368.xml,80444/xv41876,2,1,0,3
"Crawford (Arthur Whipple) papers",oru_ax237.xml,80444/xv43905,2,0,1,3
"Office of the President: Charles Hiram Chapman records",oru_ua001_002.xml,80444/xv78112,2,0,0,2
"Governor John Whiteaker commutation of sentence",oru_ca1860mar1.xml,80444/xv33346,1,0,1,2
"Allingham (Margery) photograph",oru_ph327.xml,80444/xv77832,0,2,0,2
"Redington (Bernice) papers",oru_ax092.xml,80444/xv06970,0,0,2,2
"Bristow (Elijah LaFayette) "Rencounters with Inidans, Highwaymen and outlaws" Manuscript",oru_cbb776.xml,80444/xv96929,0,0,2,2
"Keep Oregon Green Association records",oru_bx112.xml,80444/xv41705,0,2,0,2
"Patton (Thomas McFatton and Hal D.) diary",oru_a094.xml,80444/xv75741,0,0,2,2
"Nesmith (James Willis) account book",oru_a087.xml,80444/xv80651,0,0,2,2
"Littell (Philip) papers",oru_ax782.xml,80444/xv79879,0,2,0,2
"Drain & Co. records",oru_b020.xml,80444/xv46127,0,0,2,2
"Van Gorder (George) papers",oru_ax606.xml,80444/xv05883,0,0,2,2
"Dunbar (Saidie Orr) diaries",oru_ax026.xml,80444/xv96353,0,2,0,2
"Krome Corporation records",oru_bx148.xml,80444/xv51245,0,0,2,2
"E. C. M. Rand report on Northwest railroads",oru_b116.xml,80444/xv57669,0,2,0,2
"Baldwin (Eleanor) notes and pamphlets on monetary systems",oru_ax223.xml,80444/xv79721,1,1,0,2
"Caufield (Robert) receipts",oru_ca1853oct10.xml,80444/xv80575,1,0,1,2
"Sutton (J.M.) account of the Rogue River Indian War of 1855",oru_cbsu87.xml,80444/xv46487,1,1,0,2
"Wilson (Arthur) papers",oru_ax406.xml,80444/xv00097,0,2,0,2
"Zieber (Albert) diary and letters",oru_a139.xml,80444/xv87585,0,0,2,2
"Wiest (William Allen) papers",oru_ax696.xml,80444/xv32299,0,2,0,2
"Staples (Virgil Bain) legislative correspondence",oru_ax276.xml,80444/xv86853,0,0,2,2
"Dye (Eva Emery) letter to Mrs. Colby",oru_ca1906oct30.xml,80444/xv26177,0,0,2,2
"Gallagher (Patrick J.) papers",oru_ax301.xml,80444/xv70510,0,1,1,2
"Holmstrom (Haldane "Buzz") diaries",oru_a213.xml,80444/xv10757,0,0,2,2
"Dunham Printing Company financial records",oru_b021.xml,80444/xv67538,0,0,2,2
"Smith (Delazon) letter",oru_ca1855sept15.xml,80444/xv80496,2,0,0,2
"Pioneer Real Estate Company records",oru_bx101.xml,80444/xv44439,0,0,2,2
"Newton (Charles B.) reminiscences",oru_a211.xml,80444/xv98330,0,1,1,2
"Belknap (George) papers",oru_ua208.xml,80444/xv80703,0,0,2,2
"Hardy (H. Epps) letter",oru_ca1872feb16.xml,80444/xv78961,0,0,2,2
"Griffin (Myron) papers",oru_ax723.xml,80444/xv18698,0,2,0,2
"Miller (Henry B.) papers",oru_a269.xml,80444/xv02114,0,2,0,2
"Davis (Charles E.) Papers on Civilian Public Service and the Untide Press",oru_coll470.xml,80444/xv98983,0,1,1,2
"W.W. Baker and Company bill of lading",oru_ca1863mar14.xml,80444/xv88565,0,0,2,2
"Oregon. State Defense Council. Lane County records",oru_bx035.xml,80444/xv32257,0,0,2,2
"Hermann (Binger) letters",oru_ca1891nov4.xml,80444/xv94729,0,2,0,2
"Columbia (steamship) bill of lading",oru_ca1860july3.xml,80444/xv85623,0,0,2,2
"German Prisoner of War collection",oru_coll469.xml,80444/xv60339,0,0,2,2
"Kola Neis Hop Company corporate records",oru_b050.xml,80444/xv51806,0,2,0,2
"American Council for Emigres in the Professions (ACEP) records",oru_b149.xml,80444/xv22644,0,0,2,2
"Right to Pride records",oru_coll354.xml,80444/xv96740,0,1,1,2
"Terry (Chester N.) letter",oru_ca1873apr17.xml,80444/xv73046,0,0,2,2
"McKim, Mead and White notice of lien",oru_ca1885feb18.xml,80444/xv41213,0,0,2,2
"Davis (William B.) letter",oru_ca1853dec21.xml,80444/xv94512,2,0,0,2
"L. E. Blain Clothing Company records",oru_bx003.xml,80444/xv48468,0,0,2,2
"Bartrum (Smith C.) papers",oru_cbb286.xml,80444/xv49475,0,2,0,2
"Willamette Falls Canal Company records",oru_ca1865aug25.xml,80444/xv76840,0,0,2,2
"Bynner (Witter) poems",oru_ca1916jan1.xml,80444/xv11090,2,0,0,2
"Sperry (James B.) papers",oru_cbsp37.xml,80444/xv44869,2,0,0,2
"Miller (Miles M.) letter",oru_ca1868july30.xml,80444/xv44979,0,0,2,2
"Cheney (George Parkhurst) papers",oru_ax256.xml,80444/xv88351,0,0,2,2
"Forest Grove Door and Lumber Co. minute book",oru_b026.xml,80444/xv10498,2,0,0,2
"Kleinsorge (Paul Lincoln) papers",oru_bx157.xml,80444/xv89520,0,2,0,2
"Craig (David Watson) letter to William L. Adams",oru_ca1863nov4.xml,80444/xv43673,1,1,0,2
"Hanzlik (Edward John) papers",oru_ax142.xml,80444/xv65737,2,0,0,2
"Miscellaneous Subject Files",oru_coll240.xml,80444/xv56649,0,0,2,2
"Prince Ernest (Ship) log",oru_b114.xml,80444/xv05737,1,0,1,2
"Meyendorff (Michael A.) papers",oru_ax152.xml,80444/xv24121,0,2,0,2
"Sox (Edward Franklin and Carlton Edward) Papers",oru_ax168.xml,80444/xv53271,0,1,1,2
"Imhoff (Jacob) letter to Agnes Plummer",oru_ca1899may24.xml,80444/xv36746,0,0,2,2
"Steininger (Russell) papers",oru_a178.xml,80444/xv68760,0,2,0,2
"Robbins (Marcus W.) papers",oru_ax512.xml,80444/xv45596,0,1,1,2
"Jack (T. P.) petition",oru_ca1873feb1.xml,80444/xv25100,0,0,2,2
"Huston (Henry Clay) papers",oru_ax146.xml,80444/xv61567,0,1,1,2
"Mahone (Luther D.) papers",oru_coll080.xml,80444/xv75473,0,0,2,2
"Pettygrove (Francis W.) bond",oru_ca1848jan29.xml,80444/xv61499,0,0,2,2
"Regular Donkey Club records",oru_b097.xml,80444/xv26492,0,1,1,2
"Oregon Iron Company records",oru_bx020.xml,80444/xv42562,0,0,2,2
"Western Union Telegraph Co. transcripts of reports",oru_b125.xml,80444/xv92660,2,0,0,2
"Hair (Washington M.) farm account book",oru_b156.xml,80444/xv17980,0,0,2,2
"Barretto (Laurence B.) papers",oru_coll017.xml,80444/xv08068,1,0,1,2
"McNulty (Faith) manuscripts",oru_a201.xml,80444/xv78518,0,2,0,2
"Cornelius (Thomas R.) deposition",oru_ca1884jan1.xml,80444/xv68566,0,0,2,2
"Olney (Cyrus), Astoria letter to A. B. Hallock",oru_ca1860oct29.xml,80444/xv15591,0,0,2,2
"Jackson County Oregon Coroner report",oru_ca1859may7.xml,80444/xv15634,0,0,2,2
"Base Line Lumber Co. outgoing correspondence",oru_b011.xml,80444/xv01589,1,1,0,2
"Federn (Walter) papers",oru_a295.xml,80444/xv92779,0,0,2,2
"Committee to Keep Firemen Police and Teachers on the Job records",oru_bx162.xml,80444/xv74633,0,0,2,2
"Bettis (Stan) manuscript",oru_sfm069.xml,80444/xv28436,0,2,0,2
"Collection of autographs of literary and political persons",oru_coll390.xml,80444/xv46456,0,0,2,2
"Brown (Joseph Henry) letter to John H. Mitchell",oru_ca1893may18.xml,80444/xv82833,2,0,0,2
"Mitchell (Dwight E.) papers",oru_ax791.xml,80444/xv53131,0,2,0,2
"Ballinger (Thomas O.) papers",oru_ua206.xml,80444/xv43182,1,1,0,2
"Wilkins (David) letter to Oregon City merchants and businessmen",oru_ca1849sep26.xml,80444/xv37466,1,1,0,2
"Adams (George O.) radical literature collection",oru_f335ad1.xml,80444/xv70730,0,2,0,2
"Mount St. Helens photographs",oru_ph319.xml,80444/xv94067,0,0,2,2
"De Witt (Francis) deed",oru_ca1852aug18.xml,80444/xv42031,0,0,2,2
"Alden Fruit Preserving Co. records",oru_b008.xml,80444/xv18191,0,0,2,2
"Proehl (Frederick) papers",oru_ax598.xml,80444/xv05447,0,0,2,2
"Miller (Joaquin) letter to Lee Moorhouse",oru_ca1907july12.xml,80444/xv58514,2,0,0,2
"Oregon and California Advisory Board records",oru_bx056.xml,80444/xv88299,0,0,2,2
"Marks (Laurie J.) papers",oru_coll422.xml,80444/xv92330,0,0,2,2
"Oregon Rockefeller Campaign Committee records",oru_bx121.xml,80444/xv40805,0,0,2,2
"Nesmith (Georgia) letter to James Willis Nesmith",oru_ca1893sep28.xml,80444/xv01190,0,0,2,2
"Curry (George Law) letters",oru_a025.xml,80444/xv36145,0,0,2,2
"Lesslie (Eva S.) diary",oru_a155.xml,80444/xv74716,0,0,2,2
"Office of the President: Clarence Valentine Boyer records",oru_ua001_006.xml,80444/xv81024,1,1,0,2
"Bradshaw (Homer V.) report",oru_a204.xml,80444/xv07891,0,0,2,2
"Griffenhagen-Kroeger Inc. Philippines Public Administration Study records",oru_bx086.xml,80444/xv38760,1,1,0,2
"Hurricane (Sailing ship) documents, receipts, and related papers",oru_b035.xml,80444/xv33483,0,0,2,2
"Williams (John R.) letters to Lucy Applegate",oru_a148.xml,80444/xv99224,0,1,1,2
"Umpqua Academy Association records",oru_b087.xml,80444/xv17932,0,2,0,2
"Rice (Donald Blair) correspondence",oru_a187.xml,80444/xv70947,0,2,0,2
"Teall (Kaye M.) papers",oru_ax385.xml,80444/xv30328,2,0,0,2
"Independent Order of Odd Fellows, Empire City, Or. correspondence",oru_ca1872sept23.xml,80444/xv74566,0,0,2,2
"Office of the President: Myles Brand records",oru_ua001_015.xml,80444/xv16546,0,2,0,2
"Eugene Fruit Growers Association records",oru_b165.xml,80444/xv23806,0,0,2,2
"Murray (George W.) letter to W. W. Baker and Company",oru_ca1863sep18.xml,80444/xv31787,0,2,0,2
"Cornelius (Thomas R.) letter",oru_ca1855oct20.xml,80444/xv46850,2,0,0,2
"Hardy (W. H.) letter to Fred Lockley",oru_ca1918nov18.xml,80444/xv53463,2,0,0,2
"B'nai B'rith Portland Lodge No. 65 records",oru_ax218.xml,80444/xv98736,0,2,0,2
"William F. Browne (schooner) bill of lading",oru_ca1865apr13.xml,80444/xv11355,2,0,0,2
"Office of the President: Paul Olum records",oru_ua001_014.xml,80444/xv25781,0,2,0,2
"Apperson (John T.) daybook",oru_b009.xml,80444/xv06314,2,0,0,2
"Allingham (George) letter to William Allingham",oru_ca1852mar28.xml,80444/xv99356,2,0,0,2
"Oregon and California Railroad Company petition",oru_ca1881aug31.xml,80444/xv52227,0,2,0,2
"Turnbull (George Stanley) papers",oru_a306.xml,80444/xv74664,1,1,0,2
"Oregon Rural Electric Cooperative Association records",oru_bx038.xml,80444/xv08804,0,2,0,2
"California Townsend Club records",oru_bx181.xml,80444/xv62515,0,1,1,2
"Frazar (Thomas) reminiscences to 1853, including the history of the Frazar family in America",oru_cbf869.xml,80444/xv58755,0,0,2,2
"Groff-Smith (Mrs. Everitt) autobiography",oru_cbg893.xml,80444/xv80401,2,0,0,2
"Heyman (A.C.) papers",oru_coll208.xml,80444/xv89376,0,0,2,2
"Lay Council for Better Education, Lane County School District No. 69 records",oru_b146.xml,80444/xv68688,0,0,2,2
"Williams (T. F.and G. F.) legal document",oru_ca1883nov5.xml,80444/xv26495,0,0,2,2
"Williams (Moses Allen) diary and records",oru_ax099.xml,80444/xv58975,2,0,0,2
"Orides Club records",oru_ua152.xml,80444/xv61929,0,0,2,2
"Isbell (Crawford) papers",oru_a061.xml,80444/xv61138,0,0,2,2
"Smith (T.J.) letter",oru_ca1870jan26.xml,80444/xv69805,0,0,2,2
"World Without War Council records",oru_bx179.xml,80444/xv15795,0,1,0,1
"Bankhardt (Frederick) diaries and correspondence",oru_a179.xml,80444/xv98672,0,0,1,1
"Murrin (Christopher) comic collection",oru_coll468.xml,80444/xv15899,0,0,1,1
"Clackamas County County Court certificate of tax",oru_ca1857oct1.xml,80444/xv32324,0,0,1,1
"Smith (James C.) letters patent",oru_ca1883june19.xml,80444/xv06900,0,0,1,1
"Mitchell (John Hipple) legal document",oru_ca1869dec20.xml,80444/xv71578,0,1,0,1
"Yocom (Harry B.) faculty papers",oru_ua225.xml,80444/xv20312,0,0,1,1
"Prichard (William S.) letters from Iowa, California, and Union County, Oregon",oru_a099.xml,80444/xv98950,1,0,0,1
"Welch (John W.) letter to Sarah Welch Wood",oru_ca1917feb24.xml,80444/xv50708,0,0,1,1
"Office of the President: Robert D. Clark records",oru_ua001_012.xml,80444/xv97128,1,0,0,1
"Smith (Harold B.) letter",oru_ca1919jan5.xml,80444/xv23474,0,1,0,1
"White (Elijah) bond",oru_ca1846aug13.xml,80444/xv46896,0,1,0,1
"Rarick (Charles Claudius) papers",oru_ax090.xml,80444/xv34655,0,1,0,1
"Office of the President: Charles Ellicott Johnson / N. Ray Hawk records",oru_ua001_011.xml,80444/xv19488,0,0,1,1
"Yamhill Steamboat Company journal",oru_b120.xml,80444/xv03332,1,0,0,1
"Hammond (William H.) photographs",oru_coll462.xml,80444/xv32290,0,0,1,1
"Trimble (Louis Preston) papers",oru_ax251.xml,80444/xv49099,0,0,1,1
"Poor (Lester) papers",oru_ax384.xml,80444/xv87042,0,0,1,1
"Civilian Conservation Corps (CCC), Company 2110 newspaper",oru_coll386.xml,80444/xv14498,1,0,0,1
"Smith (James L.) letter to Myron Eells",oru_ca1891may29.xml,80444/xv25131,1,0,0,1
"Pacific Coast Marine Fireman, Oilers, Watertenders, and Wipers Association, Seattle Branch records",oru_bx044.xml,80444/xv23596,0,0,1,1
"Patterson (C. A.) contract",oru_ca1905aug21.xml,80444/xv56738,0,0,1,1
"Nesmith (James Willis) print block and broadside",oru_sfm071.xml,80444/xv09048,0,0,1,1
"Hall (Grace E.) papers",oru_ax792.xml,80444/xv24060,0,1,0,1
"Brown (Joseph Henry) letter to Nettie Spencer",oru_ca1895apr27.xml,80444/xv00717,1,0,0,1
"Lane County School District minutes of school directors meetings",oru_b132.xml,80444/xv01129,0,0,1,1
"Donaldson (James T.) papers",oru_a028.xml,80444/xv43331,0,1,0,1
"Johnson (John Laurence) diary and letter",oru_a270.xml,80444/xv66528,0,0,1,1
"Whiteaker (John) papers",oru_a132.xml,80444/xv12933,1,0,0,1
"Lundquist College of Business (LCB) records",oru_ua039.xml,80444/xv83035,1,0,0,1
"Kelsay (Robert C.) Forest Service diaries",oru_a212.xml,80444/xv81542,0,0,1,1
"Oregon Quicksilver Incorporated mining records",oru_coll423.xml,80444/xv98367,0,1,0,1
"Frederick E. Baker and Associates accounts records",oru_bx030.xml,80444/xv51852,1,0,0,1
"Williams (V.) journal",oru_a134.xml,80444/xv74002,0,1,0,1
"Woodworth (Edwin A.) papers",oru_ax497.xml,80444/xv39456,0,0,1,1
"Howard (William) diary",oru_a056.xml,80444/xv98812,0,1,0,1
"Bohanon (Eunice Blake) Papers",oru_ax342.xml,80444/xv86542,1,0,0,1
"Dodge (Orvil and Alice) letters to David P. Walrad",oru_a261.xml,80444/xv78509,1,0,0,1
"Pacific Northwest Hardwood Association records",oru_b080.xml,80444/xv21243,0,1,0,1
"Daughters of the American Revolution, Oregon Chapter correspondence",oru_a227.xml,80444/xv19338,1,0,0,1
"Gale (W.) letter",oru_ca1848july5.xml,80444/xv99548,0,0,1,1
"Worden (William) papers",oru_ax638.xml,80444/xv05496,1,0,0,1
"Alvord (Benjamin) letter to J.M. Sutton",oru_ca1863july16.xml,80444/xv98825,0,1,0,1
"Cronise (Ralph Reynolds) papers",oru_ax578.xml,80444/xv96212,1,0,0,1
"Kellogg (Edwin Dwight) papers",oru_f252k291.xml,80444/xv26431,0,0,1,1
"Patch (Charles C.) papers",oru_ax621.xml,80444/xv71173,1,0,0,1
"Kaufman (Victor) papers",oru_ax380.xml,80444/xv68847,1,0,0,1
"Miller (John J.) papers",oru_ax382.xml,80444/xv24057,0,0,1,1
"McGaughey (Dudley Dean) papers",oru_coll211.xml,80444/xv15249,0,1,0,1
"Woodmen of the World. Junction City Camp No. 446 minutes",oru_b074.xml,80444/xv43075,0,0,1,1
"San Francisco Market Review newspaper",oru_coll384.xml,80444/xv46813,0,0,1,1
"Merovitch (Alexander) papers",oru_ax288.xml,80444/xv31109,1,0,0,1
"University of Oregon Faculty Assembly and University Senate records",oru_ua062.xml,80444/xv02844,0,0,1,1
"Gleim (William C.) letters",oru_a143.xml,80444/xv79287,0,0,1,1
"Gardner (Ira) letters from Oregon",oru_a256.xml,80444/xv56872,0,1,0,1
"Lerrigo (Charles Henry) papers",oru_ax560.xml,80444/xv96838,0,1,0,1
"Ballard (Dean D.) papers",oru_ax258.xml,80444/xv04983,1,0,0,1
"Wilson (Woodrow) letter to Matthew H. Douglass",oru_ca1902july12.xml,80444/xv68475,0,0,1,1
"Collection of Portland, Oregon theater programs",oru_cat34.xml,80444/xv36511,0,0,1,1
"Smith (Lura McLane) collection of Korean missionary materials",oru_a293.xml,80444/xv63110,0,0,1,1
"Office of the President: William C. Jones (acting) and Arthur S. Flemming records",oru_ua001_010.xml,80444/xv52880,0,0,1,1
"Morris Music Store day book",oru_b049.xml,80444/xv09674,0,1,0,1
"Haines family miscellaneous accounts book and receipts",oru_cah127.xml,80444/xv50741,0,0,1,1
"Northwest Public Power Association, executive secretary's records",oru_bx133.xml,80444/xv68075,0,0,1,1
"Coos Bay Harbor records",oru_b018.xml,80444/xv75286,0,0,1,1
"Taylor (Matthew) papers",oru_ax367.xml,80444/xv76367,0,0,1,1
"Griffin (John Smith) papers",oru_ca1842dec31.xml,80444/xv52011,0,1,0,1
"Van Waters (George Browne) papers",oru_ax215.xml,80444/xv03530,1,0,0,1
"Oregon Territory, Militia Quartermaster department voucher",oru_ca1856aug15.xml,80444/xv45773,0,1,0,1
"Grover (A. J.) letter to Edwin Beebe",oru_ca1863jan5.xml,80444/xv27609,0,0,1,1
"Office of the President: Frank Strong records",oru_ua001_003.xml,80444/xv07012,1,0,0,1
"Umatilla County, Oregon Assessor records",oru_bx192.xml,80444/xv24310,0,0,1,1
"Waldo (Mary Jane) papers",oru_ax427.xml,80444/xv17700,0,0,1,1
"Patriots of America, Hillsboro, Oregon Lodge No. 1 records",oru_b076.xml,80444/xv09063,0,0,1,1
"Rase (Frederick W.) field diaries",oru_a102.xml,80444/xv24023,0,0,1,1
"Ruhl (Robert W.) papers",oru_coll224.xml,80444/xv40905,0,0,1,1
"Craft (Daniel) order of payment",oru_ca1855june26.xml,80444/xv42749,0,1,0,1
"Leland (Levi) letter",oru_ca1884jan7.xml,80444/xv65777,0,1,0,1
"Fairchild (Hymen) land sale agreement",oru_ca1858oct5.xml,80444/xv38339,0,1,0,1
"Nilsson (Adolph) field diaries",oru_a092.xml,80444/xv52923,0,0,1,1
"Day (Gerry) papers",oru_ax436.xml,80444/xv52709,0,1,0,1
"Fenton (Katherine L.) letter",oru_ca1926oct30.xml,80444/xv59277,0,0,1,1
"McMinnville Ladies Sanitary Aid Society records",oru_b152.xml,80444/xv93237,0,0,1,1
"Robinson (Charles William) radio scripts",oru_f808r56.xml,80444/xv82485,0,1,0,1
"Stadelman (Peter John) legislative correspondence",oru_ax238.xml,80444/xv27969,0,0,1,1
"Smith (Harold B.) letter",oru_ca1918dec19.xml,80444/xv64538,0,1,0,1
"Shipley (William A.) papers",oru_ca1866june9.xml,80444/xv71484,0,0,1,1
"McBain (Bertram Telfer) papers",oru_ax253.xml,80444/xv69580,1,0,0,1
"Socialist Party of Springfield (Or) Local treasurer's book",oru_b157.xml,80444/xv05569,0,0,1,1
"Jhabvala (Ruth Prawer) papers",oru_coll457.xml,80444/xv33267,0,0,1,1
"Cheshire (Gifford) manuscripts",oru_ax375.xml,80444/xv75485,0,0,1,1
"Mitchell (Glenn E.) papers",oru_ax158.xml,80444/xv38458,0,1,0,1
"Offord (Lenore Glen) papers",oru_ax845.xml,80444/xv58676,0,1,0,1
"Standard Corporation records",oru_bx188.xml,80444/xv64520,0,1,0,1
"Swiftsure (Ship) log and recipe book",oru_b118.xml,80444/xv64291,0,0,1,1
"Hamilton (James Watson) diary",oru_a045.xml,80444/xv12173,0,1,0,1
"Ross (Vernon) papers",oru_ax780.xml,80444/xv00976,0,0,1,1
"Jones (W. Al) letters received",oru_a140.xml,80444/xv73605,0,1,0,1
"Boeckman (Charles) papers",oru_ax329.xml,80444/xv84085,1,0,0,1
"Polhemus (James Henry) papers",oru_ax299.xml,80444/xv33309,0,0,1,1
"Fenton family letters",oru_a037.xml,80444/xv78109,0,0,1,1
"Dunbar (Elizabeth G. Lewis) autobiography",oru_a294.xml,80444/xv84448,0,1,0,1
"Clatsop County, Oregon School District No. 1 land conveyance agreement",oru_ca1865jan9.xml,80444/xv23757,0,0,1,1
"Pelz (Victor H.) papers",oru_ax644.xml,80444/xv26428,0,1,0,1
"Parrish (J. L. ) and Company account book",oru_b053.xml,80444/xv74813,0,0,1,1
"Coulee City, Wash. Chamber of Commerce records",oru_bx054.xml,80444/xv50360,0,1,0,1
"Oberlin (Gladys) papers",oru_coll050.xml,80444/xv32501,0,0,0,0
"Ingersoll (Charles Jared), letter on the Oregon question",oru_ca1846mar3.xml,80444/xv54464,0,0,0,0
"Three poems about Oregon river boating",oru_ca1888jan1.xml,80444/xv51397,0,0,0,0
"Metschan Family papers",oru_ax686.xml,80444/xv76867,0,0,0,0
"Pease (Clifton) papers",oru_ax161.xml,80444/xv36004,0,0,0,0
"United States Spruce Production Corporation records",oru_bx114.xml,80444/xv64633,0,0,0,0
"Princess Royal (Ship) log",oru_b115.xml,80444/xv20498,0,0,0,0
"McGarity (Daniel J.) papers",oru_a184.xml,80444/xv44052,0,0,0,0
"Mowry (Sylvester) letter",oru_a084.xml,80444/xv88876,0,0,0,0
"McGaw (James A. P.) pastor's register",oru_a076.xml,80444/xv16879,0,0,0,0
"Walker (Marcus Whitman) letters",oru_a175.xml,80444/xv83105,0,0,0,0
"Turner (Laura E.) household account book and weather record",oru_a124.xml,80444/xv69335,0,0,0,0
"Lait (Jacquin "Jake" L.) papers",oru_ax346.xml,80444/xv32681,0,0,0,0
"Guttry (J. K.) diary",oru_a240.xml,80444/xv00674,0,0,0,0
"Christ (J. H. (John Henry)) papers",oru_ax767.xml,80444/xv19888,0,0,0,0
"Daggett (Junior F.) papers",oru_ax029.xml,80444/xv88522,0,0,0,0
"Elston (Allan) papers",oru_ax280.xml,80444/xv45861,0,0,0,0
"Mullarky (Douglas) papers",oru_a167.xml,80444/xv72296,0,0,0,0
"Smith (D.) notice to citizens of Tualatin Plains, OR",oru_ca1850dec18.xml,80444/xv30825,0,0,0,0
"Hall (Lawrence) commonplace book",oru_a044.xml,80444/xv44757,0,0,0,0
"Canaday (Madison) account book",oru_a015.xml,80444/xv57617,0,0,0,0
"U. S. Civil Aeronautics Board records of dockets",oru_bx164.xml,80444/xv99606,0,0,0,0
"School of Music and Dance records",oru_ua044.xml,80444/xv07336,0,0,0,0
"Scott (Hamilton) diary",oru_a108.xml,80444/xv04315,0,0,0,0
"Washington Street Market Co. records",oru_b070.xml,80444/xv17330,0,0,0,0
"Bunting and Trulove papers",oru_bx180.xml,80444/xv07083,0,0,0,0
"Office of University Housing records",oru_ua113.xml,80444/xv70352,0,0,0,0
"Villair, John Joseph reminiscences",oru_cbv711.xml,80444/xv13104,0,0,0,0
"Investment in the Future of Oregon publications",oru_ua203.xml,80444/xv14358,0,0,0,0
"Dennison (A.P.) papers",oru_a177.xml,80444/xv49337,0,0,0,0
"Anderson (Clarence William) papers",oru_ax444.xml,80444/xv02517,0,0,0,0
"Deschutes County, Or. Tax Supervising and Conservation Commission minutes",oru_b100.xml,80444/xv19131,0,0,0,0
"Smith (Roy K. and Lura McLane) letters from Korea",oru_a206.xml,80444/xv20419,0,0,0,0
"Hancock (Ralph Lowell) papers",oru_ax708.xml,80444/xv13952,0,0,0,0
"Mattoon (Charles Hiram ) letter to Hill (Reuben C.)",oru_ca1862jan18.xml,80444/xv71282,0,0,0,0
"Mackie (David I.) addresses and statements",oru_ax504.xml,80444/xv52935,0,0,0,0
"Eccles (John F.) letter to Colonel Brophy",oru_ca1862mar13.xml,80444/xv67901,0,0,0,0
"Allen and Lewis Company records",oru_bx097.xml,80444/xv08593,0,0,0,0
"Metcalf (T.) letter to Albert A. Durham",oru_ca1854mar29.xml,80444/xv87164,0,0,0,0
"Hallock & Day Co. (Portland, Or.) ledger",oru_b030.xml,80444/xv79141,0,0,0,0
"Safe Ride records",oru_ua190.xml,80444/xv26641,0,0,0,0
"San Juan Boundary Dispute collection",oru_coll212.xml,80444/xv11550,0,0,0,0
"Linn Baseball Club records",oru_b095.xml,80444/xv48376,0,0,0,0
"Robinson (Will H.) letter to Grace Plummer",oru_ca1899feb12.xml,80444/xv33013,0,0,0,0
"Gildez (George F.) pilot books",oru_ax137.xml,80444/xv72830,0,0,0,0
"Committee on Courses records",oru_ua105.xml,80444/xv43054,0,0,0,0
"Barlow and Fuller (Grocery) ledger",oru_b179.xml,80444/xv14181,0,0,0,0
"Oregon. Legislative Assembly. Interim Committee on Study Workman's Compensation Law records",oru_bx062.xml,80444/xv13372,0,0,0,0
"Registration Committee records",oru_ua185.xml,80444/xv74407,0,0,0,0
"Stedman (Alfred Delos) scrapbooks",oru_cast31.xml,80444/xv73324,0,0,0,0
"Oregon Homestead Company records",oru_bx085.xml,80444/xv92706,0,0,0,0
"Portland Seamen's Friend Society account book",oru_b093.xml,80444/xv05929,0,0,0,0
"Cooley & Company records",oru_bx186.xml,80444/xv14309,0,0,0,0
"Chavner (Thomas) petition",oru_ca1864oct24.xml,80444/xv64398,0,0,0,0
"Parker (N.O.) letter",oru_ca1872dec21.xml,80444/xv70611,0,0,0,0
"Ridgeway (George W.) field diaries",oru_a103.xml,80444/xv81311,0,0,0,0
"Wilhoit Springs Resort records",oru_bx027.xml,80444/xv35708,0,0,0,0
"Campus Planning and Real Estate records",oru_ua058.xml,80444/xv58837,0,0,0,0
"Department of Political Science records",oru_ua068.xml,80444/xv40841,0,0,0,0
"Baker, Rawalt, and Hoffman Family papers",oru_ax007.xml,80444/xv17880,0,0,0,0
"Unknown",oru_coll421.xml,80444/xv54348,0,0,0,0
"Williams (Edward B.) letters",oru_a176.xml,80444/xv28302,0,0,0,0
"Villard Hall Centennial records",oru_ua083.xml,80444/xv61956,0,0,0,0
"Dawson (Orion B.) papers",oru_coll463.xml,80444/xv87359,0,0,0,0
"Steckel (Samuel J.) diary",oru_a117.xml,80444/xv82821,0,0,0,0
"Eakin (S. B.) diary",oru_a031.xml,80444/xv62283,0,0,0,0
"Seitz (Corwin V.) papers",oru_ax677.xml,80444/xv20642,0,0,0,0
"Spencer Hall agreement with Milwaukie, Oregon",oru_ca1865aug29.xml,80444/xv18466,0,0,0,0
"Handsaker (John Jacob) autobiography and family papers",oru_cbh192.xml,80444/xv65493,0,0,0,0
"West (George Miller) transcribed reminiscence of journey to Oregon.",oru_cbw52.xml,80444/xv04663,0,0,0,0
"Middle Sister register",oru_cam584.xml,80444/xv35629,0,0,0,0
"Neeve (James W.) letters to Janet Marshall",oru_coll380.xml,80444/xv96600,0,0,0,0
"Boehl (Victor) papers",oru_ax543.xml,80444/xv48754,0,0,0,0
"Silver Creek Recreational Area Advisory Committee records",oru_b098.xml,80444/xv86245,0,0,0,0
"Brownsville Industrial Co. ledgers",oru_b014.xml,80444/xv38101,0,0,0,0
"Peg Leg Mining and Milling Co. records",oru_b055.xml,80444/xv48171,0,0,0,0
"Phi Chi Theta records",oru_ua183.xml,80444/xv41912,0,0,0,0
"Red Star Roller Mills records",oru_b188.xml,80444/xv67056,0,0,0,0
"Columbia River Meat Co. records",oru_b017.xml,80444/xv74414,0,0,0,0
"Department of English records",oru_ua182.xml,80444/xv01486,0,0,0,0
"Barret (H. L.) letter to Thomas R. Cornelius",oru_ca1884feb24.xml,80444/xv12832,0,0,0,0
"Morton (Margaret "Peg") papers",oru_coll434.xml,80444/xv59848,0,0,0,0
"Willamette Draying and Forwarding Co. journal and day book",oru_b145.xml,80444/xv31088,0,0,0,0
"The Honey Bee newspaper issue",oru_f070h8.xml,80444/xv64129,0,0,0,0
"Portland, Oregon Merchants & Ship Owners petition",oru_ca1854nov1.xml,80444/xv46026,0,0,0,0
"Anderson (Van Winkle) papers",oru_ax113.xml,80444/xv75808,0,0,0,0
"St. Johns Waterworks and Lighting Co. records",oru_b061.xml,80444/xv67004,0,0,0,0
"Hastie (Sam T.), Cincinnati, Oh., letter to Edward Quackenbush, Portland, Oregon",oru_ca1886june7.xml,80444/xv71780,0,0,0,0
"Portland Oregon Metropolitan Study Commission records",oru_bx144.xml,80444/xv53530,0,0,0,0
"Hemenway (Ansel) diary",oru_a049.xml,80444/xv89166,0,0,0,0
"Oregon. Governor's Advisory Committee to Study Problems of Workmen's Compensation records",oru_bx128.xml,80444/xv45675,0,0,0,0
"Basinski (Julius) reminiscences and letters received",oru_a157.xml,80444/xv78308,0,0,0,0
"Women's Faculty Club records",oru_ua086.xml,80444/xv91921,0,0,0,0
"Marion County School District records",oru_b084.xml,80444/xv80267,0,0,0,0
"Fruit Growers Association of Southern Oregon record book",oru_b079.xml,80444/xv37054,0,0,0,0
"Smith (Roy K. and Lura McLane) collection of Korean missionary materials",oru_ax706.xml,80444/xv13613,0,0,0,0
"Women's Emergency Corps record book",oru_b072.xml,80444/xv61837,0,0,0,0
"Farmers' Security Bank records",oru_bx008.xml,80444/xv58462,0,0,0,0
"Smith (Delazon), Albany, O.T., letter to Aaron E. Wait",oru_ca1855sept13.xml,80444/xv51931,0,0,0,0
"Cloran (Lauretta M.) diaries",oru_ax111.xml,80444/xv90460,0,0,0,0
"Bowditch (J. T.) letter",oru_ca1887feb9.xml,80444/xv32385,0,0,0,0
"St. David's Episcopal Church, Transfiguration Social Club records",oru_b007.xml,80444/xv86511,0,0,0,0
"Oregon Southern Improvement Co. correspondence",oru_b052.xml,80444/xv44555,0,0,0,0
"Moses (Mathilde R.) letters from India",oru_ax490.xml,80444/xv23373,0,0,0,0
"Quackenbush (Edward) correspondence",oru_a101.xml,80444/xv69375,0,0,0,0
"Jardine (James Tertius) papers",oru_ax261.xml,80444/xv14596,0,0,0,0
""T. J. S." letter to Frank",oru_ca1889apr17.xml,80444/xv96295,0,0,0,0
"Holwerda (Frank) papers",oru_ax378.xml,80444/xv63574,0,0,0,0
"Funk (Mabel V.) manuscript",oru_coll367.xml,80444/xv55514,0,0,0,0
"Fisher (Steve) papers",oru_ax590.xml,80444/xv88574,0,0,0,0
"Boyce (Arthur Clifton) papers",oru_coll158.xml,80444/xv91699,0,0,0,0
"Johnathan Bourne Mining records",oru_bx187.xml,80444/xv72702,0,0,0,0
"Jackson County, Oregon Citizen's Committee petition",oru_ca1865feb1.xml,80444/xv90014,0,0,0,0
"Metcalf (T.) letter to Albert A. Durham",oru_ca1852aug14.xml,80444/xv99975,0,0,0,0
"Prairie View Congregational Church records",oru_b005.xml,80444/xv97302,0,0,0,0
"Ewry & Garnold account books",oru_b025.xml,80444/xv87649,0,0,0,0
"D'Aulaire (Edgar Parrin) lithographs and illustrations",oru_ax443.xml,80444/xv02017,0,0,0,0
"Condon (Thomas) papers",oru_ua210.xml,80444/xv24682,0,0,0,0
"Department of Computer and Information Science records",oru_ua043.xml,80444/xv72189,0,0,0,0
"Dielshneider Jewelry Store records",oru_bx182.xml,80444/xv49847,0,0,0,0
"Luelling (Seth) diary",oru_a071.xml,80444/xv16296,0,0,0,0
"Guttery (Arthur M.) papers",oru_coll027.xml,80444/xv66706,0,0,0,0
"Nathan (Paul S.) production reports",oru_ax354.xml,80444/xv48715,0,0,0,0
"Nathan (Tonie) papers",oru_coll328.xml,80444/xv04113,0,0,0,0
"Caufield (Robert) papers",oru_a016.xml,80444/xv51770,0,0,0,0
"McMahan (Leonard H.) papers",oru_ax064.xml,80444/xv37170,0,0,0,0
"Stephens-Weatherford Co. record",oru_b068.xml,80444/xv33056,0,0,0,0
"Wire (Melville T.) diaries",oru_a136.xml,80444/xv40588,0,0,0,0
"Northern Pacific Coal Mining Company prospectus",oru_ca1873mar25.xml,80444/xv06781,0,0,0,0
"Williams (Thorton F.) letters patent",oru_ca1881aug2.xml,80444/xv12774,0,0,0,0
"Douglas (James) journal",oru_a029.xml,80444/xv07586,0,0,0,0
"Allen and Lewis records",oru_bx002.xml,80444/xv45465,0,0,0,0
"Graham (John G.) photographs",oru_ph200_045.xml,80444/xv62949,0,0,0,0
"Burns (Edward) letter to James Boyle",oru_ca1862dec18.xml,80444/xv11923,0,0,0,0
"Heritage Documentation Programs records: Historic American Buildings Survey and Historic American Engineering photographs",oru_ph314.xml,80444/xv41656,0,0,0,0
"Gellert (Nathan H.) papers",oru_ax038.xml,80444/xv07980,0,0,0,0
"Watt (Ahio S.) description of school district boundaries",oru_ca1857mar24.xml,80444/xv65826,0,0,0,0
"Junction City Realty Company records",oru_bx100.xml,80444/xv73614,0,0,0,0
"Oregon Roadside Council records",oru_bx126.xml,80444/xv95632,0,0,0,0
"Northwest Public Power Association records",oru_bx145.xml,80444/xv82742,0,0,0,0
"Lownsdale (Daniel H.) letter to Aaron E. Wait",oru_ca1853feb1.xml,80444/xv47561,0,0,0,0
"Cannon (Colbert Hanchett) day books",oru_ax122.xml,80444/xv03729,0,0,0,0
"Center on Diversity and Community records",oru_ua103.xml,80444/xv60150,0,0,0,0
"Forest Industries Radio Communications records",oru_bx064.xml,80444/xv43377,0,0,0,0
"Italian American Bank records",oru_b036.xml,80444/xv63360,0,0,0,0
"Corbett, Failing, and Company records",oru_bx191.xml,80444/xv29534,0,0,0,0
"Culver (C. S.) letter",oru_ca1889oct20.xml,80444/xv74667,0,0,0,0
"U.S. Treasury Department, Third Auditor's Office records",oru_ca1881mar30.xml,80444/xv27679,0,0,0,0
"Harris (Lawrence T.) correspondence",oru_a273.xml,80444/xv38711,0,0,0,0
"Grimes (Lyle) collection relating to Jazz",oru_coll083.xml,80444/xv68612,0,0,0,0
"Andrus (Leonard A.) papers",oru_a006.xml,80444/xv72897,0,0,0,0
"Office of Institutional Research records",oru_ua124.xml,80444/xv88333,0,0,0,0
"Oregon. Legislative Assembly. Interim Committee on Technical Unemployment records",oru_bx129.xml,80444/xv35665,0,0,0,0
"Morse (Amos) correspondence",oru_a159.xml,80444/xv87078,0,0,0,0
"International House records",oru_ua094.xml,80444/xv14123,0,0,0,0
"Micronesia and South Pacific Program records",oru_ua092.xml,80444/xv36434,0,0,0,0
"Eugene Women's Crisis Center records",oru_coll313.xml,80444/xv68173,0,0,0,0
"Oregon Camera Club resolution",oru_ca1899june7.xml,80444/xv23718,0,0,0,0
"Office of Affirmative Action and Equal Opportunity records",oru_ua036.xml,80444/xv61505,0,0,0,0
"Multnomah School District Number 1 records",oru_sfm246.xml,80444/xv10766,0,0,0,0
"Bricklayers Union, Eugene Chapter records",oru_coll415.xml,80444/xv30160,0,0,0,0
"Weatherford (John Knox Jr.) papers",oru_ax062.xml,80444/xv02194,0,0,0,0
"Ludekens (Fred) papers",oru_ax779.xml,80444/xv60247,0,0,0,0
"Bradford (Jacob A.) papers",oru_ax119.xml,80444/xv42169,0,0,0,0
"Bellfountain Class Church record book",oru_b001.xml,80444/xv74548,0,0,0,0
"Collins (Dean) papers",oru_coll461.xml,80444/xv86349,0,0,0,0
"Office of the President: Arnold Bennett Hall records",oru_ua001_005.xml,80444/xv67941,0,0,0,0
"Johnson (Melchi) letter",oru_ca1869aug30.xml,80444/xv56515,0,0,0,0
"Baker (Samm S.) papers",oru_ax327.xml,80444/xv52740,0,0,0,0
"Blue Mountain Consolidated Wagon Road Co. articles of incorporation",oru_ca1868july18.xml,80444/xv17532,0,0,0,0
"Marshall (W. H.) blacksmith account books",oru_b046.xml,80444/xv95309,0,0,0,0
"Department of Romance Languages records",oru_ua072.xml,80444/xv54656,0,0,0,0
"Teal (Joseph Nathan) manuscript",oru_cbt221.xml,80444/xv51135,0,0,0,0
"Durham family papers",oru_coll383.xml,80444/xv09500,0,0,0,0
"Bowermeister (Simon R.) letters to Harriet A. McConnell",oru_a173.xml,80444/xv29739,0,0,0,0
"Oregon. Governor's Committee for the Oregon Museum of History, Science, and Industry records",oru_b106.xml,80444/xv77584,0,0,0,0
"Committee on Status of Women records",oru_ua187.xml,80444/xv60360,0,0,0,0
"Safety Advisory Committee records",oru_ua066.xml,80444/xv58694,0,0,0,0
"Wichman (Frederick W.) diaries and letters",oru_a152.xml,80444/xv32955,0,0,0,0
"Thompson (Robert) letter to William Stephens",oru_ca1854jan9.xml,80444/xv39855,0,0,0,0
"Clarke (Samuel Asahel) papers",oru_cbc556h.xml,80444/xv82662,0,0,0,0
"Pacific Northwest Development Association records",oru_bx143.xml,80444/xv15081,0,0,0,0
"Vancouver Transportation Co. records",oru_b119.xml,80444/xv70755,0,0,0,0
"Karzag (Leo) Papers",oru_coll172.xml,80444/xv67392,0,0,0,0
"Waterhouse (Warren) papers",oru_ca1896june8.xml,80444/xv75735,0,0,0,0
"Salem, Oregon Muscovite Club minutes",oru_b150.xml,80444/xv90475,0,0,0,0
"Walker (George W.) letters",oru_a154.xml,80444/xv73184,0,0,0,0
"Cuthbert (Frederick A.) faculty papers",oru_ua227.xml,80444/xv40792,0,0,0,0
"Hewett, Flowerdew and Co. letter to Thomas R. Cornelius",oru_ca1871oct18.xml,80444/xv25769,0,0,0,0
"Publication Committee records",oru_ua186.xml,80444/xv66857,0,0,0,0
"Failing (Josiah) petition to the County Board of Commissioners",oru_ca1853aug15.xml,80444/xv08483,0,0,0,0
"Zehntbauer (J. A.) letter to J. L. Krantz",oru_ca1917nov16.xml,80444/xv83749,0,0,0,0
"Nott (Earl Ashby) political correspondence",oru_a168.xml,80444/xv52886,0,0,0,0
"Halsey Building Association financial records",oru_b031.xml,80444/xv42565,0,0,0,0
"Committee on Appointments records",oru_ua194.xml,80444/xv36840,0,0,0,0
"Grover (A. J.) letter to Edwin Beebe",oru_ca1862dec17.xml,80444/xv24621,0,0,0,0
"U.S. Office of Indian Affairs. Warm Springs Agency, Or. letterpress copybook",oru_b143.xml,80444/xv01055,0,0,0,0
"Clackamas County precinct records",oru_ca1857june1.xml,80444/xv65173,0,0,0,0
"Moores (Althea) diary",oru_a081.xml,80444/xv88180,0,0,0,0
"Ingalls (Davis) mortgage deed",oru_ca1857may1.xml,80444/xv52154,0,0,0,0
"Gulick (Grover Cleveland "Bill") papers",oru_ax694.xml,80444/xv93603,0,0,0,0
"Grelle family papers",oru_ax221.xml,80444/xv90472,0,0,0,0
"Holmes (William) notice",oru_ca1854mar8.xml,80444/xv22824,0,0,0,0
"Landreth (Earl) papers",oru_ax480.xml,80444/xv26980,0,0,0,0
"Johnson (F.M.) papers",oru_ca1866mar29.xml,80444/xv25558,0,0,0,0
"Simon Realty Co. records",oru_b066.xml,80444/xv76174,0,0,0,0
"Ettelson (Lee) and Hearst (William Randolph) correspondence",oru_a278.xml,80444/xv53555,0,0,0,0
"Herman (Binger) letter",oru_ca1925feb2.xml,80444/xv09088,0,0,0,0
"Mission Bottom Parent Teacher Association minutes",oru_b160.xml,80444/xv97323,0,0,0,0
"Carter (George E. Jr.) papers",oru_ax572.xml,80444/xv06338,0,0,0,0
"J.E. Haseltine and Co. records",oru_bx152.xml,80444/xv04751,0,0,0,0
"Seely (Alvane Cary) papers",oru_ax266.xml,80444/xv21984,0,0,0,0
"Eisenschiml (Otto) manuscripts",oru_f923ei84.xml,80444/xv04281,0,0,0,0
"Educational Activities Board records",oru_ua173.xml,80444/xv52377,0,0,0,0
"Talbert (Harlin) papers",oru_ax632.xml,80444/xv59835,0,0,0,0
"Chamberlin (Mark A.) papers",oru_ax592.xml,80444/xv43875,0,0,0,0
"Linn County, Oregon School District No. 74 clerk's record book",oru_bx041.xml,80444/xv57620,0,0,0,0
"Spokane Terminal Company articles of agreement",oru_ca1905july10.xml,80444/xv52621,0,0,0,0
"McNary (Charles Linza) papers",oru_ax049.xml,80444/xv13998,0,0,0,0
"Cunningham (Hazel M.) papers",oru_coll411.xml,80444/xv34381,0,0,0,0
"Connell (G. W.) letter",oru_ca1873mar4.xml,80444/xv33447,0,0,0,0
"Dickinson (A. D.) letter to Thomas McFatton Patton,",oru_ca1875july4.xml,80444/xv71426,0,0,0,0
"Metcalf (T.) memorandum of agreement",oru_ca1852feb19.xml,80444/xv61090,0,0,0,0
"Department of German and Scandinavian records",oru_ua181.xml,80444/xv06399,0,0,0,0
"Young, (Henry W.) papers",oru_bx156.xml,80444/xv57345,0,0,0,0
"Hudson's Bay Company Journal of events at Stuart Lake",oru_b034.xml,80444/xv05209,0,0,0,0
"Oregon. Oregon. Legislative Assembly. Interim Committee of Judicial Administration records",oru_bx061.xml,80444/xv64071,0,0,0,0
"Harvey (James R.) papers",oru_ax144.xml,80444/xv05548,0,0,0,0
"Oregon Territory treasurer records",oru_ca1848apr8.xml,80444/xv41885,0,0,0,0
"Dye (Eva Emery) letter to Fred Lockley",oru_ca1922june19.xml,80444/xv32589,0,0,0,0
"Herman (Binger) Papers",oru_ax045.xml,80444/xv86614,0,0,0,0
"Block (Lawrence) manuscripts",oru_ax518.xml,80444/xv05862,0,0,0,0
"U. S. Pension Bureau record of examinations",oru_b141.xml,80444/xv00408,0,0,0,0
"Oregon Steamship Company bill of lading",oru_ca1878sept26.xml,80444/xv50985,0,0,0,0
"McArthur (Harriet Nesmith) diary",oru_a073.xml,80444/xv69113,0,0,0,0
"U.S. Bureau of Reclamation Project histories",oru_bx063.xml,80444/xv22225,0,0,0,0
"Johnson (Herbert S. ) scrapbook",oru_a190.xml,80444/xv54730,0,0,0,0
"Department of Speech records",oru_ua191.xml,80444/xv29351,0,0,0,0
"Multomah County School District records",oru_b102.xml,80444/xv74365,0,0,0,0
"Oregon. Legislative Assembly. Interim Committee on Social Problems records",oru_bx107.xml,80444/xv98602,0,0,0,0
"Eastern Oregon steamship log",oru_b131.xml,80444/xv62442,0,0,0,0
"Bishop (Elizabeth) correspondence and book of poetry",oru_a214.xml,80444/xv87985,0,0,0,0
"Giustina (Mazie) papers",oru_coll377.xml,80444/xv35198,0,0,0,0
"Wellington (William Fursuar) letters",oru_a196.xml,80444/xv02911,0,0,0,0
,,Totals,12774,14762,16533,44069
