Title,Document Name,Ark Identifier,July,August,September,Total
"University of Utah historical faculty files",uum_acc0526.xml,80444/xv51861,177,268,176,621
"Everett L. Cooley oral history project",uum_accn0814.xml,80444/xv48007,57,66,87,210
"John Willard and Alice Sheets Marriott papers",uum_ms0164.xml,80444/xv52987,73,55,68,196
"Wallace Earle Stegner papers",uum_ms0676.xml,80444/xv32055,58,53,73,184
"George Albert Smith Family photograph collection",uum_p0036.xml,80444/xv89669,63,75,43,181
"Joseph Ellis Johnson papers",uum_ms0110.xml,80444/xv99313,54,69,43,166
"Doris Duke oral history project",uum_ms0417.xml,80444/xv34603,34,62,66,162
"Hiram B. Clawson papers",uum_ms0040.xml,80444/xv59963,27,38,88,153
"Orrin Hatch papers",uum_accn0527.xml,80444/xv76876,33,58,61,152
"Ballet archives photograph collection",uum_p0247.xml,80444/xv73181,56,51,43,150
"Park City Mountain Resort audio-visual collection",uum_a0664.xml,80444/xv99234,53,40,56,149
"Mormon settlements in Arizona collection",uum_ms0034.xml,80444/xv44747,57,43,47,147
"James D. Wardle papers",uum_ms0578.xml,80444/xv51220,30,32,85,147
"Scott G. Kenney collection",uum_ms0587.xml,80444/xv20471,35,26,82,143
"Greek Archives photograph collection",uum_p0121.xml,80444/xv53781,46,58,38,142
"William Lee Stokes papers",uum_ms0675.xml,80444/xv24588,32,51,57,140
"Saving the Legacy oral history project",uum_accn2070.xml,80444/xv77258,36,63,35,134
"John Taylor family papers",uum_ms0050.xml,80444/xv26409,35,45,47,127
"Henry Chariton and Alberta Marie Larsen Jacobs papers",uum_accn2082.xml,80444/xv00216,42,61,21,124
"Herbert E. Gregory photograph collection",uum_p0013.xml,80444/xv18865,54,24,44,122
"Spanish-speaking peoples in Utah oral histories",uum_ms0096.xml,80444/xv23580,30,54,38,122
"Utah folklore collection",uum_ms0488.xml,80444/xv99243,45,47,29,121
"Tina Gonzales Garcia family video collection",uum_a0997.xml,80444/xv50473,33,67,19,119
"Preston Nutter Corporation records",uum_ms0289.xml,80444/xv81304,37,33,39,109
"Uranium mining oral history project",uum_accn1322.xml,80444/xv03439,36,32,41,109
"Salt Lake Tribune records",uum_accn2497.xml,80444/xv11221,31,36,42,109
"Alan K. Engen photograph collection",uum_p0413.xml,80444/xv31549,42,31,36,109
"H. Michael Marquardt papers",uum_accn0900.xml,80444/xv20324,29,37,41,107
"Fawn McKay Brodie papers",uum_ms0360.xml,80444/xv55810,27,35,42,104
"Salt Lake Organizing Committee for the Olympic Winter Games records",uum_accn1457.xml,80444/xv15530,24,34,45,103
"Doris Duke American Indian oral history project audio recordings",uum_a0001.xml,80444/xv82321,23,38,42,103
"John Mills Whitaker papers",uum_ms0002.xml,80444/xv46572,34,39,27,100
"Mervin B. Hogan papers",uum_ms0241.xml,80444/xv99462,28,26,45,99
"Dinwoodey Furniture Company photograph collection",uum_p0273.xml,80444/xv47314,34,32,31,97
"Everett Cooley photograph collection",uum_p0024.xml,80444/xv34817,96,0,1,97
"John Lowry Sr. and John Lowry Jr. biographies",uum_ms0306.xml,80444/xv45367,39,34,23,96
"Louise Degn broadcast journalism audio-visual collection",uum_a0747.xml,80444/xv16961,23,39,32,94
"Frank Herman Jonas collection",uum_ms0641.xml,80444/xv80920,30,38,25,93
"Madeline R. McQuown papers",uum_ms0143.xml,80444/xv81979,40,29,21,90
"Helen Zeese Papanikolas papers",uum_ms0471.xml,80444/xv64083,27,39,22,88
"Holy Cross Hospital records",uum_accn0588.xml,80444/xv02267,31,28,29,88
"Cooley Family photograph collection",uum_p0339.xml,80444/xv36508,32,42,13,87
"B. H. Roberts papers",uum_ms0106.xml,80444/xv66726,29,31,24,84
"Olive Woolley Burt photograph collection",uum_p0244.xml,80444/xv41589,26,33,25,84
"Keith B. Farr radio history audio collection",uum_a0917.xml,80444/xv40939,31,28,25,84
"Daughters of Utah Pioneers Camp 33 records",uum_ms0284.xml,80444/xv82281,33,32,18,83
"David Eccles photograph collection",uum_p0288.xml,80444/xv43734,34,30,19,83
"Nathan Tanner papers",uum_ms0020.xml,80444/xv95202,19,19,44,82
"George A. Smith family papers",uum_ms0036.xml,80444/xv66580,24,27,30,81
"Willem J. Kolff papers",uum_ms0654.xml,80444/xv39526,24,42,14,80
"Edward Hunter papers",uum_ms0358.xml,80444/xv24221,13,23,43,79
"George Martin Ottinger papers",uum_ms0123.xml,80444/xv04003,16,20,40,76
"Sterling M. McMurrin papers",uum_ms0032.xml,80444/xv43511,24,14,38,76
"Margaret McNeil Ballard papers",uum_ms0126.xml,80444/xv62670,20,48,8,76
"Frank E. Moss papers",uum_ms0146.xml,80444/xv31054,26,38,12,76
"Amil Quayle home movies",uum_a0586.xml,80444/xv61608,10,57,9,76
"Robert H. Hinckley papers",uum_ms0102.xml,80444/xv39416,28,34,14,76
"Joseph Desloge river running video collection",uum_a0641.xml,80444/xv99707,24,26,25,75
"Joseph Smith Senior patriarchal blessing book records",uum_accn2400.xml,80444/xv90045,25,21,27,73
"Frederick Kesler papers",uum_ms0049.xml,80444/xv16976,39,17,17,73
"Federal Resources Corporation records",uum_accn1513.xml,80444/xv29406,28,22,22,72
"Jewish oral history project audio recordings",uum_a0324.xml,80444/xv91470,38,16,16,70
"Craig Wirth broadcast journalism audio-visual collection",uum_a0355.xml,80444/xv91625,30,19,21,70
"Philo T. and Elma G. Farnsworth papers",uum_ms0648.xml,80444/xv98312,21,22,26,69
"KUED-TV productions audio-visual collection",uum_a0431.xml,80444/xv94869,14,21,33,68
"Heber Q. Hale manifestation transcript",uum_accn0287.xml,80444/xv77502,20,26,21,67
"University of Utah Ski Team photograph collection",uum_p0372.xml,80444/xv30368,23,18,26,67
"David C. Evans audio-visual collection",uum_a0159.xml,80444/xv84585,27,20,20,67
"Sunstone Foundation records",uum_accn0932.xml,80444/xv15863,25,23,19,67
"Interviews with Jews in Utah collection",uum_accn0998.xml,80444/xv70657,30,22,14,66
"Don B. Olsen papers",uum_accn2676.xml,80444/xv77236,27,25,14,66
"Dead Goat Saloon records",uum_accn2370.xml,80444/xv40975,18,21,26,65
"Andrew Jackson Allen diary",uum_ms0392.xml,80444/xv05957,58,1,5,64
"Leroy J. Robertson papers",uum_ms0038.xml,80444/xv25411,23,28,13,64
"Wasatch Mountain Club records",uum_ms0283.xml,80444/xv79742,14,8,41,63
"Daughters of Utah Pioneers, Phillips Camp biographies",uum_accn1439.xml,80444/xv20547,17,23,23,63
"Native American oral histories audio recordings",uum_a0874.xml,80444/xv00604,13,23,26,62
"Joe Hill photograph collection",uum_p0427.xml,80444/xv97778,27,9,26,62
"Jonathan Coleman photograph collection",uum_p0530.xml,80444/xv55798,15,30,17,62
"Alton Crane Melville family home movies",uum_a0655.xml,80444/xv73236,29,7,24,60
"Norman D. and Doris Nevills photograph collection",uum_p0341.xml,80444/xv17126,18,20,22,60
"Alvin L. Gittins photograph collection",uum_p0319.xml,80444/xv19924,23,22,15,60
"Melissa Jane Caldwell Adams family papers",uum_ms0082.xml,80444/xv75906,27,20,12,59
"Salt Lake City, Utah photograph collection",uum_p0251.xml,80444/xv68270,24,19,16,59
"Melvin A. Cook papers",uum_ms0658.xml,80444/xv56417,18,24,16,58
"Henry Eyring papers",uum_ms0008.xml,80444/xv56402,23,17,18,58
"David C. Evans papers",uum_ms0625.xml,80444/xv18380,20,20,17,57
"Ramona Wilcox Cannon papers",uum_accn1862.xml,80444/xv88702,19,21,16,56
"David Oman McKay papers",uum_ms0668.xml,80444/xv89685,17,19,19,55
"Rudger Clawson papers",uum_ms0481.xml,80444/xv59097,21,19,15,55
"A. Russell Mortensen papers",uum_ms0201.xml,80444/xv41024,25,18,11,54
"George S. Tanner papers",uum_accn1361.xml,80444/xv55130,15,12,27,54
"University of Utah Alumni Association records",uum_acc0437.xml,80444/xv12820,28,12,14,54
"Mike M. Masaoka papers",uum_ms0656.xml,80444/xv25720,19,12,23,54
"Shirley E. Blackmer and R. Lloyd Tyler family papers",uum_accn2871.xml,80444/xv63009,3,46,5,54
"Taylor A. Woolley papers",uum_ms0452.xml,80444/xv65252,16,7,31,54
"Stephen David Durrant papers",uum_acc0214.xml,80444/xv15304,15,31,8,54
"Interviews with Blacks in Utah",uum_ms0453.xml,80444/xv24758,17,13,24,54
"Wilbur H. Smith papers",uum_ms0563.xml,80444/xv22250,3,10,40,53
"Ammon Hennacy papers",uum_ms0555.xml,80444/xv79608,15,16,22,53
"Blair Dean Utah natural bodybuilding video collection",uum_a0077.xml,80444/xv99673,21,14,18,53
"Don Gale KSL editorial video collection",uum_a1055.xml,80444/xv26831,14,18,21,53
"Francis Armstrong family papers",uum_accn1795.xml,80444/xv71011,18,20,15,53
"Ute Indian oral history project collection",uum_accn0853.xml,80444/xv59539,14,11,27,52
"Marriner S. Eccles papers",uum_ms0178.xml,80444/xv88424,19,19,14,52
"Tesuque Pueblo oral history project",uum_accn2200.xml,80444/xv73449,17,19,16,52
"Earl Douglass papers",uum_ms0196.xml,80444/xv14910,12,20,20,52
"Utah Ski Archives Annual Banquet Photograph Archives",uum_p0397.xml,80444/xv22817,24,18,10,52
"Wallace Earle Stegner photograph collection",uum_p0561.xml,80444/xv35256,18,17,16,51
"James T. Harwood photograph collection",uum_p0117.xml,80444/xv53634,18,17,16,51
"Green River, Utah photograph collection",uum_p0077.xml,80444/xv79364,11,17,23,51
"Camp Kearns records",uum_accn1126.xml,80444/xv01785,26,11,14,51
"Karsten Hansen architectural landscape drawings",uum_accn1728.xml,80444/xv33462,20,19,12,51
"Golden Spike oral history project",uum_ms0095.xml,80444/xv31866,20,20,10,50
"University of Utah football video collection",uum_a0319.xml,80444/xv56124,21,7,22,50
"First Unitarian Church of Salt Lake City records",uum_ms0508.xml,80444/xv38778,13,22,14,49
"Edward Abbey audio collection",uum_a0779.xml,80444/xv41323,28,7,14,49
"Interviews with Japanese Americans in Utah",uum_accn1209.xml,80444/xv45901,12,20,17,49
"Trent Harris independent film collection",uum_a0832.xml,80444/xv49707,11,21,16,48
"Brigham Young papers",uum_ms0566.xml,80444/xv64971,17,18,13,48
"Stephen David Durrant papers",uum_ms0608.xml,80444/xv31304,13,28,7,48
"Musser, Betty Shepherd photograph collection",uum_p0340.xml,80444/xv40219,17,23,7,47
"Utah Humanities Research Foundation records",uum_ms0044.xml,80444/xv47195,11,9,27,47
"Hotel Utah photograph collection",uum_p0283.xml,80444/xv88323,20,15,12,47
"Alton Morton independent film collection",uum_a0320.xml,80444/xv53997,13,13,21,47
"Kenneth Bitner Castleton photograph collection",uum_p0334.xml,80444/xv93087,13,17,17,47
"David Nelson papers",uum_accn2713.xml,80444/xv14035,7,16,24,47
"Jacob Myers Sr. papers",uum_accn2505.xml,80444/xv70516,17,19,10,46
"Utah Pride Center records",uum_accn1918.xml,80444/xv19549,9,23,13,45
"Karl Vernon King papers",uum_ms0199.xml,80444/xv14614,13,24,7,44
"Henry Eyring photograph collection",uum_p0250.xml,80444/xv79498,18,15,11,44
"Duane E. Jeffery papers",uum_accn1372.xml,80444/xv27096,10,15,18,43
"Marriner S. Eccles photograph collection",uum_p0178.xml,80444/xv32366,16,10,17,43
"Preston Nutter Corporation photograph collection",uum_p0289.xml,80444/xv62582,15,9,19,43
"Walter Daniel Bonner family papers",uum_ms0269.xml,80444/xv13433,9,17,17,43
"E. Richard Hart papers",uum_accn1251.xml,80444/xv46463,10,11,22,43
"Edwin Brown Firmage papers",uum_accn1074.xml,80444/xv71646,9,19,15,43
"Ivy Baker Priest photograph collection",uum_p0163.xml,80444/xv84121,15,18,9,42
"Mexican Hat Expeditions Grand Canyon river trip video",uum_a0171.xml,80444/xv92102,10,14,18,42
"Alfred Douglas Young papers",uum_ms0292.xml,80444/xv14456,23,10,9,42
"Mary Jane Mount Tanner papers",uum_ms0200.xml,80444/xv09561,10,20,12,42
"Japanese oral histories",uum_accn0806.xml,80444/xv95172,6,20,16,42
"L. John Nuttall diaries",uum_ms0631.xml,80444/xv26303,13,9,19,41
"Jewish archives",uum_ms0224.xml,80444/xv05032,4,23,14,41
"Peter Edward Gibbs oral history audio recordings",uum_a0922.xml,80444/xv65264,13,15,13,41
"Hispanic oral histories",uum_accn1369.xml,80444/xv46923,11,13,17,41
"River Boat photograph collection",uum_p0063.xml,80444/xv95962,10,11,19,40
"Lowell S. Blaisdell papers",uum_accn0656.xml,80444/xv77075,18,11,11,40
"Lowry Nelson papers",uum_ms0115.xml,80444/xv80172,15,12,13,40
"Peter L. Goss papers",uum_accn0447.xml,80444/xv20492,21,11,8,40
"Richard Wright Young papers",uum_ms0536.xml,80444/xv65921,10,16,14,40
"Reed C. Durham papers",uum_accn0444.xml,80444/xv87060,15,11,13,39
"Hope A. Hilton papers",uum_ms0584.xml,80444/xv19268,17,8,14,39
"Roy P. Full papers",uum_accn1688.xml,80444/xv07598,16,12,11,39
"Fawn McKay Brodie audio-visual collection",uum_a0026.xml,80444/xv22158,14,13,12,39
"Sonia Johnson papers",uum_ms0287.xml,80444/xv47851,15,16,8,39
"Brigham D. Madsen papers",uum_ms0671.xml,80444/xv12445,11,10,17,38
"Ashton, Evans, and Brazier architectural blueprints",uum_ms0499.xml,80444/xv15509,12,12,14,38
"University of Utah Alumni Association records",uum_acc0508.xml,80444/xv49716,19,5,14,38
"Rocky Mountain Power Company records",uum_ms0206.xml,80444/xv10003,14,14,10,38
"David J. Buerger papers",uum_ms0622.xml,80444/xv54592,7,16,15,38
"University of Utah basketball films collection",uum_a0002.xml,80444/xv48165,10,17,11,38
"Isaac Bullock family papers",uum_ms0005.xml,80444/xv30215,16,14,8,38
"Helen B. Andelin audio collection",uum_a0754.xml,80444/xv08261,9,14,14,37
"YourStory oral history project audio recordings",uum_a0902.xml,80444/xv96380,19,9,9,37
"Ethnic archives oral histories audio recordings",uum_a0853.xml,80444/xv66183,5,20,12,37
"Eugene England papers",uum_accn2426.xml,80444/xv08175,9,18,10,37
"Wataru Misaka papers",uum_accn2761.xml,80444/xv01376,13,17,7,37
"Frederick Herzberg papers",uum_accn1592.xml,80444/xv73168,14,10,13,37
"William Dawson photograph collection",uum_p0031.xml,80444/xv92138,10,18,9,37
"Henry Eyring papers",uum_ms0477.xml,80444/xv12634,7,18,11,36
"Voices of American homemakers oral history project audio recordings",uum_a0138.xml,80444/xv95971,10,12,14,36
"Dean R. Brimhall papers",uum_ms0114.xml,80444/xv80871,15,11,10,36
"Bamberger Family photograph collection",uum_p0225.xml,80444/xv35751,11,9,16,36
"Wallace Parker drawings",uum_accn2519.xml,80444/xv56979,11,12,13,36
"J. Bracken Lee papers",uum_ms0037.xml,80444/xv79589,26,4,6,36
"McCammon Investment Company records",uum_accn1962.xml,80444/xv30258,19,2,15,36
"Maud May Babcock photograph collection",uum_p0083.xml,80444/xv02252,18,8,10,36
"Alta Club photograph collection",uum_p0254.xml,80444/xv62234,11,16,9,36
"Lowell Lindsay Bennion papers",uum_accn1065.xml,80444/xv36557,8,8,20,36
"Alf Engen ski video collection",uum_a0391.xml,80444/xv37814,9,9,18,36
"Utah Postcards photograph collection",uum_p0591.xml,80444/xv33377,18,9,9,36
"African American oral history project",uum_accn2840.xml,80444/xv32818,11,15,9,35
"Alberta Hunt Nicholson papers",uum_accn1017.xml,80444/xv89212,18,6,11,35
"Willem J. Kolff audio-visual collection",uum_a0333.xml,80444/xv57766,21,6,8,35
"William Henry Chamberlin papers",uum_accn0846.xml,80444/xv16723,4,5,26,35
"Edward G. Lueders papers",uum_accn1207.xml,80444/xv31280,14,11,10,35
"Parker M. Nielson papers",uum_accn1642.xml,80444/xv92071,7,11,16,34
"Tom McCarty autobiography",uum_ms0090.xml,80444/xv35775,10,13,11,34
"Allen Publishing Company photograph collection",uum_p0021.xml,80444/xv14935,8,12,14,34
"Ivy Baker Priest papers",uum_ms0163.xml,80444/xv78616,11,6,17,34
"Andrew Wood Cooley family papers",uum_ms0567.xml,80444/xv88366,13,18,3,34
"Rick Reese mountaineering audio collection",uum_a0151.xml,80444/xv90350,9,10,15,34
"Louis S. Goodman audio-visual collection",uum_a0310.xml,80444/xv60766,7,9,18,34
"Thatcher family papers",uum_ms0538.xml,80444/xv06680,11,11,11,33
"Ogden Regional Family History Center records",uum_accn2491.xml,80444/xv04617,7,16,10,33
"Frank B. Salisbury papers",uum_accn1778.xml,80444/xv35620,9,13,11,33
"Alf Engen papers",uum_accn1006.xml,80444/xv43640,10,16,7,33
"Annie Wells Cannon papers",uum_accn1240.xml,80444/xv32946,11,4,18,33
"William Greenwood papers",uum_ms0195.xml,80444/xv23352,9,17,7,33
"Bennion family papers",uum_ms0251.xml,80444/xv98718,14,10,9,33
"Ismael Rojas independent film collection",uum_a0768.xml,80444/xv53826,10,14,9,33
"Wallace F. Bennett papers",uum_ms0290.xml,80444/xv62390,5,17,11,33
"Greek archives",uum_ms0530.xml,80444/xv89364,12,8,12,32
"Utah ballet archives",uum_ms0247.xml,80444/xv09997,16,9,7,32
"Maurice Abravanel papers",uum_ms0517.xml,80444/xv99697,6,10,16,32
"Golden Spike Centennial records",uum_accn0441.xml,80444/xv71569,9,14,9,32
"Thomas Leiper Kane papers",uum_ms0227.xml,80444/xv05563,15,11,6,32
"Frederick Stewart Buchanan photograph collection",uum_p0573.xml,80444/xv45852,6,14,12,32
"Wasatch Mountain Club photograph collection",uum_p0004.xml,80444/xv03356,13,10,9,32
"Italian oral history project audio recordings",uum_a0305.xml,80444/xv39376,9,14,9,32
"Wick R. Miller papers",uum_accn1916.xml,80444/xv06176,14,16,2,32
"Emmeline B. Wells diaries",uum_accn1520.xml,80444/xv72198,15,13,4,32
"Aziz Suryal Atiya papers",uum_accn0480.xml,80444/xv99560,4,11,16,31
"Marilyn Bradshaw Reagan papers",uum_accn2640.xml,80444/xv44702,10,11,10,31
"C.W. Carter photograph collection",uum_p0366.xml,80444/xv86685,12,13,6,31
"Jan Andrews independent film collection",uum_a0760.xml,80444/xv79214,8,18,5,31
"Sterling McMurrin audio collection",uum_a0003.xml,80444/xv30386,2,8,20,30
"Nauvoo Masonic Lodge minutes",uum_accn2340.xml,80444/xv03271,15,6,9,30
"Zuni land claims cases records",uum_accn1200.xml,80444/xv28125,11,10,9,30
"Charles Kelly papers",uum_ms0100.xml,80444/xv66253,9,12,9,30
"Francis Armstrong photograph collection",uum_p0526.xml,80444/xv52618,7,19,4,30
"J. Calvin Giddings papers",uum_ms0430.xml,80444/xv23925,17,6,7,30
"Frederick Stewart Buchanan papers",uum_accn0379.xml,80444/xv81231,8,7,14,29
"Wesley Pratt Larsen papers",uum_accn1432.xml,80444/xv93395,8,17,4,29
"Marie Barker Nelson music recordings",uum_a0437.xml,80444/xv16058,12,11,6,29
"Hatch River Expeditions video collection",uum_a0529.xml,80444/xv65808,5,13,11,29
"George Whitaker autobiography",uum_ms0278.xml,80444/xv10131,5,13,11,29
"Carbon County oral history project",uum_accn1479.xml,80444/xv38397,7,9,13,29
"Ramiro Cortés music recordings",uum_a0264.xml,80444/xv18325,21,2,6,29
"Marvin A. Melville family home movies",uum_a1128.xml,80444/xv91687,4,8,17,29
"LandSpeed Productions Bonneville Salt Flats racing films",uum_a0078.xml,80444/xv97708,6,14,9,29
"John Cheney family papers",uum_accn0071.xml,80444/xv90518,11,12,6,29
"Webster Elementary School photograph collection",uum_p0321.xml,80444/xv23916,5,10,14,29
"University of Utah Archival photograph collection",uum_p0305.xml,80444/xv28308,14,6,8,28
"S. Lyman Tyler papers",uum_ms0042.xml,80444/xv58050,10,9,9,28
"John W. Sugden papers",uum_accn2720.xml,80444/xv23205,15,5,8,28
"Joseph Don Carlos Young family papers",uum_ms0465.xml,80444/xv51797,11,5,12,28
"Dorothee Kocks oral histories",uum_accn1594.xml,80444/xv49346,9,16,3,28
"Calumet Mining and Refining Company records",uum_accn2622.xml,80444/xv89157,7,13,8,28
"Barney B. Clark papers",uum_ms0670.xml,80444/xv15817,16,5,7,28
"Albert Carrington papers",uum_ms0549.xml,80444/xv68994,5,10,12,27
"Ross C. "Rocky" Anderson papers",uum_accn2460.xml,80444/xv44873,10,7,10,27
"Southeastern Utah oral histories",uum_accn1868.xml,80444/xv30773,4,8,15,27
"Lisle Brown papers",uum_ms0570.xml,80444/xv82040,0,3,24,27
"Ralph Vary Chamberlin papers",uum_accn0907.xml,80444/xv30163,7,8,12,27
"Brigham Young University oral history projects",uum_ms0268.xml,80444/xv03369,6,9,12,27
"Utah Salt Flats Racing Association records",uum_accn2304.xml,80444/xv10513,0,23,4,27
"MX Information Center records",uum_ms0527.xml,80444/xv63006,7,10,10,27
"Native American photograph collection",uum_p0064.xml,80444/xv25430,9,12,6,27
"Oliver Lee Robinson diary",uum_ms0024.xml,80444/xv21746,16,5,6,27
"David Pierpont Gardner presidential records",uum_acc0387.xml,80444/xv76718,11,6,9,26
"William Fotheringham papers",uum_accn1095.xml,80444/xv11209,13,10,3,26
"Kennecott Copper Corporation records",uum_accn1440.xml,80444/xv19515,7,13,6,26
"Ahmed Zaki Abu Shadi papers",uum_accn2546.xml,80444/xv19583,3,8,15,26
"Jane Ballantyne Taylor diary",uum_accn2593.xml,80444/xv18972,8,11,7,26
"Joanna Brooks papers",uum_accn2294.xml,80444/xv93673,4,2,20,26
"Navajo Oral Histories",uum_accn0941.xml,80444/xv39630,9,11,6,26
"James Holt papers",uum_ms0412.xml,80444/xv51559,9,17,0,26
"Sandra Tanner oral history interviews",uum_ms0413.xml,80444/xv59191,10,9,7,26
"Brewster Ghiselin papers",uum_ms0528.xml,80444/xv46340,7,6,12,25
"Scott H. Faulring papers",uum_accn2316.xml,80444/xv56411,10,7,8,25
"Alice "Pat" Rice Capson Brown papers",uum_accn2777.xml,80444/xv70059,8,7,10,25
"Edwin Brown Firmage audio-visual collection",uum_a0427.xml,80444/xv73114,14,3,8,25
"Guide to the DeVed-Thorne Studio negative collection",uum_p0272.xml,80444/xv92703,3,10,12,25
"Vesta Pierce Crawrford papers",uum_ms0125.xml,80444/xv23171,8,10,7,25
"Zeke Johnson papers",uum_ms0511.xml,80444/xv89846,6,13,6,25
"Jackie Nokes papers",uum_accn1970.xml,80444/xv71029,8,12,5,25
"Matthew Frederick and Claire Wilcox Noall papers",uum_ms0188.xml,80444/xv00375,9,11,5,25
"Ramiro Cortes papers",uum_ms0513.xml,80444/xv65618,8,2,15,25
"Arthur Lawton Beeley papers",uum_acc0188.xml,80444/xv69985,6,13,6,25
"Sumner G. Margetts and Company records",uum_accn1295.xml,80444/xv26593,6,14,4,24
"Harry Longabaugh Jr. papers",uum_ms0025.xml,80444/xv14639,13,3,8,24
"Philosophical Issues in Human Affairs telecourses video collection",uum_a0212.xml,80444/xv10440,5,6,13,24
"Edna Clark Ericksen oral history audio recordings",uum_a0339.xml,80444/xv67434,3,10,11,24
"Alfred Lambourne papers",uum_ms0462.xml,80444/xv44116,8,10,6,24
"Ben E. Rich Southern States Mission scrapbook",uum_accn0038.xml,80444/xv68984,17,1,6,24
"Utah Ski Archives miscellaneous videos",uum_a0323.xml,80444/xv26092,11,6,7,24
"Leo Leonard papers",uum_accn1559.xml,80444/xv24349,6,7,11,24
"Llewelyn R. McKay papers",uum_accn1692.xml,80444/xv61392,14,2,8,24
"Stanley D. Lyman papers",uum_ms0181.xml,80444/xv73583,5,5,13,23
"James A. Hogle papers",uum_accn0388.xml,80444/xv44161,5,7,11,23
"Levi Edgar Young papers",uum_ms0531.xml,80444/xv77416,14,3,6,23
"Ronald M. Smelser papers",uum_accn2374.xml,80444/xv00042,8,2,13,23
"T. Benny Rushing papers",uum_acc0497.xml,80444/xv86868,0,18,5,23
"Lyle Nelson video collection",uum_a1098.xml,80444/xv65899,2,15,6,23
"Ken Sleight river running video collection",uum_a1105.xml,80444/xv59735,15,2,6,23
"Roy Gibson photograph collection",uum_p0358.xml,80444/xv06295,8,7,8,23
"University of Utah Graduate School records",uum_acc0514.xml,80444/xv41207,10,5,8,23
"Richard K. A. Kletting drawings",uum_ms0498.xml,80444/xv71798,8,4,11,23
"Alan K. Engen ski video collection",uum_a0402.xml,80444/xv01519,11,5,7,23
"Ezra T. Clark family papers",uum_accn1528.xml,80444/xv51809,13,5,5,23
"Stephen Gary Erickson papers",uum_accn1961.xml,80444/xv51055,15,4,4,23
"Nelson Higgins papers",uum_accn2774.xml,80444/xv36486,15,7,1,23
"Charles Eggert papers",uum_accn1659.xml,80444/xv77142,14,4,5,23
"E. Richard Hart audio-visual collection",uum_a0377.xml,80444/xv41003,9,8,6,23
"Gibbons and Reed Company records",uum_ms0351.xml,80444/xv12341,8,8,6,22
"Nephi L. Morris papers",uum_ms0097.xml,80444/xv77902,2,5,15,22
"Amanda Barnes Smith papers",uum_accn1605.xml,80444/xv11431,13,5,4,22
"Jan Harold Brunvand papers",uum_accn1024.xml,80444/xv41549,2,8,12,22
"Hampton Godbe papers",uum_ms0664.xml,80444/xv97659,7,6,9,22
"Thorne Mayes photograph collection",uum_p0355.xml,80444/xv91540,12,2,8,22
"Norman D. and Doris Nevills papers",uum_ms0552.xml,80444/xv71887,4,10,8,22
"George Teasdale photograph collection",uum_p0532.xml,80444/xv83676,14,4,4,22
"Josie Bassett McKnight Wells Morris oral history interview",uum_ms0440.xml,80444/xv78237,14,6,1,21
"Jean Westwood photograph collection",uum_p0112.xml,80444/xv79882,9,9,3,21
"Agnes Just Reid photograph collection",uum_p0249.xml,80444/xv18173,4,12,5,21
"David H. Christensen photograph collection",uum_p0369.xml,80444/xv80014,6,8,7,21
"Frederick Kesler photograph collection",uum_p0049.xml,80444/xv40600,11,7,3,21
"Newhouse Mines and Smelters records",uum_accn1924.xml,80444/xv02972,6,7,8,21
"Thomas Caldwell Adams papers",uum_ms0043.xml,80444/xv55331,8,7,6,21
"Nauvoo Temple sealing records",uum_accn2113.xml,80444/xv01635,9,8,4,21
"William Budge papers",uum_accn2151.xml,80444/xv65585,9,12,0,21
"Ariel S. Ballif Jr. papers",uum_accn2127.xml,80444/xv61318,17,1,3,21
"Ralph Chamberlain photograph collection",uum_p0287.xml,80444/xv61834,12,6,3,21
"Hans Olson Magleby papers",uum_ms0047.xml,80444/xv35317,5,13,3,21
"Maurice Abravanel photograph collection",uum_p0590.xml,80444/xv04708,10,3,8,21
"University of Utah Middle East Center records",uum_acc0464.xml,80444/xv25085,2,8,11,21
"Burton Howard and Angelina Carhart Tallmon Jones papers",uum_accn2132.xml,80444/xv33609,4,6,11,21
"Zion's Cooperative Mercantile Institution (ZCMI) records",uum_accn0756.xml,80444/xv93444,14,2,5,21
"Jewish Archives Photograph Archives",uum_p0224.xml,80444/xv80294,14,6,1,21
"George Teasdale papers",uum_ms0678.xml,80444/xv07150,3,11,7,21
"University of Utah Bureau of Economic and Business Research The economic status of the University of Utah federal land grants",uum_acc0033.xml,80444/xv42935,10,8,2,20
"University of Utah Facilities Planning and Construction Office records",uum_acc0416.xml,80444/xv34857,6,1,13,20
"Margie of the Wasatch motion picture",uum_a0699.xml,80444/xv61798,5,7,8,20
"Bullion Beck and Champion Mining Company records",uum_ms0220.xml,80444/xv16104,4,11,5,20
"Uintah Basin oral history project",uum_accn0772.xml,80444/xv85006,2,7,11,20
"Joseph S. Peery Audio Visual Collection",uum_a0935.xml,80444/xv39660,11,6,3,20
"Max H. Parkin papers",uum_accn1539.xml,80444/xv51602,1,13,6,20
"Jack Goodman papers",uum_accn1521.xml,80444/xv99084,3,9,8,20
"Walker House guest register",uum_accn1616.xml,80444/xv47763,6,8,6,20
"Alexander Baird papers",uum_accn1994.xml,80444/xv03228,7,10,3,20
"Brigham Madsen photograph collection",uum_p0107.xml,80444/xv42370,6,8,6,20
"Lee's Ferry photograph collection",uum_p0277.xml,80444/xv29541,13,2,5,20
"Fort Douglas records",uum_ms0518.xml,80444/xv28591,11,3,6,20
"Steve Lacy collection of Herbert B. Maw audio recordings",uum_a0331.xml,80444/xv82199,14,0,6,20
"Mormon women's voices oral history project",uum_accn2778.xml,80444/xv88385,2,9,9,20
"Thomas Frazer papers",uum_ms0324.xml,80444/xv47116,4,10,6,20
"Western and Mormon stereograph collection",uum_p0066.xml,80444/xv42407,7,7,6,20
"George Christian Riser papers",uum_ms0022.xml,80444/xv92999,15,2,3,20
"U. S. West research records",uum_accn1683.xml,80444/xv55651,4,2,14,20
"Allan Turner Howe papers",uum_ms0140.xml,80444/xv63525,6,9,5,20
"Julia Dean Hayne papers",uum_ms0293.xml,80444/xv25811,12,7,1,20
"Old timers Colorado River trip video collection",uum_a0718.xml,80444/xv67361,3,11,6,20
"Nate Millard snowboarding video collection",uum_a0230.xml,80444/xv38265,6,7,7,20
"Helon Henry Tracy papers",uum_accn1053.xml,80444/xv58056,10,5,5,20
"Paul C. Richards papers",uum_accn1461.xml,80444/xv65289,18,2,0,20
"Snowbird Ski and Summer Resort audio-visual collection",uum_a1056.xml,80444/xv42019,8,5,7,20
"Robert S. Olpin papers",uum_ms0048.xml,80444/xv63409,6,8,6,20
"Naomi Barlow Larson autobiography",uum_accn2785.xml,80444/xv84918,11,6,3,20
"Affirmation: the Gay and Lesbian Mormons collection",uum_accn1867.xml,80444/xv07540,7,5,7,19
"Thomas G. Stockham papers",uum_accn1491.xml,80444/xv43591,6,3,10,19
"Richard Douglas Poll papers",uum_ms0674.xml,80444/xv76965,11,5,3,19
"Elsie Ross Whittaker papers",uum_accn1345.xml,80444/xv78411,5,9,5,19
"James Chipman Fletcher papers",uum_ms0202.xml,80444/xv61880,9,4,6,19
"Masashi Kamimura independent film collection",uum_a0770.xml,80444/xv37332,12,1,6,19
"Ralph Elijah Cloward papers",uum_ms0243.xml,80444/xv56338,9,4,6,19
"Linda King Newell papers",uum_ms0447.xml,80444/xv64672,12,3,4,19
"Davis Bitton oral histories and autobiographies",uum_ms0039.xml,80444/xv29327,4,10,5,19
"University of Utah Marriott Library Auditorium Committee records",uum_acc0078.xml,80444/xv55468,13,1,5,19
"Jenevieve Hubbard independent film collection",uum_a0795.xml,80444/xv09695,13,1,5,19
"Andrew Pfeiffenberger river running video collection",uum_a1025.xml,80444/xv05868,8,2,9,19
"Utah labor archives",uum_ms0013.xml,80444/xv49066,7,6,6,19
"University of Utah Business Vice President's Office records",uum_acc0025.xml,80444/xv57995,13,5,1,19
"Malcom 'Moki Mac' Ellingson river running video collection",uum_a1022.xml,80444/xv50759,5,7,7,19
"Spencer F. Eccles papers",uum_accn2351.xml,80444/xv30914,6,4,9,19
"Women in Utah politics oral history project",uum_accn1855.xml,80444/xv37860,3,6,10,19
"Lucia Eugenia Lamb Everett diary",uum_ms0583.xml,80444/xv60437,9,3,7,19
"Lennox Tierney papers",uum_accn1180.xml,80444/xv02947,7,2,10,19
"Eugene Jelesnik papers",uum_accn2339.xml,80444/xv62796,4,5,10,19
"Westside stories oral history collection",uum_accn2117.xml,80444/xv01852,2,9,8,19
"John Schmitt papers",uum_accn2570.xml,80444/xv27441,10,9,0,19
"Philip T. Blair family papers",uum_ms0120.xml,80444/xv25540,6,6,7,19
"Joe Hill Conference photograph collection",uum_p0445.xml,80444/xv49746,8,7,4,19
"John B. Fairbanks papers",uum_accn1281.xml,80444/xv21664,7,4,8,19
"Topaz oral history project collection",uum_accn1002.xml,80444/xv97265,1,11,7,19
"Peter Goss interview with Norman Hill audio recording",uum_a0309.xml,80444/xv59066,9,5,5,19
"Ann Prior Jarvis papers",uum_ms0052.xml,80444/xv86239,10,5,4,19
"Newell G. Bringhurst papers",uum_accn1341.xml,80444/xv41436,4,9,6,19
"Fern Flagler Peery papers",uum_accn2473.xml,80444/xv10211,15,3,1,19
"Tracy-Collins Bank and Trust Company records",uum_accn1230.xml,80444/xv20068,9,1,9,19
"University of Utah Department of Educational Psychology records",uum_acc0432.xml,80444/xv65927,14,3,1,18
"Mads Christensen papers",uum_ms0307.xml,80444/xv66070,7,7,4,18
"William Caine Patrick photograph collection",uum_p0148.xml,80444/xv75411,14,4,0,18
"University of Utah Marriott Library business office records",uum_acc0187.xml,80444/xv30770,5,5,8,18
"Utah women's issues collection",uum_ms0574.xml,80444/xv21124,10,4,4,18
"John Esplin family papers",uum_accn2404.xml,80444/xv96215,2,3,13,18
"J. Bracken Lee photograph collection",uum_p0037.xml,80444/xv86376,3,15,0,18
"Raymond Woolley Taylor papers",uum_accn1893.xml,80444/xv10336,7,6,5,18
"Ballet West records",uum_accn1129.xml,80444/xv96896,6,10,2,18
"Lloyd R. Yeaton collection",uum_accn1300.xml,80444/xv75695,11,3,4,18
"William Mulder papers",uum_accn0411.xml,80444/xv79547,8,4,6,18
"Grace Richards Warner papers",uum_accn2060.xml,80444/xv72055,10,7,1,18
"Earl Douglass photograph collection",uum_p0196.xml,80444/xv39883,7,7,4,18
"James Ronald Bartlett papers",uum_accn2160.xml,80444/xv58996,10,7,1,18
"Stephen Post papers",uum_ms0490.xml,80444/xv83020,3,7,8,18
"Hotel Utah records",uum_ms0469.xml,80444/xv49902,4,8,6,18
"Women's State Legislative Council Of Utah photograph collection",uum_p0348.xml,80444/xv42456,8,6,4,18
"Ski Utah audio-visual collection",uum_a0590.xml,80444/xv12377,5,0,13,18
"Utah pioneer costume research project",uum_ms0124.xml,80444/xv04974,4,7,7,18
"Thomas Battersby Child Audio-Visual Collection",uum_a0757.xml,80444/xv21813,9,6,3,18
"Alf Engen Ski Museum records",uum_accn0518.xml,80444/xv95623,14,3,1,18
"Antoine de Seynes papers",uum_accn1206.xml,80444/xv41345,2,9,7,18
"The Institute of the American West photograph collection",uum_p0046.xml,80444/xv49435,15,2,1,18
"Frank Fuller papers",uum_ms0305.xml,80444/xv56695,6,10,2,18
"Blanche Kendall McKey photograph collection",uum_p0360.xml,80444/xv40811,12,2,4,18
"Joe Hill Organizing Committee records",uum_accn1243.xml,80444/xv00823,12,5,0,17
"Louis S. Goodman photograph collection",uum_p0308.xml,80444/xv02337,13,4,0,17
"Feramorz Young Fox papers",uum_ms0540.xml,80444/xv59945,3,13,1,17
"Park City, Utah photograph collection",uum_p0228.xml,80444/xv35366,4,4,9,17
"Italian Archives photograph collection",uum_p0086.xml,80444/xv40634,9,6,2,17
"Reva Beck Bosone papers",uum_ms0127.xml,80444/xv79031,6,9,2,17
"University of Utah Deputy Executive Vice President records",uum_acc0230.xml,80444/xv72299,11,2,4,17
"South Slavic oral history project",uum_accn1502.xml,80444/xv56857,4,4,9,17
"Paul Coburn letter",uum_accn2596.xml,80444/xv25473,13,3,1,17
"Ivor Sharp photograph collection",uum_p0463.xml,80444/xv22708,10,4,3,17
"George D. Pyper photograph collection",uum_p0001.xml,80444/xv97451,8,2,7,17
"Tim Larson papers",uum_accn0990.xml,80444/xv27951,0,14,3,17
"Lorenzo Snow Young papers",uum_ms0497.xml,80444/xv27923,5,8,4,17
"University of Utah College of Engineering records",uum_acc0379.xml,80444/xv91589,11,2,4,17
"Arthur Pedersen Freber papers",uum_ms0234.xml,80444/xv25445,5,7,5,17
"Art in Utah photograph collection",uum_p0065.xml,80444/xv45077,13,0,4,17
"Ellis Reynolds Shipp papers",uum_ms0175.xml,80444/xv87167,5,10,2,17
"Robert Alan Goldberg papers",uum_accn0731.xml,80444/xv15689,11,1,5,17
"Elizabeth Corr interview",uum_ms0341.xml,80444/xv32666,7,7,3,17
"William Harroun Behle papers",uum_ms0576.xml,80444/xv78683,6,8,3,17
"J. Gordon and Elizabeth M. Browning papers",uum_accn1874.xml,80444/xv31546,5,8,4,17
"David Eccles family papers",uum_ms0187.xml,80444/xv61395,10,2,5,17
"Carl Weeks photograph collection",uum_p0207.xml,80444/xv77551,8,5,4,17
"Kent Logan Walgren papers",uum_accn2114.xml,80444/xv70401,9,1,7,17
"French kayakers river running video collection",uum_a0534.xml,80444/xv75704,0,5,12,17
"Louis C. Zucker papers",uum_ms0485.xml,80444/xv42523,7,8,2,17
"Ralph Johnston photograph collection",uum_p0392.xml,80444/xv88293,8,2,7,17
"Navajo Code Talkers oral histories",uum_ms0504.xml,80444/xv32742,2,6,9,17
"Avard T. Fairbanks papers",uum_accn1336.xml,80444/xv48159,3,3,11,17
"G. T. Harrison papers",uum_accn1351.xml,80444/xv88125,3,7,6,16
"Thomas D. S. Key articles",uum_accn1297.xml,80444/xv65591,12,2,2,16
"Madge Tomsic collection",uum_ms0672.xml,80444/xv90530,11,1,4,16
"Frank Leroy Byers papers",uum_accn2620.xml,80444/xv24734,11,4,1,16
"John Loveless autobiography",uum_ms0016.xml,80444/xv17321,8,1,7,16
"Martin and Sarah Bell Howard papers",uum_accn2005.xml,80444/xv56216,12,0,4,16
"Saving the Legacy collection",uum_accn2100.xml,80444/xv73135,7,5,4,16
"Dave M. Tatsuno Japanese-American internment camp video",uum_a0668.xml,80444/xv68127,6,5,5,16
"<title render="italic">Navajo Land</title> motion picture",uum_a0487.xml,80444/xv74362,11,1,4,16
"Jude Allen papers",uum_accn1480.xml,80444/xv43765,6,4,6,16
"Eliza Maria Partridge Smith Lyman journal",uum_ms0026.xml,80444/xv75570,7,8,1,16
"Carson City Savings Bank correspondence",uum_accn1081.xml,80444/xv22570,7,6,3,16
"Southern Utah Wilderness Alliance Records",uum_accn1696.xml,80444/xv28356,4,8,4,16
"Gilmer and Salisbury Express Company letterpress book",uum_accn0263.xml,80444/xv50656,12,1,3,16
"George Snell papers",uum_ms0556.xml,80444/xv33312,11,3,2,16
"W. L. "Bud" Rusho papers",uum_accn2636.xml,80444/xv58560,2,9,5,16
"Robert C. Steensma papers",uum_accn1579.xml,80444/xv84945,8,5,3,16
"University of Utah Secretary and Controller's Office records",uum_acc0140.xml,80444/xv22680,10,3,3,16
"John Pulsipher diaries",uum_ms0092.xml,80444/xv65625,10,6,0,16
"Leslie A. Jones papers",uum_accn1705.xml,80444/xv90774,10,3,3,16
"William Henry McDougall photograph collection",uum_p0246.xml,80444/xv50738,1,4,11,16
"University of Utah Library Administration records",uum_acc0021.xml,80444/xv17218,4,12,0,16
"Philip L. Fradkin papers",uum_accn2658.xml,80444/xv62921,4,5,7,16
"James Taylor Harwood oral history video collection",uum_a0090.xml,80444/xv13973,1,8,7,16
"Italian oral history project",uum_ms0580.xml,80444/xv84246,6,5,5,16
"Unknown",uum_accn2342.xml,80444/xv98980,6,1,9,16
"Lawrence Howard Lee papers",uum_accn2687.xml,80444/xv87255,9,5,2,16
"University of Utah Vice President For University Relations Office records",uum_acc0421.xml,80444/xv29574,5,5,6,16
"Wasatch Masonic Lodge collection",uum_accn2323.xml,80444/xv45501,9,5,2,16
"Joel Hills Johnson autobiography",uum_accn1354.xml,80444/xv82885,2,0,14,16
"Harvey and Lorena Fletcher photograph collection",uum_p0284.xml,80444/xv26080,9,5,2,16
"Samuel Bateman papers",uum_ms0159.xml,80444/xv26959,4,8,4,16
"University of Utah College of Science records",uum_acc0530.xml,80444/xv84579,2,9,5,16
"Edward B. Wilder letterpress books",uum_ms0145.xml,80444/xv37429,8,5,3,16
"University of Utah Archeological Center site records",uum_acc0308.xml,80444/xv51467,3,5,8,16
"Salt Lake Oratorio Society photograph collection",uum_p0097.xml,80444/xv18289,10,3,3,16
"Theater collection",uum_ms0147.xml,80444/xv17868,6,4,6,16
"Hatch River Expeditions records",uum_accn1325.xml,80444/xv17401,8,4,4,16
"Theodore Milton Wassmer papers",uum_ms0655.xml,80444/xv80560,4,5,7,16
"Morrison-Knudsen Company report",uum_accn2699.xml,80444/xv85748,13,3,0,16
"University of Utah - Departments of Modern Dance and Ballet Theses collection: 1967-2001",uum_a0365.xml,80444/xv51937,6,9,1,16
"David M. Walden papers",uum_accn2108.xml,80444/xv87289,2,8,6,16
"Peter Huntoon papers",uum_accn2656.xml,80444/xv21481,10,3,2,15
"University of Utah Graduate School of Education records",uum_acc0447.xml,80444/xv22604,10,3,2,15
"University of Utah Provost's Office records",uum_acc0227.xml,80444/xv11120,4,5,6,15
"Glenn Walker and John McChrystal Wallace photograph collection",uum_p0354.xml,80444/xv34338,3,8,4,15
"Bathsheba W. Bigler Smith autobiography",uum_ms0267.xml,80444/xv63635,1,2,12,15
"Sandy Gilmour papers",uum_accn2580.xml,80444/xv11395,8,2,5,15
"William S. Godbe papers",uum_accn1507.xml,80444/xv35345,12,3,0,15
"Robert Hyde Wilson papers",uum_ms0529.xml,80444/xv63461,5,4,6,15
"Maud May Babcock papers",uum_ms0083.xml,80444/xv09509,4,6,5,15
"Phillips Gallery records",uum_accn1797.xml,80444/xv67346,7,7,1,15
"Kent Frost papers",uum_accn1687.xml,80444/xv34771,5,5,5,15
"Civilian Conservation Corps Camp of Vernal records",uum_ms0512.xml,80444/xv81680,6,6,3,15
"Kimball Johnson independent film collection",uum_a0805.xml,80444/xv08273,0,9,6,15
"William H. McDougall papers",uum_ms0246.xml,80444/xv98056,5,6,4,15
"Fred C. Collier papers",uum_accn0478.xml,80444/xv15609,2,10,3,15
"George M. Ottinger photograph collection",uum_p0123.xml,80444/xv93051,11,4,0,15
"George Dollinger Pyper papers",uum_ms0001.xml,80444/xv02355,8,2,5,15
"Sugarhouse area of Salt Lake City collection",uum_accn2105.xml,80444/xv35586,13,2,0,15
"Gail Plummer collection of Maud May Babcock audio recordings",uum_a0409.xml,80444/xv88369,6,4,5,15
"Ralph Martin McGrath papers",uum_ms0308.xml,80444/xv68777,7,8,0,15
"Jean M. Westwood papers",uum_ms0112.xml,80444/xv26727,1,6,8,15
"Francis Marion Bishop correspondence",uum_ms0282.xml,80444/xv54168,7,7,1,15
"Nancy Bandy scrapbook",uum_accn2390.xml,80444/xv41653,1,3,11,15
"Edith Leroy Richardson papers",uum_ms0366.xml,80444/xv58010,3,6,6,15
"Linda Sarver papers",uum_accn2852.xml,80444/xv56265,7,3,5,15
"Taylor Woolley photograph collection",uum_p0025.xml,80444/xv95578,10,5,0,15
"Joseph F. Smith family papers",uum_ms0288.xml,80444/xv22616,6,8,1,15
"U.S. Ski and Snowboard Association records",uum_accn2461.xml,80444/xv52993,5,2,8,15
"Gail Plummer papers",uum_ms0667.xml,80444/xv52270,9,2,4,15
"Lois Milner collection of broadcast radio audio recordings",uum_a1005.xml,80444/xv20233,6,2,7,15
"Joseph Stead Jacobson papers",uum_accn2823.xml,80444/xv54598,8,2,5,15
"Reed Peck manuscript",uum_accn0755.xml,80444/xv26818,13,0,2,15
"Chi Delta Phi records",uum_ms0086.xml,80444/xv64279,3,8,4,15
"Freemen Institute records",uum_accn1171.xml,80444/xv92590,10,0,5,15
"Frank Rasmussen photograph collection",uum_p0419.xml,80444/xv83169,4,7,4,15
"Nathaniel V. Jones diary",uum_accn0040.xml,80444/xv86154,5,2,8,15
"Book of Anointings records",uum_accn1950.xml,80444/xv36898,7,3,5,15
"Charles Shepherd papers",uum_accn0917.xml,80444/xv28546,6,6,3,15
"Arthur Shepherd photograph collection",uum_p0103.xml,80444/xv47952,4,3,8,15
"Julie Jensen papers",uum_accn2827.xml,80444/xv75878,3,1,11,15
"George Reynolds papers",uum_accn1342.xml,80444/xv60058,8,5,2,15
"Zachariah Thomas Derrick papers",uum_accn2144.xml,80444/xv38363,8,7,0,15
"Salamander collection",uum_ms0577.xml,80444/xv34225,6,9,0,15
"A. S. U. U. records",uum_acc0012.xml,80444/xv79763,9,4,2,15
"Reva Beck Bosone photograph collection",uum_p0127.xml,80444/xv02380,11,2,1,14
"John S. Boyden papers",uum_accn0823.xml,80444/xv56533,8,3,3,14
"Little Cottonwood Canyon history collection",uum_ms0632.xml,80444/xv49353,3,7,4,14
"D. H. Christensen papers",uum_ms0627.xml,80444/xv13253,7,2,5,14
"Robert W. Parry papers",uum_accn1409.xml,80444/xv56674,7,3,4,14
"Stephen Trimble papers",uum_accn2757.xml,80444/xv80468,3,8,3,14
"A. J. Eardley papers",uum_ms0642.xml,80444/xv77853,5,7,2,14
"Christopher Diehl scrapbook",uum_accn0582.xml,80444/xv68981,6,5,3,14
"Dallas and Hedges blueprints",uum_accn2420.xml,80444/xv64974,0,3,11,14
"Park City Mountain Resort photograph collection",uum_p0949.xml,80444/xv93222,5,3,6,14
"University of Utah University Architect and Campus Planning Office records",uum_acc0296.xml,80444/xv51153,11,1,2,14
"Joseph Kingsbury photograph collection",uum_p0029.xml,80444/xv19973,10,4,0,14
"Alan K. Engen papers",uum_accn1601.xml,80444/xv49768,4,3,7,14
"Juanita Brooks papers",uum_ms0486.xml,80444/xv01153,3,6,5,14
"H. D. Goode papers",uum_accn1211.xml,80444/xv72326,4,0,10,14
"Sanpete County oral histories",uum_accn0562.xml,80444/xv41635,0,5,9,14
"Albert Ray Olpin presidential records",uum_acc0024.xml,80444/xv32067,1,5,8,14
"Joseph Rosenblatt papers",uum_accn0995.xml,80444/xv00778,11,1,2,14
"Allan Moll broadcast radio audio collection",uum_a0561.xml,80444/xv50570,3,8,3,14
"Flaming Gorge Bureau of Reclamation video",uum_a0548.xml,80444/xv40954,7,1,6,14
"William Wesley Anderson autobiography",uum_ms0339.xml,80444/xv26260,12,0,2,14
"Richard Jay Oldroyd papers",uum_accn1957.xml,80444/xv32968,7,1,6,14
"J. Golden Kimball papers",uum_ms0662.xml,80444/xv37536,5,5,4,14
"Albert (Bert) and Rachel Jamison Loper papers",uum_accn2090.xml,80444/xv86398,5,6,3,14
"Wandle Mace papers",uum_accn1393.xml,80444/xv80502,9,0,5,14
"University of Utah commencement addresses",uum_acc0084.xml,80444/xv04653,10,4,0,14
"St.George, Utah photograph collection",uum_p0082.xml,80444/xv02044,8,2,4,14
"Charles Willden papers",uum_ms0325.xml,80444/xv41827,1,5,8,14
"Robbin Shahani independent film collection",uum_a0811.xml,80444/xv02975,8,1,5,14
"Floyd A. O'Neil papers",uum_accn0890.xml,80444/xv00683,4,5,5,14
"M. Walker Wallace papers",uum_accn1941.xml,80444/xv28030,5,0,9,14
"University of Utah Vice President for Academic Affairs Office records",uum_acc0492.xml,80444/xv58001,4,8,2,14
"Duckworth Grimshaw autobiography",uum_accn1303.xml,80444/xv28826,9,0,5,14
"KUED-TV records",uum_acc0176.xml,80444/xv78366,0,11,3,14
"Heber R. Taylor papers",uum_acc0542.xml,80444/xv18170,4,7,3,14
"Donald M. Rees papers",uum_acc0206.xml,80444/xv84704,0,9,5,14
"James Smithies papers",uum_accn1288.xml,80444/xv98956,2,4,8,14
"Andrew Love Neff papers",uum_ms0135.xml,80444/xv91690,4,6,4,14
"Alta Club records",uum_ms0388.xml,80444/xv89678,8,2,4,14
"Luke William Gallup papers",uum_accn2786.xml,80444/xv39532,8,5,1,14
"J. Allen Crockett correspondence",uum_accn0736.xml,80444/xv11080,12,2,0,14
"Alexander Woodruff "Woody" Anderson photograph collection",uum_p0457.xml,80444/xv18588,11,2,1,14
"J. Willard and Alice Sheets Marriott photograph collection",uum_p0164.xml,80444/xv72634,5,4,5,14
"Charles Lambert journals",uum_ms0094.xml,80444/xv89154,4,2,8,14
"Sarah Studevant Leavitt autobiography",uum_ms0062.xml,80444/xv74777,10,4,0,14
"Frederick J. Pack papers",uum_ms0423.xml,80444/xv71707,8,3,3,14
"Leroy J. Robertson music recordings",uum_a0241.xml,80444/xv90075,7,4,3,14
"Azadeh Saljooghi independent film collection",uum_a0792.xml,80444/xv55230,10,2,2,14
"Kenneth L. Cook papers",uum_accn1466.xml,80444/xv16500,1,5,8,14
"Frederick Gardiner diary",uum_ms0134.xml,80444/xv53149,9,2,2,13
"Gregory A. Prince papers",uum_accn1334.xml,80444/xv01675,6,4,3,13
"Alma James Lindsey papers",uum_accn1737.xml,80444/xv53582,4,6,3,13
"Alice Kasai papers",uum_accn1091.xml,80444/xv92428,2,9,2,13
"Mark A. Pendelton photograph collection",uum_p0008.xml,80444/xv85092,6,2,5,13
"Talbot A. Chubb papers",uum_accn2559.xml,80444/xv48684,6,0,7,13
"Hardy Jenkinson family home movies",uum_a0827.xml,80444/xv25784,0,3,10,13
"Peter S. Ecker papers",uum_accn2577.xml,80444/xv33605,2,2,9,13
"Byron Cummings papers",uum_accn1434.xml,80444/xv81939,3,3,7,13
"John M. Provost papers",uum_accn2816.xml,80444/xv75219,10,0,3,13
"Intermountain Regional Medical Program records",uum_acc0166.xml,80444/xv43316,6,3,4,13
"H. Grant Ivins papers",uum_ms0362.xml,80444/xv35546,3,6,4,13
"Grant W. Bagley papers",uum_accn1991.xml,80444/xv55770,7,1,5,13
"Utah Federation of Women's Clubs photograph collection",uum_p0350.xml,80444/xv85009,6,6,1,13
"City/County Building Time Capsule photograph collection",uum_p0367.xml,80444/xv34106,13,0,0,13
"University of Utah President's Office Reports and correspondence to the Utah State Board of Regents",uum_acc0147.xml,80444/xv89001,10,1,2,13
"Harold W. Bentley papers",uum_acc0260.xml,80444/xv75863,5,6,2,13
"George D. Smith papers",uum_accn0677.xml,80444/xv67523,5,0,8,13
"Utah coal mining history records",uum_accn2058.xml,80444/xv46609,4,5,4,13
"Michael Russell papers",uum_accn2817.xml,80444/xv78457,4,9,0,13
"David Stanley poster collection",uum_accn2835.xml,80444/xv42898,4,1,8,13
"Mitsugi M. Kasai papers",uum_accn2550.xml,80444/xv35415,7,4,2,13
"Butch Cassidy papers",uum_ms0474.xml,80444/xv05606,5,5,3,13
"S. Floyd Mori papers",uum_accn2203.xml,80444/xv31024,3,2,8,13
"Mary Jane Hair papers",uum_accn1041.xml,80444/xv76727,13,0,0,13
"Emily Stewart Barnes family papers",uum_ms0547.xml,80444/xv72619,9,1,3,13
"Robert Young papers",uum_accn1694.xml,80444/xv38568,11,2,0,13
"John G. Baker article",uum_accn2697.xml,80444/xv09786,9,1,3,13
"Frank O'Rourke papers",uum_accn1201.xml,80444/xv94436,4,8,1,13
"Porte Publishing Company photograph collection",uum_p0182.xml,80444/xv56710,7,4,2,13
"University of Utah Student Involvement Center fraternity and sorority records",uum_acc0063.xml,80444/xv31570,5,8,0,13
"Charles James Nabors collection of George McGovern campaign audio recordings",uum_a0304.xml,80444/xv45278,3,5,5,13
"Happy Jack Mine records",uum_accn1919.xml,80444/xv37710,4,6,3,13
"Klaus J. Hansen papers",uum_accn1532.xml,80444/xv51855,4,3,6,13
"University of Utah Department of Computer Science records",uum_acc0051.xml,80444/xv78576,2,4,7,13
"Joan Woodbury dance audio-visual collection",uum_a0763.xml,80444/xv09768,8,3,2,13
"University of Utah College of Nursing records",uum_acc0144.xml,80444/xv86184,5,8,0,13
"University of Utah College of Social and Behavioral Science records",uum_acc0494.xml,80444/xv24664,0,13,0,13
"Jim Gaddis papers",uum_ms0592.xml,80444/xv72763,5,3,5,13
"Wayne Owens papers",uum_ms0108.xml,80444/xv75015,5,8,0,13
"Asael Carlyle Lambert papers",uum_ms0035.xml,80444/xv61172,5,2,6,13
"Samuel Parkinson Cowley papers",uum_ms0393.xml,80444/xv95605,6,2,5,13
"Topaz Museum interviews",uum_accn2465.xml,80444/xv20690,0,2,11,13
"Jo-Anne Ely papers",uum_accn1358.xml,80444/xv07031,3,8,2,13
"Ferdinand Friis Hintze papers",uum_ms0614.xml,80444/xv20346,4,2,7,13
"University of Utah Department of Family and Consumer Studies records",uum_acc0517.xml,80444/xv99172,2,3,8,13
"Jewish oral history project",uum_accn1629.xml,80444/xv12231,0,8,5,13
"University of Utah Department of Sociology records",uum_acc0491.xml,80444/xv70965,2,11,0,13
"Francis M. Darter letters",uum_ms0419.xml,80444/xv13775,2,3,8,13
"Interviews with caucasians in Utah",uum_ms0483.xml,80444/xv63665,6,3,4,13
"Robert Anderson photograph collection",uum_p0342.xml,80444/xv65869,9,3,1,13
"Jennings, Jesse D. archaeological video collection",uum_a0550.xml,80444/xv32064,2,2,9,13
"University of Utah Student Affairs Office records",uum_acc0233.xml,80444/xv16851,10,3,0,13
"Everett Ruess family papers",uum_ms0687.xml,80444/xv89776,3,6,4,13
"Beatrice Peterson Marchant papers",uum_accn0754.xml,80444/xv05722,5,2,6,13
"McIntyre family ranch papers",uum_accn2047.xml,80444/xv72238,10,0,3,13
"University of Utah University Architect and Campus Planning Office records",uum_acc0353.xml,80444/xv62640,7,6,0,13
"Women's Resource Center reference collection",uum_accn2712.xml,80444/xv27346,0,1,12,13
"Hack Miller papers",uum_accn1678.xml,80444/xv00927,7,0,6,13
"Willis D. Johnson papers",uum_accn1825.xml,80444/xv76068,6,5,1,12
"Daniel McCool papers",uum_accn2435.xml,80444/xv86163,4,5,3,12
"Richard F. Ream papers",uum_accn2533.xml,80444/xv47680,11,1,0,12
"National Cold Fusion Institute records",uum_acc0529.xml,80444/xv23135,2,8,2,12
"Carbon County coal strike records",uum_ms0473.xml,80444/xv45242,8,1,3,12
"Merrill D. Beal papers",uum_ms0640.xml,80444/xv05535,6,3,3,12
"Linwood, Utah photograph collection",uum_p0223.xml,80444/xv55474,2,4,6,12
"University of Utah Academic Senate meeting minutes and agendas",uum_acc0509.xml,80444/xv53588,3,8,1,12
"Voices of American homemakers oral history project",uum_ms0472.xml,80444/xv08352,1,5,6,12
"Joseph Ellis Johnson photograph collection",uum_p0110.xml,80444/xv61529,6,0,6,12
"Bamberger family papers",uum_ms0225.xml,80444/xv98348,4,6,2,12
"Vervene "Vee" Carlisle photograph collection",uum_p0151.xml,80444/xv18673,9,1,2,12
"Ruth May Fox papers",uum_ms0443.xml,80444/xv23004,4,8,0,12
"J. Heinrich Lienhard papers",uum_ms0089.xml,80444/xv70938,7,1,4,12
"Joseph Naylor Jr. papers",uum_accn1882.xml,80444/xv18853,2,7,3,12
"William Caine Patrick papers",uum_ms0148.xml,80444/xv41983,7,2,3,12
"Nels Anderson photograph collection",uum_p0122.xml,80444/xv60134,12,0,0,12
"SOCOTWA (South Cottonwood Ward) collection",uum_accn2029.xml,80444/xv80462,8,0,4,12
"B.A.M. Froiseth map",uum_accn2394.xml,80444/xv54211,8,0,4,12
"John Nielsen papers",uum_ms0053.xml,80444/xv19189,7,5,0,12
"Silver Brothers Iron Works records",uum_accn2357.xml,80444/xv68957,1,5,6,12
"University of Utah Department of Modern Dance annual reports",uum_acc0366.xml,80444/xv20504,10,2,0,12
"Mammoth Mining Company records",uum_accn2281.xml,80444/xv69238,2,5,5,12
"B. H. Roberts Society records",uum_accn0764.xml,80444/xv91857,0,5,7,12
"Joseph W. Musser papers",uum_ms0328.xml,80444/xv87588,10,2,0,12
"University of Utah War training program records",uum_acc0277.xml,80444/xv94387,6,4,2,12
"Matthew Rowan papers",uum_ms0588.xml,80444/xv41546,4,4,4,12
"Edith LeRoy Richardson photograph collection",uum_p0019.xml,80444/xv10363,2,2,8,12
"Oliver Cowdrey papers",uum_accn1549.xml,80444/xv80661,8,2,2,12
"Japanese American Citizens League audio-visual collection",uum_a0286.xml,80444/xv79666,5,6,1,12
"Eva Lewis Tiemersma papers",uum_accn1367.xml,80444/xv90087,2,10,0,12
"University of Utah Deputy Administrative Vice President records",uum_acc0317.xml,80444/xv97750,9,1,2,12
"University of Utah Department of Medical Technology research grant records",uum_acc0042.xml,80444/xv47488,3,4,5,12
"Spy Hop Productions independent film collection",uum_a0797.xml,80444/xv81716,3,1,8,12
"University of Utah Alumni Association photograph collection",uum_p0362.xml,80444/xv61645,2,2,8,12
"<title render="italic">The Big Chance</title> motion picture",uum_a0486.xml,80444/xv23217,8,0,4,12
"Marvin S. Hill papers",uum_accn1496.xml,80444/xv96926,9,2,1,12
"Phi Beta Kappa, Alpha of Utah records",uum_acc0372.xml,80444/xv78973,0,3,9,12
"University of Utah Graduate School student statistics and reports",uum_acc0074.xml,80444/xv74539,8,4,0,12
"H. D. Goode photograph collection",uum_p0566.xml,80444/xv97381,6,2,4,12
"Royal Lovell Garff papers",uum_ms0682.xml,80444/xv98089,3,6,3,12
"Deseret Live Stock Company records",uum_ms0105.xml,80444/xv24261,5,2,5,12
"John Clendenin freestyle ski video collection",uum_a0575.xml,80444/xv65386,6,0,6,12
"Snowbird Ski and Summer Resort photograph collection",uum_p0385.xml,80444/xv29913,11,1,0,12
"Scott M. Matheson papers",uum_accn0783.xml,80444/xv62567,9,1,2,12
"Ricker family history",uum_accn2667.xml,80444/xv06216,3,0,9,12
"Florence Ellen Ware papers",uum_accn2224.xml,80444/xv01428,3,4,5,12
"Utah Museum of Natural History records",uum_acc0540.xml,80444/xv52426,5,7,0,12
"Gail Plummer photograph collection",uum_p0138.xml,80444/xv35391,0,6,6,12
"Sherman P. Lloyd photograph collection",uum_p0045.xml,80444/xv01953,9,2,1,12
"Ray R. Canning family papers",uum_accn1550.xml,80444/xv30776,6,2,4,12
"William Gibson family papers",uum_accn2469.xml,80444/xv86703,7,2,3,12
"Dick Beck photograph collection",uum_p0068.xml,80444/xv89874,4,7,1,12
"Elizabeth Mehaffy Howe papers",uum_accn1894.xml,80444/xv67773,7,2,3,12
"William D. "Bill" Rishel papers",uum_accn2140.xml,80444/xv73974,3,6,3,12
"James A. and Mary Jane Lyttle Little papers",uum_accn2325.xml,80444/xv49514,1,9,2,12
"Simon Ramo papers",uum_ms0660.xml,80444/xv40560,4,4,4,12
"Larry Gerlach papers",uum_accn2729.xml,80444/xv29302,5,1,6,12
"Guy Potter Mormon history collection",uum_accn1561.xml,80444/xv99694,5,4,3,12
"Hans Martin Hansen papers",uum_accn2116.xml,80444/xv19195,9,1,2,12
"University of Utah Library administration records",uum_acc0202.xml,80444/xv29598,5,4,3,12
"Harold P. Fabian photograph collection",uum_p0136.xml,80444/xv64904,7,1,4,12
"University of Utah Department of Computer Science records",uum_acc0538.xml,80444/xv94100,3,8,1,12
"Arthur Shepherd papers",uum_ms0103.xml,80444/xv83264,10,2,0,12
"Green River Archives",uum_a1140.xml,80444/xv00646,0,2,10,12
"Shigeru Matsukawa papers",uum_accn1956.xml,80444/xv92907,8,1,3,12
"First Presbyterian Church records",uum_accn1049.xml,80444/xv35815,5,4,3,12
"Mike M. Masaoka photograph collection",uum_p0544.xml,80444/xv75799,7,3,2,12
"Moyer Delwyn Thomas photograph collection",uum_p0571.xml,80444/xv58590,2,2,8,12
"Asa Walter Judd papers",uum_ms0400.xml,80444/xv76638,5,5,2,12
"L. Ray Gunn Papers",uum_accn2569.xml,80444/xv84808,7,5,0,12
"Interviews with Italian Americans in Utah",uum_ms0516.xml,80444/xv38128,5,3,4,12
"Bruce Roberts papers",uum_accn2598.xml,80444/xv16156,1,7,3,11
"Spurs scrapbooks",uum_acc0037.xml,80444/xv03518,2,0,9,11
"Alice Merill Horne papers",uum_ms0521.xml,80444/xv03137,5,3,3,11
"Everett L. Cooley papers",uum_accn0073.xml,80444/xv03652,3,3,5,11
"George Edwin Little papers",uum_accn0166.xml,80444/xv77709,5,6,0,11
"United States Army Reserve Officers' Training Corps records",uum_acc0135.xml,80444/xv41711,3,4,4,11
"R. Kent Fielding papers",uum_accn1722.xml,80444/xv84313,4,3,4,11
"Joseph H. Young papers",uum_accn2537.xml,80444/xv50125,2,6,3,11
"David McKenzie papers",uum_ms0116.xml,80444/xv20602,6,3,2,11
"River Running photograph collection",uum_p0210.xml,80444/xv74508,4,1,6,11
"University of Utah Vice President for Research Office records",uum_acc0531.xml,80444/xv32113,2,4,5,11
"Biographical sketch of John Varah Long by Irma Watson Hance",uum_accn0278.xml,80444/xv04232,6,4,1,11
"Walter Ellsworth Ware architectural drawings and papers",uum_ms0502.xml,80444/xv88442,1,0,10,11
"Ephraim Edward Ericksen papers",uum_ms0534.xml,80444/xv35742,5,0,6,11
"David W. Evans autobiography",uum_accn1383.xml,80444/xv63671,10,0,1,11
"University of Utah Middle East Center records",uum_acc0158.xml,80444/xv95074,7,2,2,11
"University of Utah Biology Department records",uum_acc0495.xml,80444/xv12191,0,11,0,11
"Biography of William Mitton Stewart: typescript",uum_acc0155.xml,80444/xv64587,7,4,0,11
"Lewis H. Herring papers",uum_accn1891.xml,80444/xv07214,11,0,0,11
"University of Utah Seismograph Stations records",uum_acc0371.xml,80444/xv46389,0,4,7,11
"Suzy Harris Rytting papers",uum_accn1161.xml,80444/xv49630,4,0,7,11
"William Athol McMaster papers",uum_ms0585.xml,80444/xv04415,9,2,0,11
"University of Utah College of Letters and Science records",uum_acc0050.xml,80444/xv54089,2,7,2,11
"Willard Young letter",uum_accn0910.xml,80444/xv39196,7,1,3,11
"University of Utah Registrar's Office Student enrollment reports",uum_acc0088.xml,80444/xv99148,4,4,3,11
"Don Carlos Young, Jr. photograph collection",uum_p0281.xml,80444/xv73828,1,2,8,11
"University of Utah Secretary and Controller's Office records",uum_acc0047.xml,80444/xv61282,7,4,0,11
"Alene Dalton papers",uum_accn0955.xml,80444/xv91369,2,5,4,11
"Nathan Cook Meeker papers",uum_accn1318.xml,80444/xv18188,4,2,5,11
"Levi Savage Jr. diaries",uum_ms0070.xml,80444/xv30975,7,2,2,11
"John Weisheit papers",uum_accn1733.xml,80444/xv80331,4,1,6,11
"John W. Fitzgerald papers",uum_ms0239.xml,80444/xv18582,10,0,1,11
"Hamilton, Nevada Masonic Lodge and the Ely, Nevada Knights Templar records",uum_accn2810.xml,80444/xv29656,3,6,2,11
"University of Utah Founder's Day essay and oration contest records",uum_acc0093.xml,80444/xv83071,0,5,6,11
"University of Utah Dean of Students Office records",uum_acc0134.xml,80444/xv24591,2,6,3,11
"Gerhard Ernst Untermann photograph collection",uum_p0118.xml,80444/xv48608,1,4,6,11
"Ernest H. Runyon papers",uum_accn1866.xml,80444/xv40850,3,4,4,11
"University of Utah Honorary Degree Committee records",uum_acc0493.xml,80444/xv88278,0,11,0,11
"Roy Gibson papers",uum_accn1132.xml,80444/xv24679,2,4,5,11
"Willard and Betty Wilkinson home movies",uum_a0870.xml,80444/xv86993,5,2,4,11
"Martin Zwick photograph collection",uum_p0443.xml,80444/xv90380,1,6,4,11
"Shirley Ririe papers",uum_accn2320.xml,80444/xv73428,5,6,0,11
"Arden R. Gaufin papers",uum_accn1089.xml,80444/xv14199,9,2,0,11
"Nathan Woolley papers",uum_accn1408.xml,80444/xv04458,1,7,3,11
"<title render="italic">Lost Forever, Everett Ruess</title> motion picture",uum_a0707.xml,80444/xv20333,2,4,5,11
"University of Utah Department of Family and Community Medicine records",uum_acc0463.xml,80444/xv65701,10,1,0,11
"James John Brophy papers",uum_accn1222.xml,80444/xv43823,0,5,6,11
"Ely, Nevada Masonic Lodge records",uum_accn2809.xml,80444/xv81625,7,0,4,11
"Utah Library Association records",uum_ms0154.xml,80444/xv48999,4,3,4,11
"University of Utah Mothers' Club records",uum_acc0052.xml,80444/xv00482,2,4,5,11
""This Week We Honor" scrapbooks",uum_accn1176.xml,80444/xv25189,9,1,1,11
"Alfred C. Emery presidential records",uum_acc0213.xml,80444/xv60296,5,3,3,11
"Jean Rio Pearce diary",uum_ms0066.xml,80444/xv23425,3,6,2,11
"Julia Josephine Spencer Snow biography",uum_ms0087.xml,80444/xv61996,2,6,3,11
"Neil L. Astle papers",uum_accn1930.xml,80444/xv21496,3,2,6,11
"University of Utah Vice President for Administrative Services records",uum_acc0545.xml,80444/xv05487,4,4,3,11
"University of Utah Board of Regents meeting minutes",uum_acc0139.xml,80444/xv63412,5,6,0,11
"Robert F. Bennett papers",uum_accn1423.xml,80444/xv27175,3,6,2,11
"Angus Munn Woodbury photograph collection",uum_p0176.xml,80444/xv17907,5,1,5,11
"Japanese American relocation collection",uum_ms0144.xml,80444/xv33798,1,4,6,11
"University of Utah Division of Continuing Education lectures and concerts records",uum_acc0513.xml,80444/xv47698,1,2,8,11
"German prisoners of war at Fort Douglas collection",uum_ms0646.xml,80444/xv66378,3,3,5,11
"Daria Book Club records",uum_accn1791.xml,80444/xv93731,3,3,5,11
"Jack Adamson papers",uum_acc0278.xml,80444/xv66445,3,4,4,11
"Edward Abbey papers",uum_accn2444.xml,80444/xv00601,3,3,5,11
"Rodney H. Brady papers",uum_accn0324.xml,80444/xv31240,7,0,4,11
"Emery County Aerial photograph collection",uum_p0333.xml,80444/xv08599,6,2,3,11
"Lennox Tierney interviews audio-visual collection",uum_a0489.xml,80444/xv02902,3,1,7,11
"Stanley Jones papers",uum_ms0335.xml,80444/xv30526,9,0,2,11
"S. S. Stevens papers",uum_accn1888.xml,80444/xv76937,9,2,0,11
"Rocco C. Siciliano papers",uum_accn1639.xml,80444/xv75296,2,4,5,11
"Ted Major photograph collection",uum_p0402.xml,80444/xv74356,0,2,9,11
"Seville Flowers papers",uum_ms0607.xml,80444/xv83236,0,3,8,11
"Ladies' Literary Club of Salt Lake City records",uum_ms0439.xml,80444/xv12194,5,0,6,11
"Aloysius S. Church restaurant review video collection",uum_a1057.xml,80444/xv18600,6,3,2,11
"Ewald Kipp photograph collection",uum_p0011.xml,80444/xv13937,1,8,2,11
"Clark L. Wilson papers",uum_accn1009.xml,80444/xv31838,5,3,3,11
"Peter G. Johnston papers",uum_accn1755.xml,80444/xv42160,0,11,0,11
"Artemus Ward papers",uum_accn2616.xml,80444/xv41000,11,0,0,11
"Neponset Land and Livestock Company records",uum_accn1476.xml,80444/xv40460,7,2,2,11
"Hamilton Gardner papers",uum_ms0057.xml,80444/xv78005,10,1,0,11
"Sowards-Tibbals family papers",uum_accn2027.xml,80444/xv38381,11,0,0,11
"Ivor Delwyn Thomas papers",uum_accn1214.xml,80444/xv09533,4,2,5,11
"Charles James Nabors papers",uum_accn1007.xml,80444/xv85015,9,2,0,11
"Thomas Dearden family papers",uum_ms0506.xml,80444/xv95095,0,7,4,11
"University of Utah Vice President for University Relations Office records",uum_acc0485.xml,80444/xv83990,0,11,0,11
"Nellie Harper Curtis and Myrtle Goddard Browning papers",uum_accn2825.xml,80444/xv81088,5,3,2,10
"Alfred Kessler papers",uum_accn2886.xml,80444/xv04769,5,4,1,10
"Albion W. and Agnes Sharp Caine papers",uum_accn1990.xml,80444/xv73394,0,4,6,10
"Thomas Hart Benton letter",uum_ms0319.xml,80444/xv49700,10,0,0,10
"Charles N. Strevell papers",uum_accn1840.xml,80444/xv81900,1,0,9,10
"University of Utah Bureau of Economic and Business Research records",uum_acc0541.xml,80444/xv86834,0,6,4,10
"Warren Jeffs collection",uum_accn2691.xml,80444/xv38345,8,1,1,10
"Ruth Dickson papers",uum_accn2735.xml,80444/xv80761,3,2,5,10
"Georgius Y. Cannon papers",uum_ms0252.xml,80444/xv03799,1,5,4,10
"University of Utah Department of Anthropology records",uum_acc0499.xml,80444/xv02709,0,5,5,10
"James Stephens Brown papers",uum_ms0010.xml,80444/xv36239,8,0,2,10
"University of Utah Extension Division records",uum_acc0535.xml,80444/xv29046,9,1,0,10
"University of Utah Physical Plant and Operations Office records",uum_acc0080.xml,80444/xv57885,4,5,1,10
"George W. Reed photograph collection",uum_p0184.xml,80444/xv51702,3,4,3,10
"Cottonwood uranium mining oral histories",uum_accn2016.xml,80444/xv97607,0,4,6,10
"Jabez Woodward papers",uum_ms0028.xml,80444/xv52471,0,0,10,10
"University of Utah General Education Program records",uum_acc0330.xml,80444/xv46017,7,3,0,10
"Waldemer P. Read papers",uum_ms0572.xml,80444/xv01074,3,0,7,10
"Mark A. Pendleton papers",uum_accn0732.xml,80444/xv69421,3,1,6,10
"David Brighton Timmins papers",uum_accn2645.xml,80444/xv24304,2,2,6,10
"Ruth Draper Crockatt papers",uum_accn2837.xml,80444/xv74951,7,0,3,10
"Keith B. Farr papers",uum_accn2319.xml,80444/xv95397,0,8,2,10
"University of Utah Director of Intercollegiate Athletics records",uum_acc0079.xml,80444/xv30960,5,5,0,10
"Edward LaChapelle avalanche control video collection",uum_a0439.xml,80444/xv99902,1,1,8,10
"Daniel T. Stetich independent film collection",uum_a0886.xml,80444/xv46359,1,0,9,10
"Joseph Edward Taylor papers",uum_ms0297.xml,80444/xv58428,0,4,6,10
"Amos Davis account book",uum_accn1150.xml,80444/xv03582,5,2,3,10
"Salt Lake County probate records",uum_accn1625.xml,80444/xv19720,1,1,8,10
"John W. Rigdon papers",uum_ms0354.xml,80444/xv01770,4,1,5,10
"Western Federation of Watercolor Societies records",uum_accn2526.xml,80444/xv87777,4,4,2,10
"Donna Toland Smart papers",uum_accn1887.xml,80444/xv62191,7,1,2,10
"Charles W. Lockerbie papers",uum_accn0992.xml,80444/xv36022,10,0,0,10
"Scott & Welch architectural collection",uum_ms0501.xml,80444/xv23077,6,2,2,10
"Evelyn Chase Robison papers",uum_accn1858.xml,80444/xv24697,1,3,6,10
"James Louis Barker papers",uum_ms0611.xml,80444/xv88952,3,2,5,10
"Charles H. Monson papers",uum_ms0609.xml,80444/xv45022,3,1,6,10
"Jesse R. S. Budge journal",uum_ms0197.xml,80444/xv79562,8,2,0,10
"Helen B. Gibbons papers",uum_accn0879.xml,80444/xv62066,2,3,5,10
"Florina Vilate Gay Bond ledger",uum_accn2544.xml,80444/xv28149,8,1,1,10
"Athol Graham video collection",uum_a1036.xml,80444/xv25674,8,0,2,10
"Utah Historical American Building Survey (HABS) collection",uum_accn2611.xml,80444/xv82458,6,4,0,10
"Isaac Blair Evans papers",uum_accn2900.xml,80444/xv41204,5,5,0,10
"Midland Bridge Company photograph collection",uum_p0209.xml,80444/xv33889,5,2,3,10
"Phillip C. Blair photograph collection",uum_p0120.xml,80444/xv27941,3,6,1,10
"University of Utah Department of Meteorology records",uum_acc0459.xml,80444/xv01983,3,3,4,10
"University of Utah Department of Chemistry records",uum_acc0307.xml,80444/xv22085,9,1,0,10
"Hadassah, Utah Chapter, records",uum_accn0938.xml,80444/xv04684,9,1,0,10
"Sterling W. Sill papers",uum_accn1133.xml,80444/xv91113,4,3,3,10
"Mark E. Petersen papers",uum_ms0376.xml,80444/xv73999,4,3,3,10
"Amy Engen photograph collection",uum_p0510.xml,80444/xv25686,5,2,3,10
"University of Utah Board of Regents records",uum_acc0030.xml,80444/xv83554,2,8,0,10
"Lila Eccles Brimhall photograph collection",uum_p0337.xml,80444/xv10983,5,2,3,10
"Ogden Writers Series audio collection",uum_a0334.xml,80444/xv45269,9,0,1,10
"University of Utah Economic and business reports and surveys",uum_acc0061.xml,80444/xv38549,2,4,4,10
"Isaac Chauncey Haight papers",uum_ms0084.xml,80444/xv54946,0,0,10,10
"Japanese Church of Christ records",uum_accn2182.xml,80444/xv80310,8,1,1,10
"M. Lynn Bennion papers",uum_accn0531.xml,80444/xv42675,3,3,4,10
"Nathaniel Baldwin diaries",uum_accn1298.xml,80444/xv31201,4,0,6,10
"Beverly Brown Glauser vocal and instrumental scores collection",uum_accn1517.xml,80444/xv60824,5,0,5,10
"Williams family ranch home movies",uum_a1072.xml,80444/xv54077,3,4,3,10
"Karl A. Fox papers",uum_accn1949.xml,80444/xv45144,10,0,0,10
"Arthur L. Crawford photograph collection",uum_p0022.xml,80444/xv87612,3,2,5,10
"University of Utah Women's Resource Center records",uum_acc0285.xml,80444/xv10113,0,3,7,10
"John Frank Wright photograph collection",uum_p0256.xml,80444/xv58715,6,1,3,10
"William Adam Farish papers",uum_accn1611.xml,80444/xv56781,1,7,2,10
"The Walter and Hays Band Mormon Rap audiocassette",uum_a1082.xml,80444/xv74374,5,4,1,10
"George Richard Hill photograph collection",uum_p0545.xml,80444/xv39208,10,0,0,10
"Henry G. Boyle autobiography and diary",uum_accn0384.xml,80444/xv75012,5,3,2,10
"Betty Shepherd Musser family papers",uum_ms0561.xml,80444/xv31646,3,6,1,10
"Milton E. Wadsworth papers",uum_acc0539.xml,80444/xv43743,1,6,3,10
"William R. Gould papers",uum_ms0619.xml,80444/xv83712,8,0,2,10
"University of Utah Department of Educational Studies records",uum_acc0518.xml,80444/xv55993,9,1,0,10
"University of Utah Department of Biology records",uum_acc0502.xml,80444/xv59085,8,2,0,10
"Nels Anderson papers",uum_ms0122.xml,80444/xv22366,1,5,4,10
"Anders Gustaf Johnson papers",uum_accn1995.xml,80444/xv24081,8,2,0,10
"University of Utah College of Social and Behavioral Science records",uum_acc0320.xml,80444/xv00955,8,2,0,10
"Episcopal Diocese of Utah records",uum_ms0686.xml,80444/xv97299,2,2,6,10
"Erastus and Artimesia Snow papers",uum_ms0385.xml,80444/xv62014,2,3,5,10
"Music Temple visitors registers",uum_ms0661.xml,80444/xv73764,3,2,5,10
"Louise Degn papers",uum_accn2149.xml,80444/xv77999,0,0,10,10
"John Redington journals",uum_accn2356.xml,80444/xv82049,4,5,1,10
"David W. Eckhoff papers",uum_accn2317.xml,80444/xv94281,9,0,1,10
"Geraldine Palmer Jones photograph collection",uum_p1693.xml,80444/xv05270,5,3,2,10
"Moscow Silver Mines Company records",uum_accn0299.xml,80444/xv26062,4,2,4,10
"Donna Hill photograph collection",uum_p0600.xml,80444/xv60009,9,0,1,10
"Martha Spence Heywood diary",uum_ms0160.xml,80444/xv11535,3,1,6,10
"James E. Talmage and Joseph T. Kingsbury presidential records",uum_acc0002.xml,80444/xv87832,2,4,3,9
"Mark Stiegemeier papers",uum_accn1942.xml,80444/xv14764,6,1,2,9
"Sarah Maria Mousley Cannon diary typescript",uum_ms0302.xml,80444/xv47418,8,1,0,9
"Rick Page independent film collection",uum_a0771.xml,80444/xv43707,0,3,6,9
"David S. Monson papers.",uum_accn0933.xml,80444/xv87939,7,0,2,9
"Henry L. A. Culmer papers",uum_ms0157.xml,80444/xv11230,1,5,3,9
"Corey (Kaare) Engen scrapbooks",uum_accn1401.xml,80444/xv54980,7,0,2,9
"Arthur Pedersen Freber photograph collection",uum_p0234.xml,80444/xv89691,3,3,3,9
"Walter Siegfried Loewe papers",uum_accn0271.xml,80444/xv28570,3,5,1,9
"University of Utah Marriott Library department heads meeting minutes",uum_acc0132.xml,80444/xv62832,4,3,2,9
"Snow Cup Race scrapbook",uum_accn2617.xml,80444/xv15148,7,2,0,9
"Michael Nakoryakov papers",uum_accn2599.xml,80444/xv64685,9,0,0,9
"Silver King Coalition Mines Company records",uum_accn1239.xml,80444/xv72802,4,1,4,9
"Utah State Democratic Committee photograph collection",uum_p0095.xml,80444/xv55834,9,0,0,9
"University of Utah Academic Vice President's Office Faculty advisory committees records",uum_acc0157.xml,80444/xv49243,3,1,5,9
"ENECO records",uum_accn2464.xml,80444/xv11349,9,0,0,9
"Aroet Lucius Hale papers",uum_ms0520.xml,80444/xv18029,3,2,4,9
"Charles Morey papers",uum_accn2675.xml,80444/xv47775,4,3,2,9
"Kelly Wilson independent film collection",uum_a0802.xml,80444/xv72613,0,4,5,9
"Brixen & Christopher architectural firm records",uum_accn2897.xml,80444/xv21588,8,1,0,9
"Samuel Lindsey Sprague family papers",uum_accn2476.xml,80444/xv64715,9,0,0,9
"University of Utah Plant Operations Office records",uum_acc0452.xml,80444/xv26733,2,1,6,9
"Gary and Ann Crocker papers",uum_accn2773.xml,80444/xv26806,1,1,7,9
"University of Utah Institutional Council records",uum_acc0089.xml,80444/xv53265,6,1,2,9
"George W. Latimer papers",uum_ms0237.xml,80444/xv65194,4,0,5,9
"Michael Martinez papers",uum_accn2749.xml,80444/xv85940,1,5,3,9
"Ralph and Susannah Smith collection",uum_accn0610.xml,80444/xv81317,4,3,2,9
"University of Utah AirMed Department video collection",uum_a0010.xml,80444/xv17834,3,3,3,9
"Good Shepherd Lutheran Church records",uum_ms0649.xml,80444/xv17697,8,1,0,9
"University of Utah Plant Operations Office building records",uum_acc0274.xml,80444/xv02621,6,3,0,9
"Combined Metals Reduction Company records",uum_accn0493.xml,80444/xv33703,5,2,2,9
"George Barfoot papers",uum_accn1799.xml,80444/xv73980,1,5,3,9
"Wendover Utah Air Base photograph collection",uum_p0581.xml,80444/xv48431,5,2,2,9
"Service Star Legion records",uum_ms0222.xml,80444/xv12863,4,3,2,9
"Thomas Kearns scrapbooks",uum_accn2626.xml,80444/xv26501,0,5,4,9
"University of Utah Audio-Visual Archive collection compilation videos",uum_a0100.xml,80444/xv93908,5,1,3,9
"Julius Benedict Bearnson papers",uum_accn2407.xml,80444/xv93115,7,2,0,9
"Hirum B. Clawson photograph collection",uum_p0040.xml,80444/xv54153,4,4,1,9
"University of Utah Vice President For Health Sciences records",uum_acc0475.xml,80444/xv40222,2,2,5,9
"University of Utah Student Involvement Center Fraternity and sorority records",uum_acc0097.xml,80444/xv19970,3,6,0,9
"James G. Bleak papers",uum_accn0194.xml,80444/xv52224,3,4,2,9
"Roger Bailey Traveling Fellowship sketchbooks",uum_accn2495.xml,80444/xv77786,1,6,2,9
"University of Utah Student Family Housing Office records",uum_acc0488.xml,80444/xv33358,3,3,3,9
"Tyrone Davies independent film collection",uum_a0761.xml,80444/xv28988,3,2,4,9
"Rowland Hall-St. Mark's School records",uum_accn2142.xml,80444/xv98117,1,2,6,9
"Mary Hooper Blood Linford papers",uum_accn2337.xml,80444/xv72692,2,5,2,9
"Utah quilt heritage records",uum_accn1878.xml,80444/xv99929,1,2,6,9
"Harold George Wagstaff autobiography",uum_accn0759.xml,80444/xv09600,1,4,4,9
"University of Utah Department of Journalism records",uum_acc0163.xml,80444/xv07778,3,5,1,9
"Sumner School of Salt Lake City project collection",uum_accn2794.xml,80444/xv48254,9,0,0,9
"Frank Cyrus Carman papers",uum_accn1004.xml,80444/xv02749,7,0,2,9
"Willis Carl and Pearl Graul Nugent papers",uum_accn2471.xml,80444/xv32714,8,1,0,9
"Allen Publishing Company records",uum_ms0416.xml,80444/xv52914,4,1,4,9
"Von M. White papers",uum_accn1947.xml,80444/xv80838,5,2,2,9
"LDS Church Galilee Branch interviews",uum_accn2606.xml,80444/xv09207,1,4,4,9
"University of Utah Library administration records",uum_acc0304.xml,80444/xv56542,4,4,1,9
"University of Utah College of Engineering records",uum_acc0356.xml,80444/xv45855,0,4,5,9
"Robert C. Pendleton papers",uum_acc0275.xml,80444/xv25433,2,4,3,9
"Sam Kiefer papers",uum_accn1396.xml,80444/xv53506,9,0,0,9
"Mario DeAngelis independent film collection",uum_a0807.xml,80444/xv35531,3,3,3,9
"Utah Math and Science Network records",uum_accn2527.xml,80444/xv89852,7,0,2,9
"Quintus Charles Wilson papers",uum_accn1897.xml,80444/xv19226,9,0,0,9
"J. Nile Washburn papers",uum_accn2725.xml,80444/xv38912,9,0,0,9
"Church of Jesus Christ of Latter-day Saints History photograph collection",uum_p0056.xml,80444/xv29711,3,1,5,9
"LaVar Webb photograph collection",uum_p0454.xml,80444/xv25173,5,2,2,9
"Thomas F. Dougherty papers",uum_accn0991.xml,80444/xv22799,7,2,0,9
"John Meldrum diary",uum_accn0535.xml,80444/xv17871,3,5,1,9
"Stephen Williams independent film collection",uum_a0809.xml,80444/xv91351,0,0,9,9
"Works Progress Administration photograph collection",uum_p0169.xml,80444/xv86672,3,4,2,9
"Don D. Walker papers",uum_accn0064.xml,80444/xv42373,7,2,0,9
"Eliza Ann Bennion papers",uum_accn1988.xml,80444/xv50845,0,5,4,9
"James Ferguson papers",uum_ms0311.xml,80444/xv72930,2,2,5,9
"Herbert Z. Lund photograph collection",uum_p0075.xml,80444/xv87551,4,0,5,9
"Daughters of the American Colonists papers",uum_ms0223.xml,80444/xv61926,2,1,6,9
"G. T. Riser agreement",uum_accn1263.xml,80444/xv82330,7,0,2,9
"Leo Tolstoy and Barbara Samuels papers",uum_ms0482.xml,80444/xv72689,0,4,5,9
"University of Utah College of Letters and Science records",uum_acc0235.xml,80444/xv50009,0,2,7,9
"Reeder family safaris home movie collection",uum_a1087.xml,80444/xv34329,1,2,6,9
"Alvin G. and Lena M. Pack papers",uum_accn1005.xml,80444/xv93499,9,0,0,9
"University of Utah faculty by-laws and regulations",uum_acc0092.xml,80444/xv55047,7,2,0,9
"R. Lloyd Snedaker papers",uum_accn1105.xml,80444/xv93179,2,4,3,9
"University of Utah Men's Loan Fund financial records",uum_acc0034.xml,80444/xv31082,8,1,0,9
"EIMCO oral history project",uum_accn2183.xml,80444/xv17285,2,3,4,9
"William James Monroe papers",uum_accn1796.xml,80444/xv39840,9,0,0,9
"Mack S. Kesler papers",uum_accn0220.xml,80444/xv22262,0,0,9,9
"Loren E. Morey papers",uum_accn1860.xml,80444/xv25579,4,2,3,9
"Church of the Firstborn of the Fulness of Times letter",uum_accn0125.xml,80444/xv43795,3,2,4,9
"Karen Shepherd papers",uum_accn1426.xml,80444/xv11703,4,2,3,9
"Henry Aldous Dixon papers",uum_ms0548.xml,80444/xv72528,7,1,1,9
"Timpanogos Cave National Monument photograph collection",uum_p0315.xml,80444/xv61877,5,4,0,9
"Theater photograph collection",uum_p0147.xml,80444/xv23278,0,6,3,9
"University of Utah Student Involvement Center Fraternity park records",uum_acc0096.xml,80444/xv14361,0,6,3,9
"Miles Pratt Romney papers",uum_accn1732.xml,80444/xv84506,2,3,4,9
"Warm Springs Rapid history project",uum_accn2554.xml,80444/xv49304,0,6,3,9
"Daniel Hamer papers",uum_ms0067.xml,80444/xv63153,1,5,3,9
"Brewster Ghiselin photograph collection",uum_p0296.xml,80444/xv66281,5,4,0,9
"Red Butte Press photograph collection",uum_p0067.xml,80444/xv57955,5,0,4,9
"University of Utah Extension Division records",uum_acc0069.xml,80444/xv08154,2,6,1,9
"University of Utah Faculty Women's Club records",uum_acc0041.xml,80444/xv91604,6,3,0,9
"Deedee Corradini audio-visual collection",uum_a0736.xml,80444/xv50997,0,0,9,9
"Michael D. <emph render="doublequote">Mickey</emph> Gallivan papers",uum_accn2439.xml,80444/xv26763,3,2,4,9
"B. Roland Lewis papers",uum_ms0137.xml,80444/xv57269,1,4,4,9
"Tim Wengerd papers",uum_accn1122.xml,80444/xv22116,7,2,0,9
"Arthur and Emma Krause papers",uum_accn1769.xml,80444/xv15313,4,5,0,9
"S. Lyman Tyler photograph collection",uum_p0462.xml,80444/xv66247,0,1,8,9
"University of Utah University Year for Action records",uum_acc0332.xml,80444/xv93966,5,2,2,9
"Archibald Gardner papers",uum_accn1485.xml,80444/xv40335,0,6,3,9
"Eugene Callaghan papers",uum_accn1764.xml,80444/xv82241,6,3,0,9
"James Chipman Fletcher presidential records",uum_acc0199.xml,80444/xv99008,4,3,2,9
"Suzy Harris Rytting audio-visual ski collection",uum_a0622.xml,80444/xv17550,7,2,0,9
"University of Utah Honorary Degree Committee correspondence and questionnaires",uum_acc0004.xml,80444/xv04055,8,1,0,9
"University of Utah Associate Dean of Student Affairs records",uum_acc0271.xml,80444/xv94097,0,2,6,8
"Richard Wright Young photograph collection",uum_p0326.xml,80444/xv58752,5,3,0,8
"University of Utah College of Humanities records",uum_acc0329.xml,80444/xv66989,1,2,5,8
"Abraham Hoagland Cannon papers",uum_ms0003.xml,80444/xv43090,3,2,3,8
"Leo Loving independent film collection",uum_a0765.xml,80444/xv58898,3,2,3,8
"Salt Lake Tribune editorial scrapbooks",uum_accn1030.xml,80444/xv77239,7,1,0,8
"Darrell "Pinky" Robison photograph collection",uum_p0407.xml,80444/xv43081,7,1,0,8
"John O'M Bockris papers",uum_accn2732.xml,80444/xv17037,3,3,2,8
"Jerry Dixon smokejumping film",uum_a0812.xml,80444/xv37399,1,1,6,8
"Junior League of Salt Lake City records",uum_ms0359.xml,80444/xv46289,2,1,5,8
"Dale L. Morgan photograph collection",uum_p0556.xml,80444/xv32226,0,2,6,8
"Joseph Ray and Lorna Siddoway Broadbent papers",uum_accn2425.xml,80444/xv71447,1,5,2,8
"University of Utah Commencement Committee records",uum_acc0119.xml,80444/xv62042,1,2,5,8
"Frank H. Jonas photograph collection",uum_p0035.xml,80444/xv00405,1,4,3,8
"University of Utah Institutional Studies Office records",uum_acc0095.xml,80444/xv22460,3,5,0,8
"Nancy Melich papers",uum_accn2470.xml,80444/xv65322,0,4,4,8
"Michael Joseph Gorrell papers",uum_accn0120.xml,80444/xv97866,3,3,2,8
"Green River photograph collection",uum_p0085.xml,80444/xv37850,1,2,5,8
"Chase N. Peterson presidential records",uum_acc0483.xml,80444/xv68719,1,5,2,8
"Albert H. Kneale papers",uum_accn2653.xml,80444/xv54217,5,0,3,8
"Eugene Hilton photograph collection",uum_p0559.xml,80444/xv67111,1,3,4,8
"Ray W. Olsen yearbook collection",uum_accn2769.xml,80444/xv56607,6,0,2,8
"W. A. Clay papers",uum_ms0391.xml,80444/xv74206,3,0,5,8
"Dean R. Brimhall photograph collection",uum_p0114.xml,80444/xv70626,6,2,0,8
"Frank O'Rourke audio book",uum_a0629.xml,80444/xv72399,3,1,4,8
"Glade Peterson papers",uum_accn1413.xml,80444/xv54907,2,4,2,8
"Joseph Howard McGibbeny papers",uum_ms0259.xml,80444/xv49237,1,4,3,8
"Jackson Newell papers",uum_acc0525.xml,80444/xv47409,3,3,2,8
"J. D. Williams papers",uum_ms0245.xml,80444/xv70108,5,0,3,8
"University of Utah Alumni Association records",uum_acc0081.xml,80444/xv72946,3,4,1,8
"Lorenzo Snow letter",uum_accn2638.xml,80444/xv02249,0,3,5,8
"Clyde Eddy book",uum_accn2760.xml,80444/xv70968,7,1,0,8
"John L. Ballif scrapbook",uum_acc0427.xml,80444/xv90286,3,2,3,8
"University of Utah performing arts collection",uum_acc0477.xml,80444/xv91967,3,5,0,8
"Richard and Charlotte Cramer Brown yearbook collection",uum_accn2753.xml,80444/xv54049,1,5,2,8
"George L. Hoggan papers",uum_accn1357.xml,80444/xv18920,5,0,3,8
"John A. Widstoe presidential records",uum_acc0009.xml,80444/xv45526,2,4,2,8
"William Alexander Carter correspondence",uum_accn2496.xml,80444/xv19760,7,1,0,8
"Maydell Cazier Palmer autobiography",uum_accn0870.xml,80444/xv01937,8,0,0,8
"Angus Munn Woodbury papers",uum_ms0176.xml,80444/xv97515,1,5,2,8
"Nathan Davis papers",uum_accn0275.xml,80444/xv83374,8,0,0,8
"Johan Henri Moser papers",uum_ms0275.xml,80444/xv36529,4,0,4,8
"Academic Vice President's Office records",uum_acc0003.xml,80444/xv84652,0,8,0,8
"University of Utah Department of Geology and Geophysics records",uum_acc0420.xml,80444/xv51968,0,4,4,8
"John Max Wendel papers",uum_accn2191.xml,80444/xv39324,4,0,4,8
"Cedric I. Davern papers",uum_accn1759.xml,80444/xv19262,5,2,1,8
"Richard J. Cummings papers",uum_acc0484.xml,80444/xv26962,0,4,4,8
"United States Student War Loans Program records",uum_acc0311.xml,80444/xv82962,2,1,5,8
"Ballet West promotional materials audio-visual collection",uum_a0322.xml,80444/xv08282,0,2,6,8
"Louis S. Goodman papers",uum_accn0937.xml,80444/xv62020,0,8,0,8
"Bob Flodine papers",uum_accn2709.xml,80444/xv32519,0,1,7,8
"William Clayton papers",uum_ms0055.xml,80444/xv30578,1,4,3,8
"C. B. Suzen Timentwa papers",uum_ms0683.xml,80444/xv51000,2,0,6,8
"Dan Vogel papers",uum_accn1444.xml,80444/xv88766,3,4,1,8
"Doris C. Whittier papers",uum_accn2442.xml,80444/xv43084,3,4,1,8
"University of Utah Department of History records",uum_acc0075.xml,80444/xv24328,2,4,2,8
"University of Utah Dean of the Graduate School of Education records",uum_acc0082.xml,80444/xv15295,3,5,0,8
"University of Utah Department of Physics records",uum_acc0363.xml,80444/xv38067,0,2,6,8
"Salt Lake underground and counterculture collection",uum_accn2844.xml,80444/xv27783,0,5,3,8
"LeRoy Eugene Cowles presidential records",uum_acc0023.xml,80444/xv88644,3,4,1,8
"Herbert J. Foulger diary",uum_ms0363.xml,80444/xv44668,3,0,5,8
"Klancy Clark De Nevers papers",uum_accn2285.xml,80444/xv33941,0,2,6,8
"Sterling B. Talmage papers",uum_accn0724.xml,80444/xv17584,3,0,5,8
"William R. and Erlyn Gould Distinguished Lecture on Technology and the Quality of Life Series video recordings",uum_a0214.xml,80444/xv22717,3,2,3,8
"Gordon Neff papers",uum_accn2359.xml,80444/xv95336,2,4,2,8
"University of Utah Faculty Council meeting minutes and agendas",uum_acc0010.xml,80444/xv46899,5,3,0,8
"Adrien and Emilie Segil papers",uum_accn1402.xml,80444/xv46267,4,2,2,8
"University of Utah College of Fine Arts records",uum_acc0516.xml,80444/xv44036,2,4,2,8
"Arturo de Hoyos papers",uum_ms0384.xml,80444/xv21948,3,2,3,8
"University of Utah Business Services Office records",uum_acc0364.xml,80444/xv39944,7,1,0,8
"Sandra Sheets Denman papers",uum_accn2755.xml,80444/xv35037,7,1,0,8
"Unknown",uum_accn2084.xml,80444/xv65798,2,3,3,8
"Rulon S. Wells papers",uum_accn2121.xml,80444/xv34851,2,5,1,8
"E. Jay Bell papers",uum_accn1487.xml,80444/xv23028,3,0,5,8
"G. Bennet Larson photograph collection",uum_p0048.xml,80444/xv67697,6,1,1,8
"Axel J. Andresen papers",uum_accn1917.xml,80444/xv07449,8,0,0,8
"Benjamin M. Roe photograph collection",uum_p0139.xml,80444/xv71179,4,1,3,8
"University of Utah Student Affairs Office records",uum_acc0354.xml,80444/xv28521,4,3,1,8
"Sugarhouse Kiwanis Club records",uum_accn2432.xml,80444/xv09634,8,0,0,8
"Kilton Riggs Stewart papers",uum_accn2824.xml,80444/xv92440,4,1,3,8
"University of Utah Department of Physics records",uum_acc0453.xml,80444/xv50585,3,1,4,8
"Louis C. Zucker photograph collection",uum_p0313.xml,80444/xv58813,5,1,2,8
"Uintah County Wool Growers Association meeting minutes",uum_ms0635.xml,80444/xv16995,8,0,0,8
"Rosemary Holt papers",uum_accn2054.xml,80444/xv48818,4,3,1,8
"University of Utah Department of Philosophy records",uum_acc0504.xml,80444/xv43405,1,7,0,8
"Charles Butler and Alice Hunt papers",uum_accn1430.xml,80444/xv36904,0,8,0,8
"Indian Community Action Program records",uum_acc0165.xml,80444/xv82235,0,1,7,8
"Adolf Hitler Christmas card",uum_accn1514.xml,80444/xv44943,0,1,7,8
"Japanese American Citizens League (JACL), Utah Chapter records",uum_accn1852.xml,80444/xv39816,3,2,3,8
"H. Guy Child Elementary School Olympic activities records",uum_accn1996.xml,80444/xv29940,8,0,0,8
"Kenneth Eugene Eble papers",uum_accn1216.xml,80444/xv08428,3,3,2,8
"Dan Marriott photograph collection",uum_p0257.xml,80444/xv77243,3,3,2,8
"University of Utah University theater records",uum_acc0170.xml,80444/xv84707,4,4,0,8
"Community Congregational Church of Provo photograph collection",uum_p0255.xml,80444/xv87948,6,1,1,8
"Central States Communication Association records",uum_accn1774.xml,80444/xv81271,8,0,0,8
"University of Utah Alumni Association records",uum_acc0548.xml,80444/xv08105,7,0,1,8
"Richard A. Keller, III papers",uum_accn2708.xml,80444/xv16732,4,2,2,8
"Joseph A. Curtis papers",uum_accn1229.xml,80444/xv99264,7,1,0,8
"University of Utah Graduate Council records",uum_acc0057.xml,80444/xv12487,8,0,0,8
"Church of Jesus Christ of Latter-day Saints Missionary Postcards photograph collection",uum_p0522.xml,80444/xv39245,2,5,1,8
"Standley Hunter Rich papers",uum_ms0367.xml,80444/xv07009,5,3,0,8
"Susan Barbara Tallmon Sargent papers",uum_accn1107.xml,80444/xv57006,7,1,0,8
"Gilmer and Salisbury Stage Lines ledger",uum_accn0570.xml,80444/xv51086,0,2,6,8
"Paul W. Hodson photograph collection",uum_p0464.xml,80444/xv38241,0,6,2,8
"Fern Taylor papers",uum_accn0705.xml,80444/xv86090,3,1,4,8
"W. Stewart Gardiner papers",uum_accn1801.xml,80444/xv72811,3,2,3,8
"Maxine Olive Ward McIntyre papers",uum_accn2813.xml,80444/xv37524,3,5,0,8
"Southern Slavic photograph collection",uum_p0028.xml,80444/xv31658,0,6,2,8
"Christopher C. Heaton papers",uum_accn2246.xml,80444/xv84350,3,5,0,8
"Ted and Yeiko Nagata papers",uum_accn2035.xml,80444/xv97766,2,4,2,8
"Vern Adix papers",uum_ms0492.xml,80444/xv64880,3,3,2,8
"Hugh J. Cannon correspondence",uum_accn0919.xml,80444/xv94335,3,1,4,8
"L. Clyde Anderson papers",uum_accn0925.xml,80444/xv79650,3,0,5,8
"Neighborhood House records",uum_ms0455.xml,80444/xv82589,3,0,5,8
"John Hamilton Morgan papers",uum_accn1465.xml,80444/xv59942,1,3,4,8
"Claude T. Barnes papers",uum_accn2641.xml,80444/xv63516,2,4,2,8
"John "Jack" Thomas photograph collection",uum_p0506.xml,80444/xv59243,3,2,3,8
"Edward L. Kimball papers",uum_accn2210.xml,80444/xv88540,3,4,1,8
"Nephi James Brown papers",uum_accn0167.xml,80444/xv43008,0,2,6,8
"Young Women's Christian Assocation photograph collection",uum_p0353.xml,80444/xv06045,7,1,0,8
"KUED-TV Utah World War II Stories audio visual collection",uum_a1171.xml,80444/xv24066,4,1,3,8
"Karl Maeser and Valeria Cheney Pack papers",uum_accn1993.xml,80444/xv33816,0,1,7,8
"Jeanette McKay Morrell papers",uum_ms0684.xml,80444/xv27743,0,5,3,8
"Martha Ross Stewart papers",uum_accn2000.xml,80444/xv34762,3,2,3,8
"University of Utah University Writing Program records",uum_acc0486.xml,80444/xv35260,1,3,4,8
"Lot Smith papers",uum_ms0004.xml,80444/xv38250,3,3,2,8
"Maxwell Myer Wintrobe video collection",uum_a0307.xml,80444/xv26907,0,1,7,8
"John Alexander Bevan papers",uum_accn0382.xml,80444/xv13378,0,6,2,8
"Sheri Slaughter Utah pottery collection",uum_accn1580.xml,80444/xv05838,6,0,2,8
"ZCMI photograph collection",uum_p0507.xml,80444/xv58227,6,1,1,8
"Baltzar Hans Jacobson papers",uum_accn0716.xml,80444/xv38906,4,3,1,8
"John Held Jr. collection",uum_accn2845.xml,80444/xv33477,4,3,1,8
"Ralph Taylor Richards papers",uum_ms0258.xml,80444/xv63070,3,4,1,8
"Leo G. Provost papers",uum_acc0295.xml,80444/xv67190,2,4,2,8
"Faye Glover Petersen papers",uum_accn0100.xml,80444/xv78009,3,2,2,7
"Virgil C. Aldrich papers",uum_accn1726.xml,80444/xv03375,4,0,3,7
"Ezra Taft Benson autobiography",uum_ms0381.xml,80444/xv04638,7,0,0,7
"Charles C. Hughes papers",uum_accn1865.xml,80444/xv91342,2,0,5,7
"Antoine R. Ivins papers",uum_accn1541.xml,80444/xv72552,0,0,7,7
"John Hubbard Noakes papers",uum_accn2272.xml,80444/xv32479,4,0,3,7
"Nancy Ellen Hunt Pierce Durfee collection",uum_ms0601.xml,80444/xv65347,0,7,0,7
"Leonhard Michael Wendel papers",uum_accn2481.xml,80444/xv61227,2,3,2,7
"New Park Mining Company records",uum_accn1841.xml,80444/xv98760,3,3,1,7
"Richard J. Bird photograph collection",uum_p0388.xml,80444/xv96984,0,0,7,7
"John Peperakis papers",uum_accn1436.xml,80444/xv75711,3,4,0,7
"Brigham Young Diary photograph collection",uum_p0175.xml,80444/xv37460,3,2,2,7
"William L. English journal",uum_ms0132.xml,80444/xv96893,2,0,5,7
"Weeks family correspondence",uum_accn0808.xml,80444/xv92501,0,0,7,7
"Robert M. Jones papers",uum_accn1399.xml,80444/xv57153,4,3,0,7
"Henry Weeks Sanderson papers",uum_ms0255.xml,80444/xv23348,4,3,0,7
"Third Saturday Night Dance Club records",uum_accn1609.xml,80444/xv09005,3,3,1,7
"Roscoe E. Grover notebook",uum_accn2666.xml,80444/xv55160,5,1,1,7
"Philo T. Farnsworth papers",uum_accn2807.xml,80444/xv46350,4,2,1,7
"Francis Dunham Wormuth papers",uum_acc0262.xml,80444/xv35482,1,2,4,7
"Wyoming Stock Growers Association records",uum_ms0397.xml,80444/xv69482,0,4,3,7
"Albert Ray Olpin journals",uum_acc0219.xml,80444/xv20889,0,2,5,7
"G. Homer Durham papers",uum_accn0847.xml,80444/xv39703,0,3,4,7
"LeRoy Robertson photograph collection",uum_p0038.xml,80444/xv35668,4,3,0,7
"University of Utah Fraternity Advisory Committee records",uum_acc0197.xml,80444/xv07165,2,2,3,7
"Omer Call Stewart papers",uum_ms0612.xml,80444/xv13748,3,4,0,7
"Franklin Richards Smith papers",uum_accn1522.xml,80444/xv11807,3,2,2,7
"A. Milton Musser papers",uum_accn1404.xml,80444/xv54354,5,2,0,7
"University of Utah Campus Planning and Construction Office architectural design programs",uum_acc0216.xml,80444/xv09265,5,1,1,7
"Rosalie Jones research paper",uum_ms0076.xml,80444/xv91311,3,4,0,7
"U.S.S. Salt Lake City photograph collection",uum_p0346.xml,80444/xv11608,0,2,5,7
"Andrew Jenson letter",uum_accn2639.xml,80444/xv82727,2,0,5,7
"University of Utah Department of Journalism records",uum_acc0058.xml,80444/xv76788,2,3,2,7
"Annette R. Dinwoodey photograph collection",uum_p0141.xml,80444/xv34469,1,3,3,7
"G. Ernest Untermann papers",uum_ms0118.xml,80444/xv38626,4,1,2,7
"Sherman P. Lloyd papers",uum_ms0045.xml,80444/xv82293,2,5,0,7
"Edwin G. Woolley report",uum_accn0534.xml,80444/xv51913,6,0,1,7
"Frank Rasmussen papers",uum_accn1269.xml,80444/xv22439,2,2,3,7
"William Spencer papers",uum_accn1794.xml,80444/xv49868,5,2,0,7
"Gladys Young Orlob papers",uum_accn2459.xml,80444/xv17956,2,3,2,7
"Harold P. Fabian papers",uum_ms0136.xml,80444/xv50228,2,0,5,7
"Florence May Baldwin sheet music collection",uum_accn2690.xml,80444/xv94232,3,0,4,7
"John Stoker papers",uum_accn1966.xml,80444/xv04647,4,3,0,7
"Report on certain features of the financial history of the University of Utah from its origin to 1939, [19--] / by J. R. Mahoney",uum_acc0039.xml,80444/xv69577,3,3,1,7
"Leonidas Ralph Mecham papers",uum_accn2288.xml,80444/xv80105,5,2,0,7
"G. Stanley McAllister papers",uum_accn1398.xml,80444/xv64834,0,3,4,7
"Paper doll collection",uum_accn1854.xml,80444/xv28076,7,0,0,7
"Justin Call Stewart papers",uum_accn1449.xml,80444/xv29364,0,3,4,7
"University of Utah Graduate School of Education records",uum_acc0505.xml,80444/xv42382,0,3,4,7
"Philo T. and Elma G. Farnsworth audio collection",uum_a0382.xml,80444/xv81082,2,1,4,7
"Carl Weeks papers",uum_ms0207.xml,80444/xv67236,1,5,1,7
"University of Utah Associate Dean of the College of Letters and Science records",uum_acc0015.xml,80444/xv69741,0,6,1,7
"Bingham Stage Lines photograph collection",uum_p0133.xml,80444/xv29785,0,4,3,7
"Joseph H. McGee diary",uum_accn2403.xml,80444/xv24258,5,2,0,7
"Carl J. Christensen papers",uum_ms0553.xml,80444/xv18103,0,0,7,7
"Deseret University records",uum_ms0299.xml,80444/xv66345,0,3,4,7
"Jarvis Edwin Seegmiller papers",uum_accn1437.xml,80444/xv59005,1,2,4,7
"Powell Society records",uum_accn2486.xml,80444/xv81115,2,2,3,7
"Mike Korologos papers",uum_accn1824.xml,80444/xv52563,3,4,0,7
"Nancee Cortes papers",uum_accn1172.xml,80444/xv92840,4,0,3,7
"Dean Perkins papers",uum_accn2707.xml,80444/xv50158,0,1,6,7
"Louis Cruz Torres oral history",uum_accn2360.xml,80444/xv03253,4,1,2,7
"LGBT protest poster and news clipping",uum_accn2754.xml,80444/xv23507,7,0,0,7
"KUED-TV records",uum_acc0355.xml,80444/xv62106,3,1,3,7
"Lorenzo A. Richards papers",uum_accn2338.xml,80444/xv24108,0,1,6,7
"Jack Sears papers",uum_accn1245.xml,80444/xv33441,2,2,3,7
"University of Utah Office of Cooperative Research correspondence and reports",uum_acc0268.xml,80444/xv84020,0,1,6,7
"University of Utah building costs records, 1890-1930",uum_acc0246.xml,80444/xv78854,5,2,0,7
"Nora Pendleton Horsfall papers",uum_accn0098.xml,80444/xv02093,7,0,0,7
"Madeline Reeder McQuown photograph collection",uum_p0143.xml,80444/xv93951,5,1,1,7
"Hans S. Larsen papers",uum_accn2311.xml,80444/xv79217,3,4,0,7
"Charles Kelly photograph collection",uum_p0100.xml,80444/xv35079,2,2,3,7
"University of Utah Vice President for Student Affairs records",uum_acc0547.xml,80444/xv57708,1,5,1,7
"Inventory of the Institute for Behavioral Research in Creativity (IBRIC) records",uum_accn2612.xml,80444/xv07791,0,3,4,7
"University of Utah Medical Center Financial Services Office memoranda and reports",uum_acc0294.xml,80444/xv15670,6,1,0,7
"University of Utah College of Engineering project records and contracts",uum_acc0243.xml,80444/xv76998,6,1,0,7
"Sports and Olympics thesis collection",uum_accn1560.xml,80444/xv60647,0,5,2,7
"Vivian Snow autobiography",uum_accn1655.xml,80444/xv32327,1,3,3,7
"Little Mountain Ski Area photograph collection",uum_p0387.xml,80444/xv88317,3,0,4,7
"Nicholas Groesbeck Morgan papers",uum_accn1500.xml,80444/xv09716,5,0,2,7
"Peter McIntyre autobiography",uum_ms0029.xml,80444/xv86904,3,2,2,7
"Byron A. Hunter papers",uum_accn1059.xml,80444/xv76644,0,3,4,7
"Richard Whitehead Young papers",uum_ms0104.xml,80444/xv10067,5,1,1,7
"Repertory Dance Theater records",uum_accn0725.xml,80444/xv27102,5,2,0,7
"Spanish Fork, Utah photograph collection",uum_p0014.xml,80444/xv17593,3,3,1,7
"Victor W. Jorgensen papers",uum_accn1416.xml,80444/xv44833,4,3,0,7
"Robert and Wilma Jones home movies",uum_a0638.xml,80444/xv97387,0,5,2,7
"Utahns for Effective Government records",uum_ms0446.xml,80444/xv51837,7,0,0,7
"George Q. Cannon papers",uum_accn1224.xml,80444/xv63177,5,0,2,7
"University of Utah Department of Educational Psychology records",uum_acc0527.xml,80444/xv27392,2,2,3,7
"Richard Romney Clawson photograph collection",uum_p0073.xml,80444/xv29852,5,1,1,7
"Walt Scott papers",uum_accn2133.xml,80444/xv03665,1,6,0,7
"Ruth Harwood photograph collection",uum_p0042.xml,80444/xv33901,4,2,1,7
"Neils Peter Neilson papers",uum_acc0305.xml,80444/xv42926,1,1,5,7
"Utah Holiday records",uum_accn1547.xml,80444/xv58215,2,3,2,7
"Linda Sillitoe papers",uum_accn1262.xml,80444/xv06481,0,2,5,7
"Barbie Patterson Kallerud papers",uum_accn2012.xml,80444/xv21188,0,5,2,7
"Thomas Stuart Ferguson papers",uum_accn1350.xml,80444/xv04864,0,3,4,7
"Grant Ivins Family photograph collection",uum_p0018.xml,80444/xv86578,1,5,1,7
"Utah Engineering Experiment Station records",uum_acc0418.xml,80444/xv12210,6,1,0,7
"Folklore Society of Utah photograph collection",uum_p0205.xml,80444/xv36300,6,0,1,7
"Delta Kappa Gamma Society records",uum_accn0687.xml,80444/xv20605,5,2,0,7
"Aztec Club records",uum_accn1040.xml,80444/xv61437,7,0,0,7
"Stanton G. Fisher diary",uum_ms0006.xml,80444/xv34640,0,4,3,7
"Jesse K. and Lydia Y. Burroughs family papers",uum_accn1299.xml,80444/xv08126,7,0,0,7
"Mountain Meadows Monument Foundation records",uum_accn2023.xml,80444/xv58392,7,0,0,7
"University of Utah Division of Plastic Surgery records",uum_acc0520.xml,80444/xv76971,6,1,0,7
"Spencer S. Eccles Health Sciences Library records",uum_acc0489.xml,80444/xv85095,1,6,0,7
"Mac Madsen papers",uum_accn1931.xml,80444/xv29830,1,5,1,7
"University of Utah Academic Vice President's Office records",uum_acc0198.xml,80444/xv50411,3,3,1,7
"Ercanbrack Fruit Ranch label collection",uum_accn2743.xml,80444/xv43347,7,0,0,7
"Margaret Condie Sharp papers",uum_accn1884.xml,80444/xv42138,4,1,2,7
"Railway collection",uum_accn2731.xml,80444/xv50897,6,0,1,7
"Golden Age Mines Company records",uum_accn0074.xml,80444/xv62573,7,0,0,7
"University of Utah Vice President for University Relations Office records",uum_acc0240.xml,80444/xv43832,0,2,5,7
"Fred A. Rosenstock papers",uum_ms0487.xml,80444/xv20697,0,2,5,7
"Mario S. De Pillis papers",uum_accn2507.xml,80444/xv27209,4,2,1,7
"Wilson McCarthy papers",uum_accn1972.xml,80444/xv81140,2,4,1,7
"Nancy Geckler papers",uum_accn1486.xml,80444/xv50933,0,0,7,7
"Jean and Wilburn Pickett papers",uum_accn1573.xml,80444/xv65222,2,3,2,7
"Mickey Ibarra papers",uum_accn2375.xml,80444/xv27343,3,0,4,7
"Anne Marie Fox Felt photograph collection",uum_p0142.xml,80444/xv46716,3,2,2,7
"Cove Fort, Utah photograph collection",uum_p0076.xml,80444/xv66204,5,0,2,7
"Social Hall research report",uum_ms0323.xml,80444/xv43325,0,0,7,7
"Utah State Auditor audit reports of the University of Utah",uum_acc0048.xml,80444/xv34243,2,3,2,7
"Lawrence Foster papers",uum_accn0750.xml,80444/xv56997,0,0,7,7
"Mike Grom photograph collection",uum_p0398.xml,80444/xv31204,1,3,3,7
"Sun Valley photograph collection",uum_p0396.xml,80444/xv98693,0,5,2,7
"Ted Wilson papers",uum_accn0859.xml,80444/xv72192,7,0,0,7
"United Nations Association of Utah records",uum_accn0726.xml,80444/xv73556,7,0,0,7
"John A. Peperakis photograph collection",uum_p0570.xml,80444/xv62109,0,4,3,7
"Allen H. Lundgren papers",uum_accn1786.xml,80444/xv01901,5,1,1,7
"University of Utah College of Law records",uum_acc0454.xml,80444/xv06015,6,1,0,7
"University of Utah Business Services Office records",uum_acc0312.xml,80444/xv04959,6,1,0,7
"University of Utah Administrative Vice President's Office building records",uum_acc0358.xml,80444/xv00793,2,1,4,7
"Whitaker, John Mills photograph collection",uum_p0276.xml,80444/xv10937,6,1,0,7
"Denver and Rio Grande Western Railroad records",uum_accn0622.xml,80444/xv93637,0,2,5,7
"Shih-Kung Kao papers",uum_accn1237.xml,80444/xv87942,7,0,0,7
"Albert C. Allen photograph collection",uum_p0345.xml,80444/xv49185,1,5,1,7
"Salt Lake City Fire Department photograph collection",uum_p0327.xml,80444/xv82269,2,3,2,7
"L. Clyde Anderson photograph collection",uum_p0158.xml,80444/xv12390,3,1,3,7
"Elton T. Taylor photograph collection consists primarily of a complex scrapbook filled with photographs dating from the late 19th century. Subjects include personal images, and portraits. The collection also contains recent images of Taylor.",uum_p0536.xml,80444/xv80477,5,2,0,7
"Hinckley Institute of Politics meeting minutes and agendas",uum_acc0077.xml,80444/xv88195,2,5,0,7
"Lucy Mack Smith autobiography",uum_accn0989.xml,80444/xv72216,2,5,0,7
"Flora James Barson collection",uum_accn1403.xml,80444/xv09732,0,2,5,7
"Scott, Louie, and Browning Architects records",uum_accn1564.xml,80444/xv60684,6,0,1,7
"Robert N. and Clara (Peggy) Broomfield Sears papers",uum_accn2169.xml,80444/xv62271,2,3,2,7
"University of Utah University regulations library revisions",uum_acc0056.xml,80444/xv33428,7,0,0,7
"Harold Judd Goodro papers",uum_accn1898.xml,80444/xv67993,1,2,4,7
"A Short History of the 85th Mountain Infantry Regiment",uum_accn1628.xml,80444/xv09225,4,1,2,7
"Harvey Harris Cluff collection",uum_accn0566.xml,80444/xv99676,5,2,0,7
"Edward M. Eyring papers",uum_acc0549.xml,80444/xv63610,0,7,0,7
"Ernest Hemingway letter",uum_ms0300.xml,80444/xv48812,7,0,0,7
"Robert G. Vernon papers",uum_accn2219.xml,80444/xv68563,0,5,2,7
"Anne Marie Fox Felt papers",uum_ms0142.xml,80444/xv62637,1,6,0,7
"Olive Woolley Burt papers",uum_ms0244.xml,80444/xv80606,7,0,0,7
"Elijah Malin Weiler papers",uum_accn2216.xml,80444/xv98657,2,3,2,7
"Joseph Severn and Marjorie Allen Jones family papers",uum_accn2560.xml,80444/xv70596,2,3,2,7
"Ruth Harwood papers",uum_ms0375.xml,80444/xv75515,2,2,3,7
"New Quincy Mining Company records",uum_accn0124.xml,80444/xv30718,4,3,0,7
"Walter Pace Cottam papers",uum_accn1152.xml,80444/xv75460,1,4,2,7
"Ralph M. Aldous correspondence",uum_accn2538.xml,80444/xv14968,0,5,2,7
"Lois A. Arnow papers",uum_accn2663.xml,80444/xv57299,7,0,0,7
"Leland H. Jorgensen papers",uum_accn2681.xml,80444/xv77279,0,5,2,7
"Microfilmed copy of the Dale Lowell Morgan papers",uum_ms0560.xml,80444/xv13815,0,7,0,7
"Frederick Kesler family papers",uum_accn2767.xml,80444/xv88265,6,0,1,7
"Alvin L. Gittins papers",uum_accn0909.xml,80444/xv38964,0,1,6,7
"Mark H. Greene report",uum_accn0403.xml,80444/xv25213,7,0,0,7
"Clarence Henderson papers",uum_accn1584.xml,80444/xv20141,1,3,2,6
"Utah Fuel Company records",uum_accn1505.xml,80444/xv87368,2,1,3,6
"Joshua Hughes Paul papers",uum_accn0864.xml,80444/xv97116,1,3,2,6
"Samuel W. Richards journals",uum_accn0140.xml,80444/xv62225,4,0,2,6
"Utah and the West workshop records",uum_acc0029.xml,80444/xv89904,3,3,0,6
"LaMar Petersen papers",uum_ms0524.xml,80444/xv73721,1,1,4,6
"University of Utah College of Humanities records",uum_acc0550.xml,80444/xv23626,1,4,1,6
"University of Utah Academic Vice President's Office records",uum_acc0232.xml,80444/xv98696,2,3,1,6
"Sunnyside, Utah photograph collection",uum_p0235.xml,80444/xv29217,0,4,2,6
"Michele Parish photograph collection",uum_p0531.xml,80444/xv75057,1,4,1,6
"Elias Morris journal",uum_ms0156.xml,80444/xv32553,3,1,2,6
"Franklin S. Harris Jr. papers",uum_accn1384.xml,80444/xv21987,1,0,5,6
"Josh Scheuerman papers",uum_accn1911.xml,80444/xv45709,6,0,0,6
"Robert S. Portlock papers",uum_accn1675.xml,80444/xv15951,0,4,2,6
"Bill Lash photograph collection",uum_p0404.xml,80444/xv45953,0,3,3,6
"University of Utah Research Committee records",uum_acc0118.xml,80444/xv02047,0,6,0,6
"University of Utah Graduate School of Social Work records",uum_acc0360.xml,80444/xv54199,0,3,3,6
"Karl and Vicki Beck Jacobson papers",uum_accn2762.xml,80444/xv69989,1,2,3,6
"Jan Shipps papers",uum_ms0336.xml,80444/xv34530,6,0,0,6
"Haight's Creek Irrigation Company records",uum_accn1608.xml,80444/xv89651,0,5,1,6
"Utah Heritage Foundation records",uum_accn0861.xml,80444/xv81054,2,0,4,6
"Elks Ladies Club records",uum_accn0663.xml,80444/xv82992,4,2,0,6
"Snake Creek Mining District records",uum_accn1021.xml,80444/xv25729,4,0,2,6
"Leia Bell papers",uum_accn2211.xml,80444/xv48822,0,3,3,6
"Charles James Neal papers",uum_accn1588.xml,80444/xv05065,0,3,3,6
"United States. National Youth Administration records",uum_acc0225.xml,80444/xv68161,4,2,0,6
"Utah Recreation photograph collection",uum_p0062.xml,80444/xv80438,4,2,0,6
"Harold W. Bentley papers",uum_acc0195.xml,80444/xv30941,0,3,3,6
"Brigham Madsen audio-visual collection",uum_a0107.xml,80444/xv77883,0,0,6,6
"Harry Haines papers",uum_accn2284.xml,80444/xv27914,5,0,1,6
"Marybeth Raynes papers",uum_accn2073.xml,80444/xv42547,0,4,2,6
"Railroad photograph collection",uum_p0059.xml,80444/xv38189,4,2,0,6
"Drew Hicken papers",uum_accn1909.xml,80444/xv29019,6,0,0,6
"Matthew Fredrick and Claire Wilcox Noall photograph collection",uum_p0188.xml,80444/xv80953,1,4,1,6
"Jack Thomas papers",uum_ms0535.xml,80444/xv10702,3,2,1,6
"La Vern Adix photograph collection",uum_p0316.xml,80444/xv31408,3,0,3,6
"Harold Stanley Sanders collection",uum_accn2589.xml,80444/xv08935,5,1,0,6
"Barney Flanagan papers",uum_accn0710.xml,80444/xv76580,5,0,1,6
"Our Vision, Our Voices: A Mormon Women's Literary Tour records",uum_accn2579.xml,80444/xv63296,3,3,0,6
"William Fletcher Reynolds papers",uum_ms0357.xml,80444/xv67559,5,1,0,6
"Jacob B. Backenstos papers",uum_ms0431.xml,80444/xv55395,6,0,0,6
"Helen Bowring Ure photograph collection",uum_p0509.xml,80444/xv16165,1,2,3,6
"Dick Movitz papers",uum_accn1428.xml,80444/xv80075,6,0,0,6
"Robert L. Autry papers",uum_accn1943.xml,80444/xv20852,1,1,4,6
"University of Utah Deans and department heads meeting minutes",uum_acc0145.xml,80444/xv62350,0,1,5,6
"Salt Lake City School District Board records",uum_accn1264.xml,80444/xv34326,0,3,3,6
"Children's Service Society of Utah records",uum_accn1651.xml,80444/xv81887,3,0,3,6
"Helen B. Andelin papers",uum_accn0551.xml,80444/xv09576,1,0,5,6
"Claudia Sisemore independent film collection",uum_a0035.xml,80444/xv37518,1,2,3,6
"Karin Hodgin Jones independent film collection",uum_a0829.xml,80444/xv50866,0,1,5,6
"Granada Relocation Center (Camp Amache) records",uum_accn1984.xml,80444/xv37408,3,3,0,6
"Joseph P. Surace papers",uum_accn2371.xml,80444/xv31655,2,1,3,6
"Marilyn R. Allen papers",uum_accn1718.xml,80444/xv27139,0,2,4,6
"Mary Gibbs Bigelow autobiography",uum_ms0141.xml,80444/xv51385,2,1,3,6
"Bear Lake resorts and recreation collection",uum_accn0524.xml,80444/xv83978,5,0,1,6
"Emma Josephine Young Gilliland letter",uum_accn0383.xml,80444/xv43548,0,6,0,6
"William R. Halliday papers",uum_accn1458.xml,80444/xv02124,2,4,0,6
"Beehive House Restoration Committee records",uum_ms0340.xml,80444/xv44009,0,2,4,6
"Friendship Manor records",uum_accn1128.xml,80444/xv15475,6,0,0,6
"Ethan Pettit diaries",uum_ms0180.xml,80444/xv22851,3,3,0,6
"Anthony Woodward Ivins papers",uum_ms0167.xml,80444/xv97598,4,1,1,6
"Uintah land development records",uum_accn2614.xml,80444/xv91119,0,2,4,6
"University of Utah Administrative Council (1973-1983) records",uum_acc0425.xml,80444/xv58166,5,1,0,6
"John W. Anthon affidavit",uum_ms0379.xml,80444/xv87765,5,1,0,6
"Saltair Beach Resort records",uum_accn1025.xml,80444/xv51510,4,0,2,6
"Dennis L. Lythgoe papers",uum_accn0800.xml,80444/xv58013,0,0,6,6
"Beehive Golf Club records",uum_accn2034.xml,80444/xv81948,0,0,6,6
"Mary Bennion Powell Muhs papers",uum_accn1124.xml,80444/xv48242,3,3,0,6
"Dale Lowell Morgan papers",uum_ms0579.xml,80444/xv36810,0,6,0,6
"James and Linda Mooney papers",uum_accn2722.xml,80444/xv71502,3,3,0,6
"George H. Taylor autobiography and diary",uum_accn1368.xml,80444/xv60656,4,0,2,6
"The Arnie Ferrin scrapbooks",uum_accn2710.xml,80444/xv82565,6,0,0,6
"Roy Webb papers",uum_accn1000.xml,80444/xv82687,0,5,1,6
"Dorothy Jacobs Buchanan papers",uum_accn2348.xml,80444/xv39141,0,1,5,6
"Moses Thatcher diary",uum_ms0098.xml,80444/xv89996,2,4,0,6
"Thomas J. Harvey papers",uum_accn2669.xml,80444/xv52383,2,1,3,6
"University of Utah Traffic on campus reports",uum_acc0032.xml,80444/xv90121,1,4,1,6
"Jimi Jones independent film collection",uum_a0755.xml,80444/xv54925,0,1,5,6
"Bill Ellis papers",uum_accn2441.xml,80444/xv87548,0,0,6,6
"Logan, Utah photograph collection",uum_p0078.xml,80444/xv10574,5,0,1,6
"Donald G. Godfrey papers",uum_accn1925.xml,80444/xv15563,0,4,2,6
"Dennis D. Doddridge papers",uum_accn2156.xml,80444/xv06661,0,6,0,6
"University of Utah College of Nursing commencement addresses and student lists",uum_acc0148.xml,80444/xv23837,5,1,0,6
"University of Utah Chicano Organizations records",uum_acc0160.xml,80444/xv74526,5,1,0,6
"Virginia Nester photograph collection",uum_p0347.xml,80444/xv49874,1,4,1,6
"Ernest L. Poulson papers",uum_accn0594.xml,80444/xv46502,1,2,3,6
"Wasatch Presbyterian Church records",uum_ms0679.xml,80444/xv68185,0,6,0,6
"Spy Hop Productions records",uum_accn2630.xml,80444/xv77474,5,1,0,6
"Heber Chase Kimball papers",uum_ms0652.xml,80444/xv36804,0,2,4,6
"William Huntington papers",uum_ms0017.xml,80444/xv42340,1,2,3,6
"D. Robert Theobald scrapbook",uum_accn1834.xml,80444/xv03631,0,1,5,6
"Alma John and Alice Lamont Poulter Knapp papers",uum_accn1750.xml,80444/xv65460,4,1,1,6
"Thomas G. Truitt essay",uum_accn0019.xml,80444/xv71121,0,5,1,6
"Carl Arvid Carlquist papers",uum_accn0928.xml,80444/xv17141,6,0,0,6
"R. Wayne Pace papers",uum_accn2242.xml,80444/xv97744,3,0,3,6
"University of Utah Department of Family and Community Medicine training programs records",uum_acc0347.xml,80444/xv30038,4,2,0,6
"Jack Paige photograph collection",uum_p0364.xml,80444/xv12515,3,3,0,6
"Univeristy of Utah Athletics Department records",uum_acc0543.xml,80444/xv16339,2,3,1,6
"Thomas A. Blakely papers",uum_accn0868.xml,80444/xv59344,0,0,6,6
"Alice Morrey Bailey papers",uum_accn1676.xml,80444/xv79809,0,6,0,6
"Stu and Greta O'Brien papers",uum_accn1920.xml,80444/xv40878,3,2,1,6
"Cwean scrapbooks",uum_acc0031.xml,80444/xv10787,2,1,3,6
"Johnny Townsend papers",uum_accn2677.xml,80444/xv34460,2,3,1,6
"Altrusa Club records",uum_accn2065.xml,80444/xv84429,4,2,0,6
"Will Bagley papers",uum_accn1937.xml,80444/xv22454,1,3,2,6
"Far West record",uum_accn1284.xml,80444/xv37869,0,2,4,6
"Milton Holmes Welling papers",uum_accn2302.xml,80444/xv78198,0,3,3,6
"Bert Estrada independent film collection",uum_a0769.xml,80444/xv72106,1,0,5,6
"Homer Richards and Katherine Romney Warner papers",uum_accn2564.xml,80444/xv67764,0,4,2,6
"Heber J. Grant letters",uum_ms0378.xml,80444/xv48767,0,2,4,6
"University of Utah Bureau of Community Development Advisory Council meeting minutes",uum_acc0106.xml,80444/xv42782,0,2,4,6
"Lila Eccles Brimhall memorial service audio collection",uum_a0316.xml,80444/xv33276,4,1,1,6
"Zadok Knapp Judd autobiography",uum_ms0063.xml,80444/xv75143,2,3,1,6
"Japanese American relocation photograph collection",uum_p0144.xml,80444/xv39089,5,1,0,6
"Isaac Jacobs correspondence",uum_accn2539.xml,80444/xv68640,6,0,0,6
"Donna D. Beesley papers",uum_accn2597.xml,80444/xv60223,3,0,3,6
"William E. McLellin papers",uum_accn1827.xml,80444/xv81396,0,0,6,6
"University of Utah Center for Historical Population Studies records",uum_acc0343.xml,80444/xv64749,4,2,0,6
"Lyman P. Hunter papers",uum_ms0374.xml,80444/xv44799,0,0,6,6
"Francis Asbury Hammond papers",uum_accn2279.xml,80444/xv40957,3,2,1,6
"University of Utah University self-evaluation reports",uum_acc0212.xml,80444/xv56985,0,1,5,6
"Dixon M. Woodbury papers",uum_accn1378.xml,80444/xv05706,2,4,0,6
"Mormon missionary in Wisconsin diary and letter",uum_accn2541.xml,80444/xv92245,0,0,6,6
"Porte Publishing Company records",uum_ms0182.xml,80444/xv12896,6,0,0,6
"University of Utah independent status controversy clipping file",uum_acc0066.xml,80444/xv08917,6,0,0,6
"Edward Sapir photograph collection",uum_p0171.xml,80444/xv58059,2,0,4,6
"University of Utah Associate Vice President for Academic Affairs records",uum_acc0506.xml,80444/xv10833,0,5,1,6
"Cecelia H. Foxley papers",uum_accn2784.xml,80444/xv13171,2,2,2,6
"O.C. Tanner Company video collection",uum_a0306.xml,80444/xv76196,0,4,2,6
"Tim Rathbone papers",uum_accn0218.xml,80444/xv50479,4,2,0,6
"Frances Farley photograph collection",uum_p0575.xml,80444/xv05361,4,1,1,6
"Brandy Blank river running video collection",uum_a0532.xml,80444/xv17016,0,2,4,6
"Charles Kingston letterpress book",uum_accn2590.xml,80444/xv46823,0,3,3,6
"Robert C. Anderton papers",uum_ms0217.xml,80444/xv74533,0,2,4,6
"David Breck Morris papers",uum_accn2205.xml,80444/xv90496,0,3,3,6
"Joseph Smith Jr. collection",uum_ms0386.xml,80444/xv98709,0,4,2,6
"Mary Jeanette Hartley Ware papers",uum_accn2233.xml,80444/xv09832,2,2,2,6
"Harold Bauman Papers",uum_accn2836.xml,80444/xv50988,5,0,1,6
"John L. Traughber papers",uum_ms0666.xml,80444/xv52984,0,4,2,6
"David McKenzie photograph collection",uum_p0116.xml,80444/xv07507,6,0,0,6
"Roald F. Campbell papers",uum_acc0391.xml,80444/xv14529,0,4,2,6
"David B. Freed papers",uum_accn2350.xml,80444/xv19125,0,2,4,6
"J. Willard Marriott Library records",uum_acc0500.xml,80444/xv86099,4,2,0,6
"Louisa Thalmann Hasler papers",uum_ms0018.xml,80444/xv04205,0,1,5,6
"Nathaniel Galloway papers",uum_accn1936.xml,80444/xv54467,1,2,3,6
"George William Ashton biography",uum_accn1598.xml,80444/xv76489,3,1,2,6
"Daughters of Utah Pioneers, Uintah County Chapter records",uum_ms0468.xml,80444/xv39123,2,2,2,6
"Jerome C. Stoffel collection",uum_ms0332.xml,80444/xv33752,3,3,0,6
"Daniel Brigham Hill Richards papers",uum_accn2046.xml,80444/xv41296,0,4,2,6
"Vesta W. James papers",uum_accn2095.xml,80444/xv99005,6,0,0,6
"University of Utah student records",uum_acc0016.xml,80444/xv49404,2,4,0,6
"Mansfield M. Snow photograph collection",uum_p0081.xml,80444/xv92364,6,0,0,6
"Russell Marion Nelson papers",uum_accn2458.xml,80444/xv08248,0,0,6,6
"James Reston, Jr. correspondence",uum_accn2674.xml,80444/xv70526,6,0,0,6
"Bishop's Store House record",uum_accn2700.xml,80444/xv50689,4,0,2,6
"Willis W. Ritter papers",uum_accn0930.xml,80444/xv83953,2,0,4,6
"Clark S. Knowlton papers",uum_accn0153.xml,80444/xv60351,3,0,3,6
"Volney King papers",uum_ms0638.xml,80444/xv08590,0,0,6,6
"James M. Aton papers",uum_accn2689.xml,80444/xv64117,2,2,2,6
"University of Utah Committee on Annuities and Salaries reports",uum_acc0100.xml,80444/xv94107,4,2,0,6
"Robert Wood Johnson Foundation Emergency Medical Project records",uum_acc0254.xml,80444/xv11462,5,1,0,6
"University of Utah Native American Studies Program Records",uum_acc0334.xml,80444/xv73339,0,3,3,6
"Wallace F. Bennett photograph collection",uum_p0017.xml,80444/xv52871,2,4,0,6
"Utah labor archive audio-visual collection",uum_a0199.xml,80444/xv41012,0,1,5,6
"Ward Jay Roylance papers",uum_accn1282.xml,80444/xv93652,0,6,0,6
"University of Utah Ethnic Minority Student Health Science Center records",uum_acc0460.xml,80444/xv75067,5,1,0,6
"University of Utah Honorary Degree Committee records",uum_acc0022.xml,80444/xv34820,5,1,0,6
"Utah State Historical Society photograph collection",uum_p0072.xml,80444/xv22802,4,0,2,6
"Emily Dow Partridge Smith Young papers",uum_ms0113.xml,80444/xv45251,0,3,3,6
"I. Owen Horsfall papers",uum_accn0279.xml,80444/xv51843,0,4,2,6
"University of Utah College of Engineering records",uum_acc0094.xml,80444/xv79312,0,6,0,6
"University of Utah Ethnic Studies Program records",uum_acc0503.xml,80444/xv75137,4,2,0,6
"George Henry Dern papers",uum_accn2008.xml,80444/xv64544,1,0,5,6
"Andrew H. Wardle diary",uum_accn2389.xml,80444/xv32980,6,0,0,6
"University of Utah College of Medicine Dean's Research Advisory Committee records",uum_acc0173.xml,80444/xv70983,5,1,0,6
"Kenneth Anderson Brady papers",uum_accn2418.xml,80444/xv07281,3,2,1,6
"University of Utah Flammability Research Center records",uum_acc0369.xml,80444/xv32962,0,2,4,6
"University of Utah Financial Vice President's Office records",uum_acc0273.xml,80444/xv01199,2,2,2,6
"Christian Johannesen diary",uum_accn0436.xml,80444/xv62469,1,4,1,6
"John S. Boyden photograph collection",uum_p0265.xml,80444/xv35696,3,1,2,6
"Blanche Kendall McKey papers",uum_ms0626.xml,80444/xv16033,5,0,0,5
"Marthinius A. Strand papers",uum_accn1392.xml,80444/xv94284,5,0,0,5
"Arthur L. Chaffin papers",uum_accn1638.xml,80444/xv65850,2,3,0,5
"J. Raymond Cope papers",uum_ms0596.xml,80444/xv49053,3,1,1,5
"John Hoagland photograph collection",uum_p0422.xml,80444/xv27316,0,3,2,5
"Dale E. Winn home movies",uum_a1139.xml,80444/xv19122,0,3,2,5
"Ernst F. Sturm papers",uum_accn1530.xml,80444/xv83746,2,1,2,5
"Reo Robbins photograph collection",uum_p0258.xml,80444/xv04067,3,0,2,5
"John Adams family papers",uum_accn1577.xml,80444/xv74505,0,4,1,5
"Welby, Utah photograph collection",uum_p0240.xml,80444/xv83175,1,2,2,5
"Salt Lake Theatre records",uum_ms0541.xml,80444/xv55145,1,3,1,5
"University of Utah College of Social and Behavioral Science records",uum_acc0533.xml,80444/xv09255,0,2,3,5
"Duward and Esther Campbell oral history interview",uum_ms0441.xml,80444/xv02938,1,1,3,5
"Maude Adams papers",uum_accn2615.xml,80444/xv09881,3,0,2,5
"Maude Smith Gorham scrapbooks",uum_accn1103.xml,80444/xv19494,0,2,3,5
"Ted Curtis Smythe papers",uum_accn2395.xml,80444/xv65469,4,1,0,5
"Brigham City (Arizona) settlement records",uum_ms0342.xml,80444/xv47021,5,0,0,5
"Young Women's Christian Association records",uum_ms0550.xml,80444/xv81127,5,0,0,5
"Mohammed Fikry Shihata Soliman Gahin papers",uum_accn1809.xml,80444/xv40332,3,2,0,5
"Ida Barker Blake diaries",uum_accn0962.xml,80444/xv28234,0,3,2,5
"Excavation of the Jarvie site report",uum_accn0810.xml,80444/xv03558,0,0,5,5
"Willard Dale Rees papers",uum_accn1775.xml,80444/xv29559,2,1,2,5
"Louis Marcus photograph collection",uum_p0047.xml,80444/xv55404,4,1,0,5
"Utah State Republican Central Committee records",uum_ms0174.xml,80444/xv12020,0,3,2,5
"Bob Marsh photograph collection",uum_p0411.xml,80444/xv62902,2,0,3,5
"Sydney W. and Mildred B. Angleman papers",uum_accn2049.xml,80444/xv42297,4,1,0,5
"Walter R. Jones papers",uum_accn1647.xml,80444/xv76766,1,1,3,5
"Capitol Reef National Park records",uum_accn1817.xml,80444/xv54766,2,3,0,5
"Malcolm O. Sillars papers",uum_accn1997.xml,80444/xv11187,2,0,3,5
"William M. Stewart School records",uum_acc0072.xml,80444/xv10675,4,1,0,5
"Alan E. Brockbank papers",uum_ms0604.xml,80444/xv58679,2,3,0,5
"Hancock Brothers Fruit Merchants records",uum_accn2534.xml,80444/xv21990,5,0,0,5
"Lorin A. and Laura Reese Merrill papers",uum_accn1016.xml,80444/xv10180,5,0,0,5
"Julia Farnsworth Lund Wassmer papers",uum_accn1599.xml,80444/xv50805,0,1,4,5
"S.S. Schweitzer papers",uum_accn2099.xml,80444/xv24707,0,0,5,5
"Maud May Lawson papers",uum_accn2341.xml,80444/xv96218,0,4,1,5
"Stephanie Young Merzel papers",uum_accn2227.xml,80444/xv50534,0,3,2,5
"University of Utah Campus Planning Advisory Committee correspondence and meeting minutes",uum_acc0107.xml,80444/xv93682,0,4,1,5
"University of Utah State College of Education records",uum_acc0370.xml,80444/xv76675,3,1,1,5
"University of Utah College of Medicine Department of Child Psychiatry records",uum_acc0471.xml,80444/xv12103,2,1,2,5
"Utah Women's Political Caucus records",uum_accn2433.xml,80444/xv89172,3,1,1,5
"Kearns Building collection",uum_ms0410.xml,80444/xv71640,0,2,3,5
"Stan Larson papers",uum_accn1111.xml,80444/xv40649,3,0,2,5
"Richard Bradley papers",uum_accn1658.xml,80444/xv91006,0,2,3,5
"Murdock family papers",uum_ms0613.xml,80444/xv31362,0,2,3,5
"Charles H. Bradford papers",uum_accn1837.xml,80444/xv27825,1,4,0,5
"Ian Hyde papers",uum_accn0268.xml,80444/xv45193,2,3,0,5
"University of Utah Graduate School of Social Work research grant records",uum_acc0446.xml,80444/xv15316,0,1,4,5
"Walter H. and Ann S. Huish photograph collection",uum_p0520.xml,80444/xv68142,0,4,1,5
"George Gordon Campbell papers",uum_accn0851.xml,80444/xv63430,4,0,1,5
"John Elliott Welsh papers",uum_accn1871.xml,80444/xv60089,0,5,0,5
"Alice Colton papers",uum_accn2483.xml,80444/xv27966,2,0,3,5
"John Franklin Tolton autobiography",uum_ms0007.xml,80444/xv35827,2,3,0,5
"LaVarr G. Webb papers",uum_ms0525.xml,80444/xv23397,0,4,1,5
"Joseph Fielding Smith photograph collection",uum_p0130.xml,80444/xv23379,4,1,0,5
"Agnes Just Reid papers",uum_ms0365.xml,80444/xv82369,1,1,3,5
"Joseph Wilson correspondence",uum_accn2798.xml,80444/xv83941,5,0,0,5
"Thomas Jefferson O'Brien journals",uum_accn0135.xml,80444/xv08813,1,0,4,5
"Marion Moore Fidlar papers",uum_accn0123.xml,80444/xv78158,3,2,0,5
"Sandra C. Taylor papers",uum_accn1808.xml,80444/xv33221,3,2,0,5
"Utah mining district maps collection",uum_accn1043.xml,80444/xv05651,5,0,0,5
"Vernon Wallace Larsen papers",uum_accn2309.xml,80444/xv31622,0,2,3,5
"Henry W. Lawrence papers",uum_ms0309.xml,80444/xv96231,2,3,0,5
"Millard F. Malin papers",uum_ms0177.xml,80444/xv40133,2,0,3,5
"University of Utah Administrative Vice President's Office and Financial Vice President's Office records",uum_acc0333.xml,80444/xv28662,0,1,4,5
"Aurora Club records",uum_ms0569.xml,80444/xv65313,0,1,4,5
"Ronald L. Holt papers",uum_ms0657.xml,80444/xv82894,2,2,1,5
"University of Utah College of Engineering records",uum_acc0357.xml,80444/xv97161,3,2,0,5
"JD Mortensen autobiography",uum_accn2565.xml,80444/xv77221,3,0,2,5
"Nicholas Groesbeck Smith, Jr. autobiography",uum_accn2081.xml,80444/xv41076,0,0,5,5
"ARPANET training video",uum_a0020.xml,80444/xv88165,2,0,3,5
"University of Utah Deputy Administrative Vice President for Planning and Construction records",uum_acc0237.xml,80444/xv45108,2,1,2,5
"Richards Durham papers",uum_accn1382.xml,80444/xv09259,4,1,0,5
"Jeanne Tellier Leeson papers",uum_accn1835.xml,80444/xv14663,0,0,5,5
"University of Utah Institutional Council meeting minutes",uum_acc0020.xml,80444/xv05081,1,4,0,5
"Joseph E. Ray papers",uum_ms0194.xml,80444/xv98532,5,0,0,5
"Nelson Paul Beebe autobiography",uum_ms0253.xml,80444/xv25714,2,2,1,5
"Paul B. Cannon papers",uum_accn1086.xml,80444/xv49896,3,2,0,5
"Madsen Furniture Company records",uum_accn1803.xml,80444/xv10406,2,1,2,5
"Vivian Dorothy Peterman Lovell papers",uum_accn1987.xml,80444/xv78356,1,2,2,5
"University of Utah Board of Trustees meeting minutes and trustee files",uum_acc0546.xml,80444/xv12362,0,5,0,5
"Suzy Harris Rytting photograph collection",uum_p0412.xml,80444/xv60983,0,1,4,5
"Pearl Jacobson photograph collection",uum_p0111.xml,80444/xv60720,5,0,0,5
"Adelia Almira Wilcox Hatton Woods Kimball papers",uum_accn2234.xml,80444/xv36068,0,3,2,5
"Charles H. Monson photograph collection",uum_p0546.xml,80444/xv21304,2,1,2,5
"Ina Claire Wallace papers",uum_accn2025.xml,80444/xv52416,3,1,1,5
"University of Utah Museum of Natural History records",uum_accn1191.xml,80444/xv51486,0,2,3,5
"William Williams Henderson papers",uum_ms0533.xml,80444/xv49884,3,0,2,5
"Beatrice Sells Deitrick Huesman papers",uum_accn2453.xml,80444/xv15417,0,0,5,5
"University of Utah Professors Emeriti Club records",uum_acc0044.xml,80444/xv13406,1,0,4,5
"John Boylston Fairbanks diary",uum_ms0681.xml,80444/xv21493,0,1,4,5
"David E. Miller papers",uum_accn0891.xml,80444/xv58551,3,0,2,5
"Lyman Wight papers",uum_ms0409.xml,80444/xv15948,2,3,0,5
"Seth Hubbard independent film collection",uum_a0796.xml,80444/xv29446,0,2,3,5
"Apex mine legal exhibits",uum_accn1533.xml,80444/xv81158,3,1,1,5
"University of Utah Department of Budget and Resource Planning grade distribution by class level, 1969-1977",uum_acc0340.xml,80444/xv69641,0,2,3,5
"C. Lowell and Georgiana T. Lees papers",uum_accn0538.xml,80444/xv94134,2,2,1,5
"John Andreas Widtsoe papers",uum_accn1562.xml,80444/xv34600,0,0,5,5
"Eugene Hilton papers",uum_accn1257.xml,80444/xv20901,0,2,3,5
"Nelson Wheeler Whipple papers",uum_accn2123.xml,80444/xv94482,5,0,0,5
"Ririe-Woodbury Dance Company records",uum_accn0709.xml,80444/xv87054,1,1,3,5
"Naomi Hoffmann papers",uum_accn0284.xml,80444/xv46243,5,0,0,5
"Harold Robins manuscript",uum_accn1353.xml,80444/xv03656,1,1,3,5
"Portrait photograph collection",uum_p0190.xml,80444/xv49734,5,0,0,5
"<title render="italic">Kick Like a Girl</title> motion picture",uum_a1120.xml,80444/xv10992,0,0,5,5
"George J. Janecek papers",uum_accn1807.xml,80444/xv71905,1,2,2,5
"Mormon Tabernacle Choir photograph collection",uum_p0583.xml,80444/xv95922,0,1,4,5
"Davis County Flood photograph collection",uum_p0361.xml,80444/xv70999,0,0,5,5
"Italian-American Civic League records",uum_accn2751.xml,80444/xv28372,3,0,2,5
"John L. Cross papers",uum_accn2030.xml,80444/xv70864,1,4,0,5
"Ezra Taft Benson speeches",uum_ms0382.xml,80444/xv59970,2,2,1,5
"Richard J. Bird papers",uum_ms0610.xml,80444/xv21691,4,0,1,5
"Alton F. Richards papers",uum_accn1632.xml,80444/xv07751,0,1,4,5
"Hampton C. Godbe photograph collection",uum_p0113.xml,80444/xv74810,3,0,2,5
"Women's Ski Jumping USA records",uum_accn2679.xml,80444/xv42633,0,0,5,5
"Utah Academic Library Consortium records",uum_accn1820.xml,80444/xv56057,0,3,2,5
"William R. and Erlyn Gould Distinguished Lecture on Technology and the Quality of Life Series records",uum_accn2780.xml,80444/xv70809,5,0,0,5
"Barbara Jean Erickson Andersen papers",uum_accn2386.xml,80444/xv35900,1,3,1,5
"Alma Lamoni Smith diary",uum_accn1604.xml,80444/xv07803,0,5,0,5
"Trudy McMurrin papers",uum_accn2672.xml,80444/xv29437,4,0,1,5
"Whiterocks trading post records",uum_accn0887.xml,80444/xv40936,3,0,2,5
"Elliott D. Landau papers",uum_acc0367.xml,80444/xv75656,1,3,1,5
"Ann S. Jarrell papers",uum_accn0904.xml,80444/xv79595,2,1,2,5
"Raye Carleson Ringholz papers",uum_accn1812.xml,80444/xv53424,1,4,0,5
"Sidney S. Fox papers",uum_ms0559.xml,80444/xv50558,2,0,3,5
"Timp Haven Ski Area collection",uum_accn1102.xml,80444/xv56628,5,0,0,5
"Garden Club of Cottonwood records",uum_ms0454.xml,80444/xv59317,3,0,2,5
"Steven E. Jones papers",uum_accn1359.xml,80444/xv93563,3,0,2,5
"Lex Hemphill papers",uum_accn2252.xml,80444/xv89505,0,3,2,5
"Aaron Belnap Ross papers",uum_accn1714.xml,80444/xv98178,0,2,3,5
"Jack Wilson Carlson papers",uum_accn1828.xml,80444/xv17431,0,3,2,5
"Mary Young Burton family papers",uum_accn0765.xml,80444/xv16213,5,0,0,5
"Francis Nephi Grigg papers",uum_accn1753.xml,80444/xv93820,3,0,2,5
"Alison R. Pikus papers",uum_accn2101.xml,80444/xv93157,0,0,5,5
"Doyce Blackman Nunis papers",uum_accn1980.xml,80444/xv80581,3,0,2,5
"Biography of David Osborn, senior",uum_ms0171.xml,80444/xv72903,5,0,0,5
"Fred Douglas Duehlmeier papers",uum_accn1748.xml,80444/xv10260,5,0,0,5
"University of Utah College of Letters and Science department heads meeting minutes",uum_acc0146.xml,80444/xv34494,2,1,2,5
"Maurine Dewsnup papers",uum_accn1143.xml,80444/xv36962,5,0,0,5
"Lincoln Mining Company records",uum_accn1386.xml,80444/xv28851,5,0,0,5
"Dale R. Broadhurst audio collection",uum_a0315.xml,80444/xv22711,1,2,2,5
"Herm Hoops papers",uum_accn2673.xml,80444/xv28811,1,2,2,5
"University of Utah Department of Anthropology audio collection",uum_a1085.xml,80444/xv96542,4,0,1,5
"Vontella Hess Buchholz Kimball papers",uum_ms0264.xml,80444/xv77102,1,1,3,5
"Dugway Proving Ground reports",uum_accn2504.xml,80444/xv39648,2,2,1,5
"Associated Utah Artists records",uum_ms0262.xml,80444/xv29473,1,3,1,5
"Emma Elizabeth Lindsey Thomas papers",uum_ms0594.xml,80444/xv44415,1,3,1,5
"University of Utah Scholarship Awards and Student Loan Committee records",uum_acc0125.xml,80444/xv70819,0,5,0,5
"Francis Dunham Wormuth papers",uum_accn1321.xml,80444/xv78289,1,2,2,5
"Abraham Owen Smoot papers",uum_accn1556.xml,80444/xv60375,3,0,2,5
"Karen Huntoon Miller papers",uum_accn1921.xml,80444/xv10903,0,5,0,5
"University of Utah Institutional Studies Office statistical reports",uum_acc0375.xml,80444/xv75918,0,1,4,5
"Ola Nilsson Liljenquist papers",uum_accn1967.xml,80444/xv21276,4,1,0,5
"Pamela Call Johnson family papers",uum_accn2763.xml,80444/xv62631,5,0,0,5
"Joseph H. Peck papers",uum_ms0231.xml,80444/xv96142,3,2,0,5
"Blacks in Utah photograph collection",uum_p0160.xml,80444/xv03314,4,1,0,5
"University of Utah Medical Center Volunteer Auxiliary records",uum_acc0501.xml,80444/xv27960,0,5,0,5
"Leland Karr and Ada C. Irvine papers",uum_accn1892.xml,80444/xv25909,5,0,0,5
"Ralph Taylor Richards photograph collection",uum_p0091.xml,80444/xv79995,4,0,1,5
"August H. Mihsfeldt papers",uum_accn2347.xml,80444/xv35430,5,0,0,5
"Frank Everett Steele correspondence",uum_accn2508.xml,80444/xv28445,1,1,3,5
"University of Utah Graduate School memoranda and student lists",uum_acc0178.xml,80444/xv30722,2,1,2,5
"Grand Canyon management plan collection",uum_accn1307.xml,80444/xv13589,0,1,4,5
"Sterling M. McMurrin papers",uum_acc0205.xml,80444/xv04040,0,4,1,5
"E. Kay Kirkham papers",uum_accn1906.xml,80444/xv44296,3,0,2,5
"Theater program and clipping collection",uum_accn1051.xml,80444/xv89440,0,2,3,5
"Dialogue Foundation records",uum_accn0385.xml,80444/xv71176,2,3,0,5
"Lyman P. Hunter photograph collection",uum_p0006.xml,80444/xv81384,5,0,0,5
"Arch Leonard Madsen photograph collection",uum_p0501.xml,80444/xv34909,1,2,2,5
"Knight Belnap Kerr papers",uum_accn1117.xml,80444/xv25787,5,0,0,5
"Kirk Alan Watson papers",uum_accn2124.xml,80444/xv51425,4,1,0,5
"Percy Livingstone Myer papers",uum_accn0084.xml,80444/xv72503,3,1,1,5
"Alden J. Bennett and Joseph H. Harper papers",uum_accn2885.xml,80444/xv24423,4,1,0,5
"Shelby Holladay papers",uum_accn2230.xml,80444/xv22393,5,0,0,5
"Henry Y. Kasai photograph collection",uum_p0149.xml,80444/xv96697,1,0,4,5
"Montana Uinta Hydrocarbon Company records",uum_accn0922.xml,80444/xv20306,0,0,5,5
"Zola Rice Pound papers",uum_accn2779.xml,80444/xv63082,0,0,5,5
"10th Mountain Division Association records",uum_accn1070.xml,80444/xv65304,0,0,5,5
"Cochranism collection",uum_ms0470.xml,80444/xv07736,2,2,1,5
"Salt Lake City Women's Civic Center records",uum_accn2098.xml,80444/xv92062,0,0,5,5
"Zettie M. Nebeker Kearl letter",uum_accn1003.xml,80444/xv10671,2,3,0,5
"Kenneth Bitner Castleton papers",uum_accn0121.xml,80444/xv01690,2,2,1,5
"Orland L. Tapp scrapbooks",uum_accn2451.xml,80444/xv25863,3,0,2,5
"Eldon J. Gardner papers",uum_ms0478.xml,80444/xv13034,0,2,3,5
"Butte and Superior Copper Company check register",uum_accn1537.xml,80444/xv53182,0,0,5,5
"Little May Mining Company records",uum_accn0762.xml,80444/xv30599,1,0,4,5
"University of Utah College of Letters and Science Associate Dean of the College of Letters and Science correspondence and memoranda",uum_acc0182.xml,80444/xv31936,0,2,3,5
"University of Utah College of Fine Arts records",uum_acc0478.xml,80444/xv83166,0,2,3,5
"University of Utah Administrative Vice President's Office Staff specialist records",uum_acc0220.xml,80444/xv84115,2,2,1,5
"Beaver Mountain ski area photograph collection",uum_p0381.xml,80444/xv89849,4,0,1,5
"Ken Sleight papers",uum_accn2392.xml,80444/xv25140,0,2,3,5
"Charles H. Andrus papers",uum_accn1366.xml,80444/xv54803,2,0,3,5
"Russell Lees papers",uum_accn1622.xml,80444/xv44223,1,2,2,5
"William Henry Jackson photograph collection",uum_p0329.xml,80444/xv61117,2,0,3,5
"Katharine Hogle Cole papers",uum_accn1720.xml,80444/xv96905,0,3,2,5
"Howard Caswell Jones autobiography",uum_accn2582.xml,80444/xv76568,2,0,3,5
"University of Utah Division of Continuing Education records",uum_acc0534.xml,80444/xv80938,2,3,0,5
"Journal history of the Church of Jesus Christ of Latter-day Saints",uum_accn1146.xml,80444/xv49725,0,0,5,5
"Sheepherding photograph collection",uum_p0069.xml,80444/xv47711,5,0,0,5
"University of Deseret Museum register and miscellaneous articles inventory",uum_acc0038.xml,80444/xv65722,3,1,1,5
"John Reese biography",uum_ms0475.xml,80444/xv97753,0,3,2,5
"George J. Taylor papers",uum_accn1454.xml,80444/xv38555,1,3,1,5
"Elijah Averett journal",uum_accn0359.xml,80444/xv03161,5,0,0,5
"Clarence Barrows papers",uum_accn2480.xml,80444/xv63247,0,1,4,5
"B. Floyd Farr papers",uum_accn0934.xml,80444/xv93365,1,2,2,5
"Irene M. Bates papers",uum_accn1875.xml,80444/xv80978,0,1,4,5
"Mary Elizabeth Rollins Lightner biography",uum_ms0589.xml,80444/xv07373,2,2,1,5
"University of Utah Physical Plant and Equipment Control Cabinet meeting minutes",uum_acc0006.xml,80444/xv71008,0,0,5,5
"Louis Marcus papers",uum_accn0788.xml,80444/xv09915,4,1,0,5
"Saint Mark's Hospital records",uum_accn1789.xml,80444/xv91213,0,0,5,5
"University of Utah Ethnic Studies Office records",uum_acc0362.xml,80444/xv94293,0,2,3,5
"Tom Korologos papers",uum_accn1565.xml,80444/xv68914,0,4,1,5
"Karen Korfanta photograph collection",uum_p0415.xml,80444/xv53952,2,0,2,4
"Harry L. A. Culmer photograph collection",uum_p0157.xml,80444/xv43814,0,2,2,4
"Ariel L. Crowley papers",uum_ms0072.xml,80444/xv87997,0,0,4,4
"University of Utah College of Science records",uum_acc0351.xml,80444/xv96630,0,4,0,4
"Charles Cather letter",uum_ms0356.xml,80444/xv48678,0,2,2,4
"University of Utah Vice President for Research Office Research policy development records",uum_acc0252.xml,80444/xv16558,0,2,2,4
"Marriner Wood Merrill papers",uum_accn0958.xml,80444/xv93252,3,0,1,4
"Don Willie papers",uum_accn2740.xml,80444/xv83666,1,3,0,4
"University of Utah Faculty meeting minutes",uum_acc0007.xml,80444/xv14962,0,4,0,4
"Ruth Gilchrist Bracy papers",uum_accn2741.xml,80444/xv58786,3,1,0,4
"Fish and Game scrapbook",uum_accn2561.xml,80444/xv39254,2,1,1,4
"University of Utah Academic Evaluation and Standards Committee meeting minutes",uum_acc0098.xml,80444/xv94570,0,2,2,4
"Caledonia Club ledger",uum_accn0082.xml,80444/xv80569,4,0,0,4
"University of Utah Marriott Library committee reports and meeting minutes",uum_acc0115.xml,80444/xv31063,1,3,0,4
"Central Christian Church newsletters",uum_accn1524.xml,80444/xv05950,4,0,0,4
"H. Wayne Driggs script",uum_ms0407.xml,80444/xv34796,4,0,0,4
"Diary of Salt Lake City",uum_accn1895.xml,80444/xv15286,0,4,0,4
"Madge Harris Tuckett papers",uum_ms0458.xml,80444/xv31597,4,0,0,4
"Minutes of the school of the prophets held in Parowan",uum_accn0578.xml,80444/xv99215,3,0,1,4
"Herbert S. Auerbach papers",uum_accn2567.xml,80444/xv02386,0,2,2,4
"James Henry Linford Jr. papers",uum_accn2344.xml,80444/xv07839,4,0,0,4
"Daniel MacGregor papers",uum_accn2362.xml,80444/xv65036,1,3,0,4
"Floyd E. Risvold papers",uum_ms0539.xml,80444/xv34393,0,0,4,4
"Rees family history",uum_accn1101.xml,80444/xv06307,1,0,3,4
"Chip Ward papers",uum_accn2303.xml,80444/xv73364,1,1,2,4
"Wanda Clayton Thomas papers",uum_ms0298.xml,80444/xv39862,2,2,0,4
"Edward W. Clyde papers",uum_accn1335.xml,80444/xv14602,2,2,0,4
"Kadsuo and Riu Hata Nishijima papers",uum_accn2399.xml,80444/xv45562,0,0,4,4
"Bruce A. Van Orden papers",uum_accn1388.xml,80444/xv89169,2,0,2,4
"Ernest L. Wilkinson diaries",uum_ms0629.xml,80444/xv23995,1,3,0,4
"Jean C. Thatcher family papers",uum_accn2291.xml,80444/xv87057,4,0,0,4
"Nauvoo City Council records",uum_accn1474.xml,80444/xv32415,0,0,4,4
"John R. Park presidential records",uum_acc0001.xml,80444/xv09808,2,1,1,4
"Pioneer Theater Guild photograph collection",uum_p0286.xml,80444/xv64505,2,2,0,4
"University of Utah faculty and university regulations",uum_acc0325.xml,80444/xv49533,0,1,3,4
"University of Utah Office of Budget and Resource Planning records",uum_acc0512.xml,80444/xv80020,0,1,3,4
"Stanley Murdock slide collection",uum_p0052.xml,80444/xv38034,3,0,1,4
"Theodore Ward papers",uum_ms0394.xml,80444/xv99612,0,3,1,4
"University of Utah Student Affairs and Services Office records",uum_acc0382.xml,80444/xv04293,0,4,0,4
"International Women's Year records",uum_ms0236.xml,80444/xv98431,0,4,0,4
"Superfund Records Center records",uum_accn2107.xml,80444/xv19958,0,0,4,4
"Allen Quentin Howard papers",uum_accn2329.xml,80444/xv42520,1,3,0,4
"Albert S. Hansen papers",uum_accn1843.xml,80444/xv33261,2,0,2,4
"Mrs. William O. Erickson lantern slide collection",uum_p0053.xml,80444/xv35757,3,1,0,4
"Stephen G. Boyden papers",uum_accn1042.xml,80444/xv25891,0,3,1,4
"Vern Openshaw papers",uum_accn2268.xml,80444/xv14270,2,0,2,4
"Norman Paulsen papers",uum_accn2148.xml,80444/xv13967,3,1,0,4
"Gordon Alcott photograph collection",uum_p0403.xml,80444/xv00939,1,0,3,4
"University of Utah Committee on Student Affairs meeting minutes",uum_acc0011.xml,80444/xv76333,0,4,0,4
"University of Utah Department of Biology records",uum_acc0316.xml,80444/xv45690,2,2,0,4
"Anna Elizabeth Rupper Grames papers",uum_accn2443.xml,80444/xv84600,3,0,1,4
"Armand J. Eardley papers",uum_acc0380.xml,80444/xv40121,3,1,0,4
"Indian archives",uum_ms0109.xml,80444/xv61114,1,2,1,4
"Bonnie Speyer Carluccio papers",uum_accn1469.xml,80444/xv83193,3,1,0,4
"Colorado riverbed case records",uum_accn1702.xml,80444/xv17147,4,0,0,4
"Utah skiing collection",uum_accn1080.xml,80444/xv57000,0,1,3,4
"<title render="italic">Frontiers</title> motion picture",uum_a0440.xml,80444/xv27069,1,1,2,4
"John W. Taylor family photograph collection",uum_p0050.xml,80444/xv86795,2,0,2,4
"Thomas Evans Jeremy papers",uum_ms0315.xml,80444/xv86932,3,1,0,4
"Max Nolan papers",uum_accn2503.xml,80444/xv70025,0,2,2,4
"Lester E. Bush papers",uum_ms0685.xml,80444/xv01861,0,1,3,4
"Rudolf Stockseth diary",uum_accn2411.xml,80444/xv20770,4,0,0,4
"Parley P. Pratt papers",uum_ms0014.xml,80444/xv74804,1,3,0,4
"University of Utah Admissions Office records",uum_acc0014.xml,80444/xv68103,0,2,2,4
"Carl Madsen Bradt papers",uum_accn1863.xml,80444/xv78070,2,0,2,4
"Wesley Parkinson Lloyd diaries",uum_accn1338.xml,80444/xv90609,3,1,0,4
"Stewart Van Vliet papers",uum_accn0679.xml,80444/xv74316,2,0,2,4
"Lorille Horne Miller papers",uum_accn1279.xml,80444/xv64614,4,0,0,4
"Norma W. Matheson photograph collection",uum_p0259.xml,80444/xv53454,0,2,2,4
"Pat Denner artwork",uum_accn2818.xml,80444/xv49176,1,0,3,4
"Mary Risser Gallacher papers",uum_accn2103.xml,80444/xv54022,2,2,0,4
"Lauretta L. Kidman photograph collection",uum_p0051.xml,80444/xv56188,3,1,0,4
"University of Utah Administrative Council meeting minutes",uum_acc0008.xml,80444/xv26843,0,4,0,4
"Seeholzer family papers",uum_accn1305.xml,80444/xv67468,4,0,0,4
"John W. Summerhays papers",uum_accn0845.xml,80444/xv08517,4,0,0,4
"White Mountain Apache Indian Reservation map",uum_accn2517.xml,80444/xv42129,0,1,3,4
"C.R. Savage photograph collection",uum_p0365.xml,80444/xv64389,3,0,1,4
"Charles Nettleton appointment certificate",uum_accn0258.xml,80444/xv58361,1,0,3,4
"Francis Vinton Greene papers",uum_ms0133.xml,80444/xv22335,0,1,3,4
"Larry Cappetto independent film collection",uum_a0803.xml,80444/xv89929,0,2,2,4
"Tsutomu and Shirley Sugimoto Inouye papers",uum_accn2354.xml,80444/xv44018,1,2,1,4
"Homer Abstract Company records",uum_accn0181.xml,80444/xv91012,4,0,0,4
"Marjorie Madsen Riley papers",uum_accn2417.xml,80444/xv01666,2,0,2,4
"Curtis Oberhansly collection",uum_accn1992.xml,80444/xv42984,2,2,0,4
"Michele Parish papers",uum_accn1348.xml,80444/xv99157,0,2,2,4
"Carolyn Hunsaker papers",uum_accn1248.xml,80444/xv16326,1,3,0,4
"Jesse S. Hoy manuscript",uum_ms0011.xml,80444/xv93487,4,0,0,4
"Marian Robertson Wilson papers",uum_accn0202.xml,80444/xv11093,1,1,2,4
"Marie Barker Nelson papers",uum_accn1664.xml,80444/xv55294,1,0,3,4
"Melvin Henry Fletcher papers",uum_accn2033.xml,80444/xv88232,1,3,0,4
"Emery G. Epperson papers",uum_accn2261.xml,80444/xv97723,1,3,0,4
"University of Utah College of Medicine student biographies",uum_acc0253.xml,80444/xv00460,0,2,2,4
"Randolph, Utah photograph collection",uum_p0015.xml,80444/xv07946,2,2,0,4
"Claud O. and Katherine Tanner Carter papers",uum_accn2010.xml,80444/xv65612,0,2,2,4
"Wilford Ence photograph collection",uum_p0119.xml,80444/xv19223,4,0,0,4
"Robert L. Springmeyer papers",uum_accn1816.xml,80444/xv97039,0,0,4,4
"Sunstone Foundation photograph collection",uum_p0307.xml,80444/xv90615,3,0,1,4
"Park West Ski Area photograph collection",uum_p0382.xml,80444/xv61813,0,3,1,4
"KUED-TV records",uum_acc0374.xml,80444/xv35128,3,1,0,4
"University of Utah Business Services Office records",uum_acc0290.xml,80444/xv51895,2,1,1,4
"American Civil Liberties Union (ACLU) of Utah records",uum_ms0650.xml,80444/xv94485,2,1,1,4
"James G. Rossiter papers",uum_accn2369.xml,80444/xv02438,1,0,3,4
"Edna Clark Ericksen papers",uum_ms0617.xml,80444/xv15042,0,0,4,4
"University of Utah Union Board meeting minutes",uum_acc0129.xml,80444/xv23489,0,1,3,4
"John Smith autobiography",uum_accn1567.xml,80444/xv78234,4,0,0,4
"Margaret R. Draper papers",uum_accn2879.xml,80444/xv05462,0,3,1,4
"June Rose Harwood papers",uum_ms0543.xml,80444/xv89630,0,3,1,4
"Geraldine Palmer-Jones papers",uum_accn2650.xml,80444/xv61883,2,0,2,4
"University of Utah Associate Vice President for Academic Affairs records",uum_acc0456.xml,80444/xv37362,1,3,0,4
"Dolores Chase papers",uum_accn2943.xml,80444/xv16162,4,0,0,4
"Roy and Wuta Terazawa Tsuya papers",uum_accn2826.xml,80444/xv90542,2,0,2,4
"Robert Gordon Larsen papers",uum_accn0999.xml,80444/xv36782,0,4,0,4
"David S. King papers",uum_ms0033.xml,80444/xv26095,4,0,0,4
"Ellen Gustava Stark Pack papers",uum_accn1954.xml,80444/xv42892,3,0,1,4
"Ewald Kipp papers",uum_accn0777.xml,80444/xv63378,2,0,2,4
"David H. Bailey papers",uum_accn1823.xml,80444/xv66650,0,0,4,4
"William Henry King papers",uum_accn2243.xml,80444/xv97698,0,0,4,4
"Victory Theatre sheet music collection",uum_accn2036.xml,80444/xv74417,4,0,0,4
"University of Utah Department of Materials Science and Engineering records",uum_acc0448.xml,80444/xv50103,0,1,3,4
"Edward Lloyd Parry papers",uum_ms0368.xml,80444/xv73767,2,2,0,4
"University of Utah College of Law records",uum_acc0242.xml,80444/xv88732,1,3,0,4
"Jack H. Walker collection",uum_accn1219.xml,80444/xv14114,4,0,0,4
"David Eccles Quinney papers",uum_accn1772.xml,80444/xv40982,0,0,4,4
"Leo R. Newfarmer papers",uum_accn2387.xml,80444/xv46667,0,2,2,4
"Doug McLaren papers",uum_accn2397.xml,80444/xv68249,0,3,1,4
"R. Paul Cracroft papers",uum_accn2040.xml,80444/xv29486,1,0,3,4
"Louis E. Viko photograph collection",uum_p0478.xml,80444/xv19927,4,0,0,4
"Virginia City General Store records",uum_accn0305.xml,80444/xv45785,0,3,1,4
"Alberta Henry papers",uum_accn2069.xml,80444/xv88217,0,1,3,4
"Sara Barnard Johnston papers",uum_accn1686.xml,80444/xv32449,3,1,0,4
"University of Utah Admissions Office records",uum_acc0026.xml,80444/xv59930,3,1,0,4
"University of Utah College of Medicine committees records",uum_acc0293.xml,80444/xv64144,1,2,1,4
"H.W. Bailey photogaph collection",uum_p0023.xml,80444/xv39318,0,4,0,4
"Wilford Woodruff papers",uum_ms0373.xml,80444/xv70935,0,4,0,4
"State Capitol Competition collection",uum_accn1959.xml,80444/xv78887,3,1,0,4
"Ianthus Leo Richards papers",uum_accn1554.xml,80444/xv65063,2,0,2,4
"Utah Westerners records",uum_accn0370.xml,80444/xv52920,3,0,1,4
"Elmore LeRoy photograph collection",uum_p0089.xml,80444/xv42544,4,0,0,4
"Darin Tinney independent film collection",uum_a0772.xml,80444/xv81665,0,3,1,4
"Erich Robert Paul papers",uum_accn1660.xml,80444/xv01422,0,2,2,4
"Richard S. Van Wagoner papers",uum_ms0597.xml,80444/xv75140,1,3,0,4
"Hill Air Force Base collection",uum_accn1615.xml,80444/xv85446,1,0,3,4
"Lyn Richard Jacobs papers",uum_accn2041.xml,80444/xv32998,0,1,3,4
"Jack London manuscript (photocopy)",uum_accn2515.xml,80444/xv85708,2,2,0,4
"Q. Michael Croft papers",uum_accn0918.xml,80444/xv10583,4,0,0,4
"Norma W. Matheson papers",uum_accn0849.xml,80444/xv69143,3,0,1,4
"Calvin Bicknell letter",uum_accn2516.xml,80444/xv16204,4,0,0,4
"Marion Burrows Smith papers",uum_accn2077.xml,80444/xv78573,0,2,2,4
"Ralph Elliott Margetts photograph collection",uum_p0356.xml,80444/xv19781,0,0,4,4
"Taxpayers for Utah records",uum_ms0551.xml,80444/xv06069,4,0,0,4
"Joseph Jenson papers",uum_accn0671.xml,80444/xv16409,0,4,0,4
"Karl C. Sandberg papers",uum_accn2021.xml,80444/xv27603,1,3,0,4
"David J. Buerger photograph collection",uum_p0466.xml,80444/xv98770,3,0,1,4
"Dean L. May papers",uum_ms0422.xml,80444/xv18515,1,0,3,4
"G. Vernon McCracken papers",uum_accn2088.xml,80444/xv29028,4,0,0,4
"Cornelius Cole papers",uum_accn2273.xml,80444/xv61981,0,1,3,4
"William Ajax papers",uum_ms0064.xml,80444/xv36108,4,0,0,4
"Washoe County Title Guaranty Company records",uum_accn2222.xml,80444/xv58761,0,0,4,4
"Ivor D. Sharp scrapbooks",uum_ms0616.xml,80444/xv17962,1,0,3,4
"Phyllis Baker Van Wagenen correspondence",uum_accn2683.xml,80444/xv01547,1,3,0,4
"Channing Lowe independent film collection",uum_a0794.xml,80444/xv77725,0,1,3,4
"William M. Stewart School Reunion Committee records",uum_acc0390.xml,80444/xv36148,0,2,2,4
"Ralph J. Hafen papers",uum_accn2019.xml,80444/xv04418,4,0,0,4
"Mary Haskin Parker Richards diary",uum_ms0051.xml,80444/xv12036,0,0,4,4
"Emigration Canyon Community Council records",uum_accn2501.xml,80444/xv03524,0,0,4,4
"David R. Trevithick essay",uum_accn0539.xml,80444/xv82989,4,0,0,4
"Art Barn photograph collection",uum_p0096.xml,80444/xv59475,1,0,3,4
"Steven T. Baird papers",uum_accn2119.xml,80444/xv72286,4,0,0,4
"Glenn Walker Wallace papers",uum_accn1141.xml,80444/xv91763,0,2,2,4
"Mormom Women's Forum records",uum_accn2789.xml,80444/xv64328,0,0,4,4
"Flora Stewart Bennion photograph collection",uum_p0456.xml,80444/xv73812,1,3,0,4
"John E. McKendrick papers",uum_accn2448.xml,80444/xv26364,3,1,0,4
"Joseph Slater promissory notes",uum_accn2695.xml,80444/xv14898,4,0,0,4
"Dr. Charles James Nabors, Jr. photograph collection",uum_p0508.xml,80444/xv60379,0,3,1,4
"Robert Hyde Wilson photograph collection",uum_p0336.xml,80444/xv27673,1,0,3,4
"Ardean W. Watts papers",uum_acc0283.xml,80444/xv55850,0,4,0,4
"University of Utah Marriott Library Staff Council records",uum_acc0301.xml,80444/xv71878,1,1,2,4
"Ralph D. and Ruth Thomson papers",uum_accn0091.xml,80444/xv44543,4,0,0,4
"Karen Marguerite Moloney papers",uum_accn2180.xml,80444/xv23791,0,3,1,4
"Herb and Patsy Jepko certificates",uum_accn2649.xml,80444/xv52023,0,0,4,4
"Gordon and Peg Alcott papers",uum_accn1134.xml,80444/xv63998,0,3,1,4
"University of Utah President's Office Cabinet meeting minutes and agendas",uum_acc0040.xml,80444/xv98873,1,0,3,4
"University of Utah Administrative Vice President's Office records",uum_acc0336.xml,80444/xv53884,2,2,0,4
"Grant H. Palmer papers",uum_accn2071.xml,80444/xv28936,0,3,1,4
"George Thomas presidential records",uum_acc0017.xml,80444/xv76013,0,4,0,4
"James Starley journal",uum_ms0091.xml,80444/xv93099,3,0,1,4
"David Pierpont Gardner audio-visual collection",uum_a0024.xml,80444/xv97335,1,2,1,4
"Harold Herbert Leich papers",uum_accn1973.xml,80444/xv51062,2,0,2,4
"Grant Johannesen papers",uum_accn2199.xml,80444/xv71520,1,2,1,4
"University of Utah Olympic planning records",uum_accn2004.xml,80444/xv85421,0,2,2,4
"Judy Dykman papers",uum_accn2028.xml,80444/xv43307,1,1,2,4
"Keith Maurice Engar papers",uum_ms0677.xml,80444/xv41751,1,0,3,4
"Emil B. Fetzer papers",uum_accn2575.xml,80444/xv98797,0,2,2,4
"Eloise Randall photograph collection",uum_p0300.xml,80444/xv60345,0,0,4,4
"University of Utah College of Medicine records",uum_acc0228.xml,80444/xv18109,0,1,3,4
"KUER Radio records",uum_accn2009.xml,80444/xv24240,4,0,0,4
"Dorothy Shepherd Van Stipriaan papers",uum_ms0281.xml,80444/xv44104,4,0,0,4
"Eugene Nicholas Kovalenko papers",uum_accn2217.xml,80444/xv37753,0,0,4,4
"William Scott Barber papers",uum_accn2401.xml,80444/xv76632,0,1,3,4
"Ida Shimizu Tateoka papers",uum_accn1952.xml,80444/xv75088,4,0,0,4
"Huish family papers",uum_accn1302.xml,80444/xv34152,4,0,0,4
"Hector Haight Lee papers",uum_ms0505.xml,80444/xv99011,2,2,0,4
"Melvin A. Cook photograph collection",uum_p0567.xml,80444/xv79281,0,0,4,4
"Ralph Cannon papers",uum_accn1385.xml,80444/xv75238,0,2,2,4
"Henry Dinwoodey family papers",uum_accn0880.xml,80444/xv40188,0,0,4,4
"Monroe, Utah photograph collection",uum_p0079.xml,80444/xv61691,4,0,0,4
"James W. Ure papers",uum_accn2353.xml,80444/xv07833,2,1,1,4
"University of Utah Vice President for Administrative Services records",uum_acc0523.xml,80444/xv79037,2,1,1,4
"Tracey Wendell and Leone Sorensen Shepherd papers",uum_accn2143.xml,80444/xv81097,1,3,0,4
"Obert C. Tanner papers",uum_accn0343.xml,80444/xv75909,3,0,1,4
"Lynn M. Hilton papers",uum_accn1945.xml,80444/xv14916,4,0,0,4
"University of Utah Women's Resource Center records",uum_acc0532.xml,80444/xv76852,1,1,2,4
"Stanhope E. Blunt papers",uum_accn2332.xml,80444/xv22760,4,0,0,4
"William F. Bulkley photograph collection",uum_p1116.xml,80444/xv67593,3,1,0,4
"J.D. Williams photograph collection",uum_p0135.xml,80444/xv67584,4,0,0,4
"International Women's Year audio recordings",uum_a0236.xml,80444/xv64962,0,0,4,4
"Gladys Thorne papers",uum_accn0924.xml,80444/xv07962,3,1,0,4
"William Decatur Kartchner autobiography",uum_ms0271.xml,80444/xv35848,2,2,0,4
"Eliza Lowe biography",uum_ms0647.xml,80444/xv09497,0,1,3,4
"Bullion Hill Mines Company journal",uum_accn0085.xml,80444/xv06323,4,0,0,4
"University of Utah University Hospital records",uum_acc0467.xml,80444/xv89712,3,1,0,4
"Women's State Legislative Council of Utah records",uum_ms0228.xml,80444/xv45324,4,0,0,4
"Lynn Matthews Anderson papers",uum_accn1934.xml,80444/xv66308,0,3,1,4
"Alta LaRee Hill Pehrson papers",uum_accn2298.xml,80444/xv97955,4,0,0,4
"Historic American buildings survey",uum_accn1057.xml,80444/xv07272,4,0,0,4
"LeGrand Young papers",uum_accn0477.xml,80444/xv70376,0,4,0,4
"Nonie N. Sorensen papers",uum_accn1695.xml,80444/xv02581,2,2,0,4
"D. J. Angus home movies",uum_a0208.xml,80444/xv89361,1,0,3,4
"Henry Y. Kasai papers",uum_ms0149.xml,80444/xv33425,2,0,2,4
"Orson F. Whitney papers",uum_accn1400.xml,80444/xv48986,3,1,0,4
"Harvey W. Bailey papers",uum_accn0055.xml,80444/xv94790,2,0,2,4
"Cowley family papers",uum_accn1223.xml,80444/xv19281,4,0,0,4
"Bess Foster Smith papers",uum_ms0168.xml,80444/xv26284,2,0,2,4
"Harry Nelson papers",uum_ms0645.xml,80444/xv29244,0,2,2,4
"Friendship Circle records",uum_accn1968.xml,80444/xv96310,0,0,4,4
"Junior Bounous photograph collection",uum_p0389.xml,80444/xv56454,2,2,0,4
"Tracy Collins photograph collection",uum_p0516.xml,80444/xv12234,3,1,0,4
"Lynn Stegner papers",uum_accn1699.xml,80444/xv78231,0,0,4,4
"Steven K. Madsen collection on Blacks in Utah",uum_accn0689.xml,80444/xv15597,3,0,1,4
"University of Utah Administrative Vice President's Office records",uum_acc0236.xml,80444/xv06741,2,1,1,4
"David Merrill papers",uum_accn2446.xml,80444/xv25192,1,3,0,4
"Valeo Mining Company",uum_accn1073.xml,80444/xv78067,0,4,0,4
"University of Utah Vice President for Academic Affairs Office records",uum_acc0256.xml,80444/xv69461,0,3,0,3
"Olive Ghiselin papers",uum_accn2660.xml,80444/xv47744,0,0,3,3
"Sonia Johnson photograph collection",uum_p0099.xml,80444/xv93017,1,0,2,3
"Southwest Regional Resource Center records",uum_acc0383.xml,80444/xv45925,0,1,2,3
"Monte E. Rouska papers",uum_accn2150.xml,80444/xv35623,0,0,3,3
"Excelsior Mining Company records",uum_accn0567.xml,80444/xv50106,0,0,3,3
"Park City Mountain Resort records",uum_accn1938.xml,80444/xv55453,0,3,0,3
"J. W. Sylvester papers",uum_accn2022.xml,80444/xv65563,3,0,0,3
"Dan A. Weggeland architectural drawings",uum_ms0496.xml,80444/xv77450,3,0,0,3
"Leo Tolstoy Samuels photograph collection",uum_p0285.xml,80444/xv30187,0,0,3,3
"University of Utah Admissions Office records",uum_acc0309.xml,80444/xv84451,0,3,0,3
"Gary H. Schwartz ski collection",uum_accn2604.xml,80444/xv44033,0,0,3,3
"Alvin Willard Kirkham autobiography",uum_ms0021.xml,80444/xv05346,3,0,0,3
"Jean H. Futrell photograph collection",uum_p0515.xml,80444/xv11315,2,1,0,3
"Harold Moore photograph collection",uum_p0702.xml,80444/xv36364,0,3,0,3
"Patrick N. Miller collection",uum_accn1771.xml,80444/xv32470,0,2,1,3
"Jungle Garden Press records",uum_accn2543.xml,80444/xv35910,0,2,1,3
"Jacob Miller papers",uum_ms0111.xml,80444/xv28442,3,0,0,3
"Howard D. Johnson papers",uum_accn1035.xml,80444/xv14401,0,0,3,3
"Grace Atkin Woodbury papers",uum_accn1512.xml,80444/xv10919,1,0,2,3
"Rudger Clawson photograph collection",uum_p0291.xml,80444/xv42163,0,0,3,3
"University of Utah Institute of International Studies records",uum_acc0318.xml,80444/xv93942,0,1,2,3
"Naomi Silverstone papers",uum_accn1199.xml,80444/xv14599,1,1,1,3
"University of Utah College of Humanities memoranda and meeting minutes",uum_acc0076.xml,80444/xv95492,2,0,1,3
"University of Utah Personnel Department records",uum_acc0259.xml,80444/xv84359,1,1,1,3
"Thomas Stuart Ferguson photograph collection",uum_p0564.xml,80444/xv79382,2,1,0,3
"Bronson Stringham papers",uum_accn2093.xml,80444/xv48645,3,0,0,3
"James Walter Paxman diary",uum_accn0684.xml,80444/xv39956,0,1,2,3
"Joseph B. Toronto papers",uum_ms0179.xml,80444/xv67605,2,0,1,3
""Big Parade" War Bond Drive photograph collection",uum_p0280.xml,80444/xv31057,2,1,0,3
"Benjamin M. Roe papers",uum_ms0139.xml,80444/xv38894,1,1,1,3
"Page Stegner papers",uum_accn1698.xml,80444/xv76000,0,3,0,3
"Luella Seeholzer collection on Beaver Mountain Ski Area",uum_accn1255.xml,80444/xv00885,3,0,0,3
"University of Utah Controller's Office financial memoranda and audit reports",uum_acc0241.xml,80444/xv17556,0,3,0,3
"Jonn Werner Welland papers",uum_accn2056.xml,80444/xv85385,0,0,3,3
"Salt Lake City Country Club records",uum_accn0793.xml,80444/xv44216,0,0,3,3
"American Game Breeders Co-op Federation photograph collection",uum_p0309.xml,80444/xv34573,3,0,0,3
"Melvin T. Smith papers",uum_accn1981.xml,80444/xv25219,0,0,3,3
"Helen Clawson Wells photograph collection",uum_p0090.xml,80444/xv74978,3,0,0,3
"Robert L. Springmeyer photograph collection",uum_p0421.xml,80444/xv74072,0,1,2,3
"Beverly Holley theater program collection",uum_accn1583.xml,80444/xv74835,0,3,0,3
"World War II scrapbook collection",uum_accn2608.xml,80444/xv26815,0,0,3,3
"University of Utah College of Pharmacy records",uum_acc0302.xml,80444/xv85549,1,2,0,3
"Sally Smith letter",uum_accn1617.xml,80444/xv49749,3,0,0,3
"Stanley Buchholz Kimball papers",uum_accn2075.xml,80444/xv49822,0,0,3,3
"University of Utah Department of Geology and Geophysics research records",uum_acc0381.xml,80444/xv73809,0,1,2,3
"John Doyle Lee papers",uum_accn0186.xml,80444/xv97152,0,2,1,3
"Mike Korologos photograph collection",uum_p0410.xml,80444/xv47433,1,2,0,3
"Oscar J. and Mary Preston Moyle papers",uum_accn1420.xml,80444/xv58297,0,1,2,3
"Thomas J. and Lydia H. Yates papers",uum_accn1287.xml,80444/xv72665,1,2,0,3
"A. S. U. U. records",uum_acc0156.xml,80444/xv67254,0,2,1,3
"Phyllis Anne Haskell papers",uum_accn2197.xml,80444/xv39633,1,1,1,3
"Charles Gustave Larson papers",uum_accn2632.xml,80444/xv42166,1,0,2,3
"A. Russell Mortensen photograph collection",uum_p0201.xml,80444/xv01809,2,1,0,3
"Clyde D. Gessel papers",uum_accn2437.xml,80444/xv89236,0,0,3,3
"William Nelson papers",uum_accn2696.xml,80444/xv90216,3,0,0,3
"C. Lowell Lees photograph collection",uum_p0005.xml,80444/xv05389,2,0,1,3
"Lloyd M. Pierson papers",uum_accn1706.xml,80444/xv41467,1,0,2,3
"Tammy J. Braithwaite papers",uum_accn2011.xml,80444/xv82174,1,0,2,3
"Gordon Weggeland papers",uum_accn0988.xml,80444/xv60693,3,0,0,3
"A.J. Peters photograph collection",uum_p0368.xml,80444/xv38842,2,1,0,3
"University of Utah Department of Bioengineering records",uum_acc0519.xml,80444/xv12384,0,1,2,3
"Don Maguire papers",uum_ms0424.xml,80444/xv06918,1,2,0,3
"H. Byron Mock papers",uum_accn0886.xml,80444/xv85675,0,3,0,3
"Susanna Bransford Emery-Holmes scrapbook",uum_ms0634.xml,80444/xv06185,3,0,0,3
"University of Utah Alumni Association meeting minutes and reports",uum_acc0338.xml,80444/xv32617,2,1,0,3
"Elizabeth Dennistoun Wood Kane diary",uum_accn1034.xml,80444/xv05114,0,0,3,3
"Barbara Williams papers",uum_accn1467.xml,80444/xv09909,1,1,1,3
"Brigham Young family photograph collection",uum_p0054.xml,80444/xv43927,3,0,0,3
"Mary Susannah Sumner Fackrell Fowler and William Fowler papers",uum_ms0318.xml,80444/xv16363,0,3,0,3
"J.A.C. Redford papers",uum_accn1397.xml,80444/xv27575,0,1,2,3
"George B. Sanderson papers",uum_accn2134.xml,80444/xv98641,0,2,1,3
"India Students Association newsletters",uum_acc0193.xml,80444/xv75076,2,1,0,3
"Harry P. Bluhm, Claude W. Grant, and Frank B. Jex papers",uum_acc0365.xml,80444/xv38876,1,2,0,3
"Ernest H. Linford correspondence",uum_ms0334.xml,80444/xv74761,1,0,2,3
"Tooele Army Depot photograph collection",uum_p0060.xml,80444/xv83367,3,0,0,3
"Roy E. Lundquist report",uum_accn2702.xml,80444/xv11026,0,0,3,3
"Jack Paige papers",uum_accn0949.xml,80444/xv32223,1,2,0,3
"N.J. Van Steenberg papers",uum_accn1044.xml,80444/xv35351,0,0,3,3
"Bruce S. Jenkins papers",uum_accn1630.xml,80444/xv85494,3,0,0,3
"Tanner family home movies",uum_a1079.xml,80444/xv31170,0,0,3,3
"George W. Taggart papers",uum_accn0611.xml,80444/xv54666,3,0,0,3
"Francis W. Kirkham papers",uum_accn1259.xml,80444/xv32650,1,2,0,3
"Utah State Democratic Committee records",uum_ms0272.xml,80444/xv51266,3,0,0,3
"John Pack record book",uum_accn2410.xml,80444/xv09423,1,2,0,3
"Lowry Nelson photograph collection",uum_p0115.xml,80444/xv82101,1,0,2,3
"Marjorie Alston Whiteley autograph album",uum_ms0586.xml,80444/xv05404,0,0,3,3
"Lambda Delta Sigma records",uum_accn2427.xml,80444/xv83538,3,0,0,3
"Barbara Stewart Anderson papers",uum_accn2184.xml,80444/xv96377,2,1,0,3
"Steven Harvey Heath research paper",uum_accn0585.xml,80444/xv08645,0,0,3,3
"Stevenson family papers",uum_accn1613.xml,80444/xv17291,2,1,0,3
"The Division of Continuing Education: a position paper, 1973 / by Oakley J. Gordon",uum_acc0071.xml,80444/xv38961,2,0,1,3
"Mark H. Forscutt papers",uum_ms0261.xml,80444/xv63067,3,0,0,3
"Utah Scottish Association audio-visual collection",uum_a0032.xml,80444/xv07705,0,0,3,3
"Lead-Zinc Producers Association records",uum_accn0994.xml,80444/xv81469,3,0,0,3
"Feargus O'Connor Willden papers",uum_accn1292.xml,80444/xv79421,0,0,3,3
"Roy Watrous papers",uum_accn1963.xml,80444/xv31015,3,0,0,3
"Pioneer Memorial Theater collection",uum_accn1679.xml,80444/xv55007,1,2,0,3
"Peter DeLafosse papers",uum_accn1581.xml,80444/xv97689,0,3,0,3
"Deseret Livestock Company photograph collection",uum_p0105.xml,80444/xv14562,1,2,0,3
"William P. Nisbet papers",uum_accn1754.xml,80444/xv38623,2,1,0,3
"Gay N. Blanchard papers",uum_accn0162.xml,80444/xv67630,0,1,2,3
"Robert Hinckley photograph collection",uum_p0102.xml,80444/xv04843,2,1,0,3
"Doris S. Melich papers",uum_accn2141.xml,80444/xv94726,1,1,1,3
"Craig Wirth papers",uum_accn1310.xml,80444/xv23132,3,0,0,3
"University of Utah Libraries Marriott Library annual report",uum_acc0149.xml,80444/xv11651,0,1,2,3
"University of Utah Vice President for Research Office records",uum_acc0344.xml,80444/xv10296,0,2,1,3
"J. Irvin Swigart papers",uum_accn0969.xml,80444/xv26638,0,0,3,3
"Hansen Planetarium collection",uum_accn2654.xml,80444/xv64105,0,0,3,3
"Echo Park Dam controversy study",uum_accn1846.xml,80444/xv73599,0,1,2,3
"Patrick W. McKendrick papers",uum_ms0350.xml,80444/xv13137,0,1,2,3
"Utah Women's Democratic Club records",uum_ms0229.xml,80444/xv59570,1,0,2,3
"Elzy J. Bird papers",uum_ms0639.xml,80444/xv83874,0,0,3,3
"University of Utah Graduate School of Social Work records",uum_acc0521.xml,80444/xv03829,1,2,0,3
"Joel O. Palmer papers",uum_accn1456.xml,80444/xv02590,3,0,0,3
"Stanley S. Ivins papers",uum_accn1471.xml,80444/xv24737,0,2,1,3
"Marilyn Arnold papers",uum_accn2857.xml,80444/xv95944,2,0,1,3
"Art Zeldin papers",uum_accn1212.xml,80444/xv60025,3,0,0,3
"Utah Arts Festival Foundation records",uum_accn2478.xml,80444/xv87954,0,0,3,3
"Dale R. Broadhurst papers",uum_accn0913.xml,80444/xv95535,2,0,1,3
"Phil Larsen Andersen papers",uum_accn2185.xml,80444/xv60690,3,0,0,3
"Jennie Teasdale Smith Photogaph Collection",uum_p0551.xml,80444/xv46908,2,0,1,3
"Mansfield Lorenzo Snow papers",uum_ms0081.xml,80444/xv67141,0,3,0,3
"Myth of the Eastern Front records",uum_accn2380.xml,80444/xv54446,0,2,1,3
"Mountain Fuel Supply Company audio-visual collection",uum_a0314.xml,80444/xv41217,2,0,1,3
"Burch-Taylor gristmill historical description",uum_accn0757.xml,80444/xv87863,0,0,3,3
"Franklin Spencer Spalding collection",uum_ms0073.xml,80444/xv58709,0,2,1,3
"Francis Urry papers",uum_ms0659.xml,80444/xv36578,1,1,1,3
"Paul Edward Nelson papers",uum_accn2522.xml,80444/xv85263,0,2,1,3
"Report on Blacksmith Fork hydro electric development near Hyrum, Utah",uum_accn0708.xml,80444/xv87210,0,0,3,3
"L. Jackson Newell Audio Visual Collection",uum_a0927.xml,80444/xv33038,2,0,1,3
"Japanese in Utah collection",uum_accn0514.xml,80444/xv79309,1,0,2,3
"<title render="italic">The First Vampire</title> motion picture",uum_a0793.xml,80444/xv35409,1,0,2,3
"John D. Spencer photograph collection",uum_p0203.xml,80444/xv61651,1,1,1,3
"Benjamin Franklin Johnson papers",uum_ms0056.xml,80444/xv87454,0,3,0,3
"George Isom papers",uum_ms0068.xml,80444/xv98031,3,0,0,3
"Calvin McPhie papers",uum_accn2111.xml,80444/xv04397,0,1,2,3
"Phi Delta Kappa records",uum_acc0270.xml,80444/xv07128,2,1,0,3
"Jesse Crosby papers",uum_ms0398.xml,80444/xv53726,0,2,1,3
"V. Douglas Snow collection",uum_ms0390.xml,80444/xv61795,3,0,0,3
"John Whitmer papers",uum_accn0274.xml,80444/xv80737,0,0,3,3
"Lillian May Tucker nursing certificate",uum_accn1154.xml,80444/xv43338,2,0,1,3
"University of Utah Marriott Library Staff Associations records",uum_acc0137.xml,80444/xv31268,2,1,0,3
"William M. Powell papers",uum_accn1394.xml,80444/xv84158,0,0,3,3
"Zeta Gamma Literary and Debating Society records",uum_acc0067.xml,80444/xv59912,2,1,0,3
"David P. Rothrock papers",uum_accn1483.xml,80444/xv70504,0,3,0,3
"A. Wally Sandack papers",uum_accn1481.xml,80444/xv61520,3,0,0,3
"Dale Eldon Winn papers",uum_accn1701.xml,80444/xv88345,0,3,0,3
"James F. Milligan papers",uum_accn1850.xml,80444/xv49417,0,0,3,3
"Edward F. Coburn papers",uum_accn2238.xml,80444/xv37222,3,0,0,3
"William Lee journal",uum_accn0673.xml,80444/xv52691,0,0,3,3
"Barbara J. Hamblin papers",uum_accn1460.xml,80444/xv14926,1,2,0,3
"Pete Delos Gardner papers",uum_accn1181.xml,80444/xv92807,0,3,0,3
"Brighton Ski Resort records",uum_accn1838.xml,80444/xv67785,0,1,2,3
"Leonard H. Kirkpatrick papers",uum_ms0484.xml,80444/xv34103,1,0,2,3
"Chamber Music Society of Salt Lake City records",uum_ms0651.xml,80444/xv15847,2,0,1,3
"Charlie P. Haynes letters",uum_accn1066.xml,80444/xv44012,0,1,2,3
"Pat Shea papers",uum_accn1864.xml,80444/xv58245,0,1,2,3
"Italian archives",uum_ms0230.xml,80444/xv39434,2,1,0,3
"Esther Landa photograph collection",uum_p0555.xml,80444/xv14852,2,1,0,3
"Joseph Smith Scofield diary",uum_ms0232.xml,80444/xv84512,3,0,0,3
"University of Utah Physical Plant and Operations Office personnel administration records",uum_acc0377.xml,80444/xv60266,0,2,1,3
"University of Utah Vice President for Health Sciences Office records",uum_acc0239.xml,80444/xv35650,0,3,0,3
"George S. and Algie E. Ballif papers",uum_accn1760.xml,80444/xv76721,0,3,0,3
"William J. Roosen skiing collection",uum_accn1506.xml,80444/xv89749,1,1,1,3
"Utah Symphony Guild records",uum_accn1019.xml,80444/xv62747,0,3,0,3
"Tsutomu (Stormy) Mitsui papers",uum_accn2644.xml,80444/xv54986,0,3,0,3
"Dan Marriott papers",uum_accn0812.xml,80444/xv82113,1,2,0,3
"Ballet West for Children records",uum_accn1313.xml,80444/xv21688,1,0,2,3
"University of Utah Graduate School of Education councils records",uum_acc0289.xml,80444/xv62023,1,1,1,3
"Owen Franklin Beal papers",uum_ms0219.xml,80444/xv11886,0,3,0,3
"Decorative paper samples collection",uum_accn2682.xml,80444/xv42587,0,1,2,3
"University of Utah Department of Fuels Engineering records",uum_acc0522.xml,80444/xv41839,2,1,0,3
"Authors Club records",uum_ms0240.xml,80444/xv52316,0,0,3,3
"William R. Handley papers",uum_accn2258.xml,80444/xv92080,2,0,1,3
"John Lyman Ballif papers",uum_accn1431.xml,80444/xv13711,0,1,2,3
"B. H. Blanton letter",uum_ms0165.xml,80444/xv06457,3,0,0,3
"Joseph Smith Horne autobiography",uum_ms0093.xml,80444/xv24157,0,3,0,3
"Janet Quinney Lawson photograph collection",uum_p0423.xml,80444/xv81445,1,2,0,3
"Colton family papers",uum_ms0418.xml,80444/xv40112,1,2,0,3
"Western States Communication Association records",uum_ms0620.xml,80444/xv72991,0,0,3,3
"Betty Elaine Gunderson Woodbury collection",uum_accn2621.xml,80444/xv79785,1,2,0,3
"Jesse Haven papers",uum_accn2792.xml,80444/xv90066,1,0,2,3
"Society of Utah Artists records",uum_accn0883.xml,80444/xv51638,0,0,3,3
"Hans Franklin and Florence Jepperson Madsen papers",uum_accn2716.xml,80444/xv87643,1,1,1,3
"Bae B. Gardner papers",uum_accn1829.xml,80444/xv64575,2,0,1,3
"American Association of University Women records",uum_ms0117.xml,80444/xv33105,2,0,1,3
"Theodore Frederick Major ski clippings collection",uum_accn1418.xml,80444/xv80191,0,2,1,3
"Ronald Coleman papers",uum_accn1020.xml,80444/xv98440,0,3,0,3
"Pioneer Dress photograph collection",uum_p0058.xml,80444/xv80734,3,0,0,3
"University of Utah Executive Vice President records",uum_acc0229.xml,80444/xv63772,0,3,0,3
"William H Behle photograph collection",uum_p0030.xml,80444/xv70922,1,1,1,3
"Edward H. Snow papers",uum_ms0169.xml,80444/xv23779,0,0,3,3
"Sonia Johnson audio-visual collection",uum_a0099.xml,80444/xv35437,0,0,3,3
"University of Utah Auxiliary Services records",uum_acc0476.xml,80444/xv70169,2,1,0,3
"Henry Blanchard Freeman diary",uum_accn0395.xml,80444/xv97229,1,2,0,3
"Herbert B. Maw audio-visual collection",uum_a0066.xml,80444/xv12039,0,0,3,3
"Kenneth and Linda Brailsford collection",uum_accn2935.xml,80444/xv70950,3,0,0,3
"Mead Leroy Jensen papers",uum_accn2262.xml,80444/xv80212,1,2,0,3
"Utah Industry photograph collection",uum_p0061.xml,80444/xv71221,3,0,0,3
"Scott D. McCoy papers",uum_accn2535.xml,80444/xv01187,2,0,1,3
"Craig Hibberd collection on cold fusion",uum_accn1309.xml,80444/xv55120,2,1,0,3
"Intermountain Ski Hall of Fame collection",uum_accn2668.xml,80444/xv06192,0,0,3,3
"The Great Salt Lake photograph collection",uum_p0220.xml,80444/xv66680,3,0,0,3
"Richard Tracey Wootton papers",uum_accn0219.xml,80444/xv84423,1,1,1,3
"Cold fusion collection",uum_accn1319.xml,80444/xv05773,3,0,0,3
"Vernal, Utah photograph collection",uum_p0238.xml,80444/xv11236,0,3,0,3
"Thomas Caldwell Adams photograph collection",uum_p0043.xml,80444/xv22296,3,0,0,3
"<emph render="italic">Sagen et al v. VANOC</emph> records",uum_accn2657.xml,80444/xv91442,0,1,2,3
"Charles G. Beaudette papers",uum_accn2297.xml,80444/xv76123,0,0,3,3
"David T. Holland independent film collection",uum_a0798.xml,80444/xv75189,0,1,2,3
"University of Utah College of Engineering records",uum_acc0280.xml,80444/xv59613,0,2,1,3
"Sigrid Peterson papers",uum_accn1314.xml,80444/xv04391,1,1,1,3
"James W. Beless papers",uum_ms0450.xml,80444/xv75424,3,0,0,3
"South Valley Unitarian Universalist Society records",uum_accn1109.xml,80444/xv26473,1,0,2,3
"University of Utah Bookstore records",uum_acc0105.xml,80444/xv26861,0,3,0,3
"Albert Robison Lyman papers",uum_accn1681.xml,80444/xv26480,1,2,0,3
"University of Utah Teaching Innovations Committee records",uum_acc0186.xml,80444/xv97845,0,2,1,3
"Central Utah Project lecture video collection",uum_a0191.xml,80444/xv25988,2,0,1,3
"Betty M. Madsen papers",uum_accn1649.xml,80444/xv31643,0,2,1,3
"Richard L. Bate papers",uum_accn1278.xml,80444/xv15866,0,3,0,3
"University of Utah Business Services Office records",uum_acc0349.xml,80444/xv34292,2,1,0,3
"David T. Lewis collection",uum_accn0730.xml,80444/xv04440,3,0,0,3
"Jessica Furman scrapbook",uum_accn2372.xml,80444/xv18032,2,0,1,3
"Elbert Dansie papers",uum_accn1859.xml,80444/xv15362,2,0,1,3
"Albert and Vera Cuglietta papers",uum_accn2747.xml,80444/xv04565,1,1,1,3
"Frank K. Yoshimura papers",uum_accn1983.xml,80444/xv45300,2,0,1,3
"Zion Easter Pageant collection",uum_ms0310.xml,80444/xv52734,0,3,0,3
"Lafayette Hinckley Holbrook papers",uum_accn2308.xml,80444/xv96032,0,1,2,3
"Kevin G. Barnhurst papers",uum_accn2292.xml,80444/xv31686,0,0,3,3
"Utah music collection",uum_accn2744.xml,80444/xv78479,0,2,1,3
"Bureau of Indian Affairs records",uum_accn1125.xml,80444/xv11846,2,1,0,3
"Brigham Young Jr. papers",uum_accn1680.xml,80444/xv82543,2,0,1,3
"Thaynes mine shaft photograph collection",uum_p0400.xml,80444/xv69033,0,2,1,3
"California gold mines letter collection",uum_ms0099.xml,80444/xv77273,3,0,0,3
"Avard T. Fairbanks photograph collection",uum_p0542.xml,80444/xv55087,3,0,0,3
"Eldon T. McEntire papers",uum_accn1985.xml,80444/xv97225,0,0,3,3
"Robert Lang Campbell papers",uum_accn0376.xml,80444/xv29336,1,0,2,3
"Mark R. Ashurst-McGee papers",uum_accn1619.xml,80444/xv55322,0,3,0,3
"Charles Sheppard homestead certificate",uum_accn2502.xml,80444/xv58923,0,0,3,3
"G. L. Brunschuler lectures",uum_accn2467.xml,80444/xv86395,3,0,0,3
"Perry E. Brocchus papers",uum_ms0150.xml,80444/xv29299,0,2,1,3
"Frank O'Rourke photograph collection",uum_p0351.xml,80444/xv99343,1,0,2,3
"James Cantwell diary",uum_ms0254.xml,80444/xv37725,0,0,3,3
"Erastus Beck mercantile ledger",uum_accn2799.xml,80444/xv44189,0,3,0,3
"Utah Territorial Penitentiary stone contract",uum_ms0345.xml,80444/xv78750,1,0,2,3
"Cotton Mission photograph collection",uum_p0055.xml,80444/xv18566,3,0,0,3
"Noel de Nevers papers",uum_accn1523.xml,80444/xv21456,2,1,0,3
"Utah Soccer Archives",uum_accn2322.xml,80444/xv46511,2,0,1,3
"Plan-B Theatre Company records",uum_accn2498.xml,80444/xv90402,3,0,0,3
"Richfield, Utah photograph collection",uum_p0230.xml,80444/xv62680,0,3,0,3
"Marjorie G. Paul papers",uum_accn2089.xml,80444/xv78152,1,1,1,3
"Isaac Hurd letter",uum_accn2514.xml,80444/xv85198,1,1,1,3
"Richard D. Movitz photograph collection",uum_p1325.xml,80444/xv28204,0,0,3,3
"National Reclamation Association records",uum_ms0205.xml,80444/xv63488,0,3,0,3
"Ernest H. Quayle diaries",uum_ms0226.xml,80444/xv87973,0,0,3,3
"West High Basketball Team photograph collection",uum_p0167.xml,80444/xv69921,0,2,1,3
"Rocco C. Siciliano photograph collection",uum_p0524.xml,80444/xv90835,2,1,0,3
"University Club of Salt Lake City records",uum_accn2334.xml,80444/xv48010,3,0,0,3
"Barry Lynn photograph collection",uum_p0183.xml,80444/xv33197,0,3,0,3
"James Chipman Fletcher photograph collection",uum_p0202.xml,80444/xv25439,2,1,0,3
"University of Utah American West Center Advisory Committee meeting minutes",uum_acc0070.xml,80444/xv86010,2,0,1,3
"Arthur C. Deck papers",uum_ms0361.xml,80444/xv86654,0,3,0,3
"Jerilyn S. McIntyre papers",uum_accn2730.xml,80444/xv28143,0,0,3,3
"Albert George Brain papers",uum_accn0982.xml,80444/xv19342,0,1,2,3
"Moyer Delwyn Thomas papers",uum_ms0665.xml,80444/xv83398,2,0,1,3
"Garth N. Jones papers",uum_accn1558.xml,80444/xv86950,0,0,3,3
"University of Utah College of Mines and Mineral Industries records",uum_acc0474.xml,80444/xv98205,0,3,0,3
"Arthur L. Crawford papers",uum_ms0364.xml,80444/xv89096,0,2,0,2
"University of Utah Bureau of Indian Services correspondence and reports",uum_acc0263.xml,80444/xv04183,0,1,1,2
"John W. Young correspondence",uum_accn1719.xml,80444/xv95626,0,2,0,2
"Grant L. and Mary Merrell Valentine papers",uum_accn2244.xml,80444/xv64801,2,0,0,2
"Rosezella Dalton Hardy papers",uum_accn1697.xml,80444/xv36669,1,0,1,2
"David S. King photograph collection",uum_p0033.xml,80444/xv21398,2,0,0,2
"Delta Theta Sorority scrapbook",uum_accn1092.xml,80444/xv88058,0,1,1,2
"University of Utah Bureau of Economic and Business Research records",uum_acc0183.xml,80444/xv26577,0,2,0,2
"Elizabeth and Jimmy Miklavcic independent film and dance collection",uum_a0762.xml,80444/xv94702,0,0,2,2
"Edna Clark Ericksen photograph collection",uum_p0425.xml,80444/xv12857,0,2,0,2
"Edward P. Jennings photograph collection",uum_p0101.xml,80444/xv40081,2,0,0,2
"Jennie Teasdale Smith papers",uum_accn1349.xml,80444/xv69314,0,0,2,2
"Andrew L. Rogers papers",uum_accn1739.xml,80444/xv35110,0,0,2,2
"University of Utah Archives records",uum_accn2724.xml,80444/xv40661,2,0,0,2
"John H. Dalton document",uum_accn2698.xml,80444/xv66564,0,1,1,2
"Archibald R. Anderson papers",uum_accn1735.xml,80444/xv13598,2,0,0,2
"Joseph W. McMurrin papers",uum_accn1029.xml,80444/xv73590,1,1,0,2
"Nettie Blackburn West photograph collection",uum_p0432.xml,80444/xv24938,1,1,0,2
"Craig Gorder papers",uum_accn1709.xml,80444/xv15118,0,2,0,2
"University of Utah Deans' Council meeting minutes",uum_acc0005.xml,80444/xv38714,0,0,2,2
"Fred T. Darvill papers",uum_accn1800.xml,80444/xv05230,0,0,2,2
"Bonneville Salt Flats racing collection",uum_accn2805.xml,80444/xv53817,1,0,1,2
"Gold Chain Mining Company records",uum_accn2455.xml,80444/xv76678,0,2,0,2
"MX photograph collection",uum_p0505.xml,80444/xv11770,2,0,0,2
"Sheldon F. Hyde papers",uum_accn1448.xml,80444/xv28475,0,2,0,2
"David Hogg Matheson autobiography",uum_accn0672.xml,80444/xv16497,0,2,0,2
"Khosrow Mostofi photograph collection",uum_p0517.xml,80444/xv76535,2,0,0,2
"Clifford Percy Evans photograph collection",uum_p0002.xml,80444/xv38900,0,2,0,2
"Martin Tolchin papers",uum_accn1790.xml,80444/xv78552,0,2,0,2
"Joseph Lafayette Rawlins papers",uum_ms0189.xml,80444/xv14169,0,1,1,2
"Hite ferry booklet",uum_accn0977.xml,80444/xv32778,0,2,0,2
"University of Utah Department of Philosophy records",uum_acc0450.xml,80444/xv23522,0,1,1,2
"Utah State Society Daughters of the Revolution records",uum_ms0153.xml,80444/xv94546,0,0,2,2
"Suzanne Skinner papers",uum_accn1411.xml,80444/xv68875,2,0,0,2
"Heist and Birkhaus family papers",uum_accn1477.xml,80444/xv98971,0,0,2,2
"Horace M. McMullen papers",uum_accn2822.xml,80444/xv47250,1,1,0,2
"U.S. Forest Service/ Alta photograph collection",uum_p0394.xml,80444/xv81448,0,2,0,2
"Timpanogos Club records",uum_ms0369.xml,80444/xv99151,0,0,2,2
"Harold Dalgliesh photograph collection",uum_p0070.xml,80444/xv69369,2,0,0,2
"Grant N. Mildenhall papers",uum_accn1742.xml,80444/xv68841,0,0,2,2
"Utah Federation of Women's Republican Clubs records",uum_ms0186.xml,80444/xv44140,1,0,1,2
"Third Wagon Company roster",uum_ms0435.xml,80444/xv59158,0,0,2,2
"M. Hamlin Cannon papers",uum_ms0618.xml,80444/xv71432,0,0,2,2
"Kirtland revelation book",uum_accn1286.xml,80444/xv63842,0,0,2,2
"Phyllis Barber papers",uum_accn0369.xml,80444/xv20294,1,1,0,2
"University of Utah Budget Office records",uum_acc0266.xml,80444/xv81771,0,1,1,2
"Andrus, Charles H. photograph collection",uum_p0598.xml,80444/xv89132,2,0,0,2
"Merlo John Pusey typewritten manuscript",uum_accn0908.xml,80444/xv33892,0,2,0,2
"George Thomas diary",uum_ms0023.xml,80444/xv78094,0,2,0,2
"Keith Smith papers",uum_ms0185.xml,80444/xv36666,0,1,1,2
"Marvin Alton Melville papers",uum_accn1246.xml,80444/xv03930,0,0,2,2
"George James Peirce papers",uum_accn0905.xml,80444/xv82907,0,0,2,2
"Luella Hyatt photograph collection",uum_p0560.xml,80444/xv56655,0,1,1,2
"Benson Stake Tabernacle collection",uum_ms0451.xml,80444/xv43041,0,2,0,2
"University of Utah Graduate School of Education committee and faculty meeting records",uum_acc0306.xml,80444/xv68478,0,2,0,2
"John D. Spencer papers",uum_ms0203.xml,80444/xv51522,0,1,1,2
"Thorn L. Mayes Sr. papers",uum_accn1189.xml,80444/xv46133,0,0,2,2
"Mervin B. Hogan photograph collection",uum_p0434.xml,80444/xv01913,0,2,0,2
"Patricia Albers papers",uum_accn1861.xml,80444/xv90036,0,1,1,2
"William H. Delves papers",uum_accn1756.xml,80444/xv82843,2,0,0,2
"Clarice Short photograph collection",uum_p0278.xml,80444/xv09371,0,2,0,2
"Edward H. Ashment papers",uum_accn1498.xml,80444/xv35879,0,2,0,2
"University of Utah Campus Planning and Traffic Committee records",uum_acc0108.xml,80444/xv28686,0,2,0,2
"Earl and Gladys Miller photograph collection",uum_p0375.xml,80444/xv00402,0,2,0,2
"Committee to Stop East-West Light Rail records",uum_accn1792.xml,80444/xv42190,2,0,0,2
"Mosiah Hall papers",uum_ms0248.xml,80444/xv15551,0,1,1,2
"Hole-in-the-Rock photograph collection",uum_p0194.xml,80444/xv88284,0,0,2,2
"KUED-TV Promotional Materials",uum_acc0409.xml,80444/xv61886,0,1,1,2
"Royal Kenneth Barnes papers",uum_accn2327.xml,80444/xv83047,0,1,1,2
"Garcilaso de la Vega papers",uum_accn2419.xml,80444/xv04388,0,1,1,2
"Alexander George Fontas papers",uum_accn2061.xml,80444/xv86041,0,0,2,2
"David Pierpont Gardner papers",uum_accn2006.xml,80444/xv99023,1,1,0,2
"Ludwig Wittgenstein papers",uum_accn2265.xml,80444/xv94128,0,0,2,2
"University of Utah Deputy Business Vice President for Finance records",uum_acc0203.xml,80444/xv71231,0,1,1,2
"American Forensic Association records",uum_accn0418.xml,80444/xv30456,0,0,2,2
"Park City Ski Corporation records",uum_accn1218.xml,80444/xv81567,0,0,2,2
"George Barber journal",uum_accn0327.xml,80444/xv55712,1,1,0,2
"William A. Dawson papers",uum_ms0031.xml,80444/xv75320,2,0,0,2
"Fort Douglas Hidden Valley Country Club records",uum_accn1055.xml,80444/xv86914,0,2,0,2
"Isaac Riddle autobiography",uum_ms0277.xml,80444/xv48773,0,2,0,2
"Norm Burton photograph collection",uum_p0420.xml,80444/xv87875,0,0,2,2
"Robert Marsham diary",uum_accn1802.xml,80444/xv09075,1,1,0,2
"National Organization for Women photograph collection",uum_p0071.xml,80444/xv29910,2,0,0,2
"University of Utah Department of Pharmaceutics records",uum_acc0462.xml,80444/xv14407,0,2,0,2
"Margaret Lantis papers",uum_accn2125.xml,80444/xv01278,0,2,0,2
"Capitol Theater programs",uum_accn0944.xml,80444/xv14462,0,2,0,2
"Elzy J. Bird photograph collection",uum_p0558.xml,80444/xv15515,0,0,2,2
"University of Utah Vice President for University Relations meeting minutes and reports",uum_acc0319.xml,80444/xv09826,0,2,0,2
"Nona Cook Weatherbee photograph collection",uum_p1303.xml,80444/xv36212,0,2,0,2
"Mary Jane Orrock Seegmiller typescript history",uum_accn0285.xml,80444/xv01391,2,0,0,2
"Emma Peterson Riddle autobiography",uum_ms0276.xml,80444/xv33743,0,1,1,2
"Read H. Putnam papers",uum_accn2059.xml,80444/xv28787,0,0,2,2
"LeGrand Richards papers",uum_ms0429.xml,80444/xv31735,0,0,2,2
"University of Utah Executive Vice President's Office records",uum_acc0238.xml,80444/xv37683,0,1,1,2
"Joseph F. Merrill papers",uum_accn1062.xml,80444/xv42419,2,0,0,2
"Jim Shane photograph collection",uum_p0416.xml,80444/xv27423,2,0,0,2
"Lorenzo Hill Hatch papers",uum_accn0407.xml,80444/xv08673,0,2,0,2
"Combined Metals Reduction Company photograph collection",uum_p0124.xml,80444/xv89593,2,0,0,2
"University of Utah Media Services records",uum_acc0524.xml,80444/xv28533,0,1,1,2
"Utah Theatre Association records",uum_accn1926.xml,80444/xv94854,0,0,2,2
"University of Utah Friars Club records",uum_accn2736.xml,80444/xv31420,0,2,0,2
"Robert Heiner Garff papers",uum_accn0986.xml,80444/xv74841,2,0,0,2
"Gale Dick papers",uum_ms0593.xml,80444/xv57916,0,0,2,2
"Utah Small Business Development Center records",uum_acc0507.xml,80444/xv22796,0,2,0,2
"JoAnne C. Swindle papers",uum_accn1765.xml,80444/xv57162,2,0,0,2
"Utah State Junior Chamber of Commerce records",uum_ms0285.xml,80444/xv39086,0,2,0,2
"Milton Roswell Trenam papers",uum_accn1948.xml,80444/xv78073,2,0,0,2
"Olive Andelin Potter autobiography",uum_accn0360.xml,80444/xv33676,0,0,2,2
"Ewart A. Swinyard papers",uum_accn1340.xml,80444/xv36376,0,2,0,2
"Oscar Lewis papers",uum_accn2415.xml,80444/xv66748,0,1,1,2
"Joseph S. Peery papers",uum_accn2452.xml,80444/xv18954,0,2,0,2
"James May reminiscences",uum_accn1113.xml,80444/xv18493,0,0,2,2
"Edward Morris Whitesides papers",uum_accn0723.xml,80444/xv14120,0,0,2,2
"William B. Smart papers",uum_ms0575.xml,80444/xv54910,0,0,2,2
"Plitt Intermountain Theaters collection",uum_accn0867.xml,80444/xv84301,0,2,0,2
"Carey Call papers",uum_accn0265.xml,80444/xv32736,1,0,1,2
"Virginia P. Frobes collection",uum_ms0599.xml,80444/xv07019,2,0,0,2
"Sylvia Eugenia Nilsen papers",uum_accn1244.xml,80444/xv31149,0,2,0,2
"Lorenzo Hoopes papers",uum_accn1745.xml,80444/xv74307,1,0,1,2
"Frank Whitney photograph collection",uum_p0405.xml,80444/xv02655,1,1,0,2
"Stephen B. Smith papers",uum_accn2841.xml,80444/xv30691,0,2,0,2
"Glen M. Vernon papers",uum_accn1545.xml,80444/xv93914,0,0,2,2
"Ann Mousley Cannon photograph collection",uum_p0293.xml,80444/xv55947,0,2,0,2
"Harold Schindler papers",uum_accn1202.xml,80444/xv79626,1,0,1,2
"Utah Scottish Association records",uum_accn0262.xml,80444/xv25732,1,1,0,2
"Edward B. Ferguson papers",uum_accn1903.xml,80444/xv56222,0,2,0,2
"Deedee Corradini papers",uum_accn2024.xml,80444/xv31973,1,1,0,2
"Pi Epsilon Phi scrapbook",uum_acc0428.xml,80444/xv46890,0,1,1,2
"Walter Hahn papers",uum_accn1136.xml,80444/xv92391,0,0,2,2
"William Robinson family papers",uum_accn1290.xml,80444/xv24441,0,0,2,2
"Gustive O. Larson articles",uum_ms0078.xml,80444/xv24420,2,0,0,2
"Barbara Newbold manuscript",uum_accn2719.xml,80444/xv13870,0,2,0,2
"Christian Anselmes Orlob papers",uum_accn2378.xml,80444/xv06387,0,0,2,2
"University of Utah Faculty Emeritus Club meeting minutes and treasurer's reports",uum_acc0064.xml,80444/xv93975,2,0,0,2
"Virginia Bennion Buchanan papers",uum_accn2422.xml,80444/xv02230,2,0,0,2
"Gosiute Indian photograph collection",uum_p0074.xml,80444/xv85052,2,0,0,2
"Ella Mae Donohoo Bills papers",uum_ms0291.xml,80444/xv45510,2,0,0,2
"Frank Kikuhei and Yoshiko Shibuya Endo papers",uum_accn2352.xml,80444/xv96704,1,1,0,2
"Brigham Henry Roberts photograph collection",uum_p0106.xml,80444/xv19311,1,1,0,2
"Cheves Walling papers",uum_accn1236.xml,80444/xv47473,1,0,1,2
"Robert Gardner papers",uum_ms0190.xml,80444/xv12396,0,2,0,2
"Christian Schneider papers",uum_accn1761.xml,80444/xv87307,1,1,0,2
"University of Utah Center for Ethnic Student Affairs meeting minutes",uum_acc0086.xml,80444/xv90560,2,0,0,2
"Ole Pettit photograph collection",uum_p0087.xml,80444/xv15447,1,1,0,2
"Perry E. Brocchus photograph collection",uum_p0150.xml,80444/xv33151,0,2,0,2
"Bingham Consolidated Mining and Smelting Company records",uum_accn1258.xml,80444/xv13088,1,0,1,2
"Daniel and Amanda Bradley Henrie papers",uum_ms0046.xml,80444/xv81481,0,0,2,2
"Robert Smith photograph collection",uum_p0395.xml,80444/xv15435,0,0,2,2
"Tuesday Study Club photograph collection",uum_p0572.xml,80444/xv34280,1,0,1,2
"Vardis Fisher papers",uum_ms0401.xml,80444/xv48849,0,2,0,2
"Richard Nelson Jones papers",uum_accn2045.xml,80444/xv41018,0,0,2,2
"Salt Lake City public schools collection",uum_accn1602.xml,80444/xv04150,1,0,1,2
"University of Utah Student Broadcast Council meeting minutes",uum_acc0101.xml,80444/xv56390,0,2,0,2
"University of Utah Institutional Funds Committee meeting minutes",uum_acc0114.xml,80444/xv99771,0,2,0,2
"Mt. Harris, Colorado, history project records",uum_accn1027.xml,80444/xv65740,0,2,0,2
"Community Action Program records",uum_ms0460.xml,80444/xv73251,0,2,0,2
"Elliott Organick photograph collection",uum_p0431.xml,80444/xv32592,0,2,0,2
"Parley Pratt Nelson papers",uum_accn1880.xml,80444/xv13220,0,2,0,2
"Anand A. Yang papers",uum_accn1978.xml,80444/xv90579,0,0,2,2
"Gibb R. Madsen photograph collection",uum_p1477.xml,80444/xv51333,2,0,0,2
"Douglas R. Stringfellow papers",uum_accn0606.xml,80444/xv21868,0,1,1,2
"Stephen Lythgoe Bradford papers",uum_accn1982.xml,80444/xv72113,0,2,0,2
"Indian Self-Rule oral histories",uum_accn2186.xml,80444/xv13787,0,2,0,2
"Hinckley Institute of Politics records",uum_acc0544.xml,80444/xv85617,1,1,0,2
"University of Utah Summer School Office records",uum_acc0313.xml,80444/xv06393,0,2,0,2
"Jeffrey P. Davis papers",uum_accn1901.xml,80444/xv88507,0,2,0,2
"Dan Miller papers",uum_accn2506.xml,80444/xv54275,0,0,2,2
"Martin Zwick papers",uum_accn1277.xml,80444/xv27078,0,1,1,2
"H. W. Isaacson letter",uum_accn2772.xml,80444/xv14840,0,0,2,2
"Alvin L. Gittins papers",uum_acc0376.xml,80444/xv96417,1,1,0,2
"Millard F. Malin photograph collection",uum_p0177.xml,80444/xv83233,0,0,2,2
"Steven K. Madsen papers",uum_accn1703.xml,80444/xv95657,2,0,0,2
"Horace Willis Higgs papers",uum_accn2275.xml,80444/xv89016,0,1,1,2
"Greek railroad workers records",uum_accn2083.xml,80444/xv18395,1,1,0,2
"White Horse Prophecy collection",uum_accn2249.xml,80444/xv90454,0,0,2,2
"Joseph Peck photograph collection",uum_p0231.xml,80444/xv44317,0,0,2,2
"University of Utah Media Services records",uum_acc0433.xml,80444/xv91906,0,2,0,2
"Utah Federation of the Council for Exceptional Children records",uum_ms0456.xml,80444/xv33709,2,0,0,2
"Frank E. Schefski papers",uum_accn2215.xml,80444/xv30612,0,1,1,2
"Alan Conway Ashton papers",uum_accn1037.xml,80444/xv66149,0,0,2,2
"John Mason Boutwell papers",uum_accn2277.xml,80444/xv78060,0,1,1,2
"University of Utah Graduate School of Education records",uum_acc0498.xml,80444/xv12561,0,2,0,2
"University of Utah Office of Public Relations press releases",uum_acc0181.xml,80444/xv98358,0,2,0,2
"National Copper Bank of Salt Lake City records",uum_accn2220.xml,80444/xv24438,2,0,0,2
"Vontella Hess Bucholz Kimball photograph collection",uum_p0093.xml,80444/xv57479,2,0,0,2
"Saburo Shimomura papers",uum_accn2355.xml,80444/xv68286,1,0,1,2
"Chauncey L. Thornburg papers",uum_accn1889.xml,80444/xv59259,1,0,1,2
"Lily Park Stock Growing Association records",uum_accn0616.xml,80444/xv36816,0,2,0,2
"University of Utah Special Events Center Committee records",uum_acc0126.xml,80444/xv51275,0,1,1,2
"University of Utah Department of Information Systems and Communications records",uum_acc0487.xml,80444/xv80804,1,1,0,2
"Ralph Dudley and Florence Louise Dimm Cowan family papers",uum_accn2457.xml,80444/xv08956,1,1,0,2
"Pro-Utah photograph collection",uum_p0016.xml,80444/xv41394,2,0,0,2
"University of Utah Department of Geography records",uum_acc0429.xml,80444/xv73733,0,2,0,2
"Utah Labor Archives photograph collection",uum_p0032.xml,80444/xv09100,1,0,1,2
"Allen D. Marler papers",uum_accn1376.xml,80444/xv23095,2,0,0,2
"Harley Murray oral history interview",uum_accn0561.xml,80444/xv98538,0,2,0,2
"University of Utah Department of Psychology records",uum_acc0142.xml,80444/xv76312,0,1,1,2
"David Cornelius Hess papers",uum_accn2080.xml,80444/xv74346,0,0,2,2
"Earl E. Olson speech",uum_ms0320.xml,80444/xv53002,1,0,1,2
"Friends of the Marriott Library records",uum_accn0795.xml,80444/xv19149,2,0,0,2
"National Communication Association records",uum_ms0673.xml,80444/xv87200,1,1,0,2
"Shauna McLatchy Adix papers",uum_accn0811.xml,80444/xv17327,0,2,0,2
"University of Utah University Counseling Center reports",uum_acc0085.xml,80444/xv67532,2,0,0,2
"Utah Engineering Experiment Station records",uum_acc0210.xml,80444/xv61279,0,1,1,2
"Mitsuhiro Endo papers",uum_accn2454.xml,80444/xv49114,0,0,2,2
"C. A. Robertson papers",uum_ms0526.xml,80444/xv30349,2,0,0,2
"Jean Saubert papers",uum_accn0223.xml,80444/xv72769,0,0,2,2
"Irvin K. Luker papers",uum_accn2662.xml,80444/xv53198,0,0,2,2
"University of Utah Vice President for Budget and Planning Office Report on dance companies associated with the university",uum_acc0103.xml,80444/xv04650,0,2,0,2
"University of Utah Department of Biochemical Pharmacology and Toxicology records",uum_acc0431.xml,80444/xv07098,1,1,0,2
"University of Utah Graduate School of Education records",uum_acc0449.xml,80444/xv80398,0,1,1,2
"Holy Cross Hospital Auxiliary records",uum_accn1606.xml,80444/xv56082,0,2,0,2
"University of Utah Associate Academic Vice President records",uum_acc0407.xml,80444/xv63253,0,1,1,2
"Agnes Mero Plenk papers",uum_accn1585.xml,80444/xv74771,0,0,2,2
"Frederic Rowland Marvin papers",uum_accn2331.xml,80444/xv86737,2,0,0,2
"Bruce A. Crane papers",uum_accn2196.xml,80444/xv24468,0,0,2,2
"Sterling M. McMurrin photograph collection",uum_p0433.xml,80444/xv25146,2,0,0,2
"Paul K. Evans papers",uum_accn2624.xml,80444/xv66848,0,1,1,2
"Lettie Dewey Campbell papers",uum_accn1724.xml,80444/xv29159,0,0,2,2
"Park City West records",uum_ms0544.xml,80444/xv71209,0,0,2,2
"Newton's Principia exhibition records",uum_accn1032.xml,80444/xv30624,0,0,2,2
"American Mining Company records",uum_accn1377.xml,80444/xv89764,0,0,2,2
"Salt Lake Oratorio Society records",uum_ms0602.xml,80444/xv26452,0,2,0,2
"Lorenz Fuellenbach papers",uum_accn0342.xml,80444/xv94119,0,0,2,2
"Milton H. Sevy speech",uum_ms0403.xml,80444/xv82141,0,0,2,2
"Valora P. Treshow papers",uum_accn0803.xml,80444/xv05636,0,2,0,2
"Steven Pecchia-Bekkum independent film collection",uum_a0773.xml,80444/xv62652,0,0,2,2
"Nate Rockwood independent film collection",uum_a0804.xml,80444/xv66265,0,0,2,2
"Barry Lynn papers",uum_ms0183.xml,80444/xv20053,2,0,0,2
"Historical Sketch of Salt Lake Valley and Watershed",uum_accn2802.xml,80444/xv67288,2,0,0,2
"William Treseder papers",uum_accn1848.xml,80444/xv12582,1,0,1,2
"Chicano Mobile Institute records",uum_acc0345.xml,80444/xv45687,0,1,1,2
"Don L. Lind papers",uum_accn1525.xml,80444/xv14303,0,0,2,2
"John Soule photograph collection",uum_p0172.xml,80444/xv21798,0,2,0,2
"Elizabeth Haglund papers",uum_accn0681.xml,80444/xv41864,0,2,0,2
"Richard Gabriel Rummonds papers",uum_accn2171.xml,80444/xv13064,1,1,0,2
"Duchesne County records",uum_accn2032.xml,80444/xv66772,0,0,2,2
"Paul G. Christean papers",uum_accn2738.xml,80444/xv82669,2,0,0,2
"J.K. Moore papers",uum_accn2239.xml,80444/xv48703,0,0,2,2
"David Orton Maxfield photograph collection",uum_p1478.xml,80444/xv73593,0,0,2,2
"E. H. Crowdee diary",uum_accn1098.xml,80444/xv81265,2,0,0,2
"World War II memorabilia collection",uum_ms0433.xml,80444/xv71450,0,0,2,2
"Alta Ski Resort records",uum_accn1414.xml,80444/xv70599,0,0,2,2
"Utah coins and tokens collection",uum_accn1569.xml,80444/xv05664,0,0,2,2
"Leland M. Perry papers",uum_accn0980.xml,80444/xv22863,0,0,2,2
"John Jasper McClellan papers",uum_accn1999.xml,80444/xv00225,0,2,0,2
"Edward P. Jennings papers",uum_ms0101.xml,80444/xv43841,1,1,0,2
"Political clippings collection",uum_accn1104.xml,80444/xv58938,0,0,2,2
"James H. Skinner papers",uum_accn0609.xml,80444/xv96975,1,1,0,2
"American Institute of Chemical Engineers Great Salt Lake Section records",uum_accn0825.xml,80444/xv98278,0,0,2,2
"University of Utah Athletic Board meeting minutes",uum_acc0104.xml,80444/xv08505,0,2,0,2
"Martin S. Lindsay diary",uum_ms0420.xml,80444/xv44195,0,0,2,2
"Daughters of the American Revolution, Princess Timpanogos Chapter records",uum_accn1526.xml,80444/xv43020,1,1,0,2
"Arthur Wheelock Moulton certificate",uum_accn2528.xml,80444/xv69302,1,0,1,2
"University of Utah General Education Executive Council records",uum_acc0113.xml,80444/xv35379,0,2,0,2
"Alton Crane Melville papers",uum_accn1723.xml,80444/xv67025,0,1,1,2
"Ogden writer's series papers",uum_accn0926.xml,80444/xv17950,0,0,2,2
"Joel Rosenberg audio collection",uum_a0246.xml,80444/xv66851,1,0,1,2
"Algie Ballif Forum records",uum_ms0545.xml,80444/xv16320,1,0,1,2
"Dame-McBride family papers",uum_ms0515.xml,80444/xv44070,1,0,1,2
"Genevieve Lawrence papers",uum_accn1110.xml,80444/xv45571,2,0,0,2
"William Adams papers",uum_accn1011.xml,80444/xv31326,0,0,2,2
"Edward Wyer family papers",uum_accn2532.xml,80444/xv84793,1,1,0,2
"Julianne Hinz papers",uum_accn2783.xml,80444/xv27770,1,0,1,2
"Francis Urry photograph collection",uum_p0543.xml,80444/xv61471,0,2,0,2
"Albert King Thurber papers",uum_accn2110.xml,80444/xv75848,0,0,2,2
"Russell L. Bragg papers",uum_accn1955.xml,80444/xv63546,0,1,1,2
"O. Meredith Wilson papers",uum_ms0389.xml,80444/xv37573,0,0,2,2
"James John Brophy photograph collection",uum_p0579.xml,80444/xv40893,0,2,0,2
"University of Utah Faculty Club records",uum_acc0111.xml,80444/xv60778,0,2,0,2
"Iranian Rural Improvement Program records",uum_acc0209.xml,80444/xv27877,0,2,0,2
"Ray Briem papers",uum_accn2728.xml,80444/xv15432,0,2,0,2
"David Baddley independent film collection",uum_a0806.xml,80444/xv25756,0,0,2,2
"Cordell Wolking independent film collection",uum_a0764.xml,80444/xv38262,0,0,2,2
"Eliza R. Snow papers",uum_ms0313.xml,80444/xv24618,0,1,1,2
"J. Douglas Swenson papers",uum_accn1998.xml,80444/xv73480,0,2,0,2
"Todd I. Berens papers",uum_ms0491.xml,80444/xv96154,0,1,1,2
"Utah Peace and Freedom Party records",uum_accn1572.xml,80444/xv96139,0,0,2,2
"Perpetual Emigrating Fund Company receipt book",uum_ms0138.xml,80444/xv68038,0,0,2,2
"University of Utah courses offered with a class size of ten or less for the year ended June 30, 1968",uum_acc0062.xml,80444/xv72433,2,0,0,2
"George P. Lee papers",uum_accn1112.xml,80444/xv61599,2,0,0,2
"G. Bennett Larson papers",uum_ms0444.xml,80444/xv83880,0,2,0,2
"Ski Utah Associates records",uum_accn1415.xml,80444/xv56491,0,0,2,2
"Platte De Alton Lyman papers",uum_ms0065.xml,80444/xv88186,2,0,0,2
"Sylvester Mowry papers",uum_accn2326.xml,80444/xv28244,2,0,0,2
"University of Utah Long-Range Planning Office records",uum_acc0287.xml,80444/xv03024,0,2,0,2
"American Association of University Professors records",uum_acc0189.xml,80444/xv90255,0,2,0,2
"Western Union Telegraph Company letterbook",uum_accn0387.xml,80444/xv94955,0,2,0,2
"University of Utah College of Engineering faculty meeting minutes",uum_acc0073.xml,80444/xv99804,2,0,0,2
"Mining photograph collection",uum_p0189.xml,80444/xv01629,0,2,0,2
"Irving Jerome "Izzy" Wagner papers",uum_accn2164.xml,80444/xv02801,0,0,2,2
"Dan Steffen papers",uum_accn1741.xml,80444/xv33505,1,1,0,2
"Roy D. Tea papers",uum_accn2765.xml,80444/xv64526,2,0,0,2
"Dan Milton Hughes Wilcox papers",uum_accn2429.xml,80444/xv26278,0,2,0,2
"Toronto, Joseph B. photograph collection",uum_p0179.xml,80444/xv38009,2,0,0,2
"New West Education Commission records",uum_ms0637.xml,80444/xv68829,0,0,2,2
"H. E. Garrett notebook",uum_accn2576.xml,80444/xv91870,0,2,0,2
"University of Utah Women's Club records",uum_acc0138.xml,80444/xv66137,0,2,0,2
"Wayne Owens photograph collection",uum_p0108.xml,80444/xv77203,1,1,0,2
"Seiko Arakaki papers",uum_accn2152.xml,80444/xv40417,0,1,1,2
"University of Utah Division of Continuing Education records",uum_acc0257.xml,80444/xv05609,0,2,0,2
"Waldemar Van Cott Young papers",uum_ms0238.xml,80444/xv43710,0,2,0,2
"Proposed ski resort site plans",uum_accn1254.xml,80444/xv34918,2,0,0,2
"Park City Ski Area photograph archives",uum_p0384.xml,80444/xv04724,0,0,2,2
"Edward Ray photograph collection",uum_p0165.xml,80444/xv97354,0,0,2,2
"Robert Anderson papers",uum_ms0573.xml,80444/xv80001,0,0,2,2
"Mineral Flat Mining Company cash book",uum_accn0291.xml,80444/xv50521,0,2,0,2
"Glenn Walker Wallace photograph collection",uum_p0401.xml,80444/xv12744,1,1,0,2
"Richard Nebeker papers",uum_accn1574.xml,80444/xv16854,0,0,2,2
"Marianne T. Watson papers",uum_accn1960.xml,80444/xv48089,1,1,0,2
"Utah Symphony photograph collection",uum_p0166.xml,80444/xv20166,0,0,2,2
"John Franklin Wright papers",uum_accn1915.xml,80444/xv47451,2,0,0,2
"Richard D. Westwood papers",uum_accn2742.xml,80444/xv14260,0,2,0,2
"Benjamin Roland Lewis photograph collection",uum_p0137.xml,80444/xv51300,0,1,1,2
"University of Utah Department of Biology records",uum_acc0249.xml,80444/xv08346,0,2,0,2
"R. A. Hart papers",uum_accn2259.xml,80444/xv75756,0,0,2,2
"George Pruce Simson photograph collection",uum_p0298.xml,80444/xv05776,0,2,0,2
"Barbara Yamada papers",uum_accn1250.xml,80444/xv80767,0,0,2,2
"Redick N. Allred autobiography",uum_ms0088.xml,80444/xv80548,0,2,0,2
"Military photograph collection",uum_p0057.xml,80444/xv84594,2,0,0,2
"University of Utah Committees records",uum_acc0049.xml,80444/xv55184,2,0,0,2
"University of Utah Curriculum Policy Review Board records",uum_acc0109.xml,80444/xv23645,0,2,0,2
"Harold Woodmansee Bentley folklore papers",uum_ms0624.xml,80444/xv22552,0,0,2,2
"Mining company records",uum_accn1163.xml,80444/xv29309,0,0,2,2
"Sumner Chase Cobb papers",uum_accn2434.xml,80444/xv32904,1,0,1,2
"E. Kay Hanks papers",uum_accn2449.xml,80444/xv63064,0,2,0,2
"University of Utah Campus Art Advisory Committee meeting minutes and correspondence",uum_acc0102.xml,80444/xv90457,0,2,0,2
"Dept. of English Records",uum_acc0419.xml,80444/xv76742,0,2,0,2
"Bernard DeVoto papers",uum_accn2688.xml,80444/xv20544,0,1,1,2
"Lou Lorenz papers",uum_accn1644.xml,80444/xv29751,1,0,1,2
"S. J. Sedgewick papers",uum_accn1271.xml,80444/xv23880,0,0,2,2
"Isaac Albert Smoot papers",uum_accn1145.xml,80444/xv90347,2,0,0,2
"Utah Humanities Research Foundation Photograph Collection",uum_p0044.xml,80444/xv89688,2,0,0,2
"W. P. Armstrong general merchandise account book",uum_accn0874.xml,80444/xv51379,0,0,2,2
"Renee Marchant Rampton autobiography",uum_accn2838.xml,80444/xv51281,1,1,0,2
"Norman Carlyle Tarbox papers",uum_accn1663.xml,80444/xv37591,0,1,1,2
"N. W. Tanner papers",uum_accn0929.xml,80444/xv98907,0,0,2,2
"University of Utah Council of Faculty Advisors meeting minutes",uum_acc0110.xml,80444/xv95007,0,2,0,2
"Milo Andrus photograph collection",uum_p0132.xml,80444/xv82476,0,0,2,2
"Kenilworth (Utah) architectural drawings and history",uum_accn0921.xml,80444/xv50711,0,0,2,2
"Scottish Rite Temple records",uum_accn1535.xml,80444/xv37872,0,0,2,2
"Augustus Locke papers",uum_accn2289.xml,80444/xv45617,2,0,0,2
"George S. Tanner photograph collection",uum_p0034.xml,80444/xv93139,1,1,0,2
"Chi Omega Alumnae Association records",uum_accn1289.xml,80444/xv51715,0,2,0,2
"Spencer, Bill photograph collection",uum_p0424.xml,80444/xv95523,0,2,0,2
"Robert Temple papers",uum_accn2678.xml,80444/xv22814,1,0,1,2
"Manuscript history of the church",uum_ms0643.xml,80444/xv19677,2,0,0,2
"Phi Delta Theta fraternity certificate",uum_accn2552.xml,80444/xv82214,0,0,2,2
"Salt Lake Council of Women records",uum_accn1069.xml,80444/xv89099,0,0,2,2
"LeGrand G. Van Uitert papers",uum_accn0973.xml,80444/xv01113,0,2,0,2
"Utah Federation of Women's Clubs records",uum_ms0558.xml,80444/xv27154,1,1,0,2
"Floyd O'Neal photograph collection",uum_p0429.xml,80444/xv03179,2,0,0,2
"Harry Nelson photograph collection",uum_p0585.xml,80444/xv16711,2,0,0,2
"William Bryam Pace autobiography",uum_accn0875.xml,80444/xv86666,0,0,2,2
"Spruces Ski Area photograph collection",uum_p0386.xml,80444/xv86114,0,0,2,2
"Union Light and Power Company records",uum_accn2172.xml,80444/xv97521,0,2,0,2
"Henry Rampton diary typescript",uum_accn0987.xml,80444/xv39056,0,1,1,2
"Patrick G. Coy papers",uum_accn1657.xml,80444/xv00784,0,2,0,2
"Big Cottonwood Canyon Association records",uum_accn1727.xml,80444/xv32662,0,0,2,2
"Frederick Hoffman Wood papers",uum_accn1603.xml,80444/xv97702,1,0,1,2
"Richard D. Wallin papers",uum_accn2363.xml,80444/xv92437,0,0,2,2
"George C. Hatch papers",uum_accn2692.xml,80444/xv54879,0,2,0,2
"John Eugene Seaich papers",uum_accn1633.xml,80444/xv43002,0,0,2,2
"George Forstner Harding papers",uum_accn1986.xml,80444/xv48672,0,0,2,2
"Alfred A. Rordame papers",uum_accn2236.xml,80444/xv39419,0,2,0,2
"Carol L. Clark papers",uum_accn2758.xml,80444/xv91241,0,1,1,2
"Darrell Duggan papers",uum_accn2831.xml,80444/xv90463,1,0,1,2
"University of Utah Administrative Vice President's Office Fort Douglas land records",uum_acc0335.xml,80444/xv89566,0,2,0,2
"Zane Witcher Keating oral history interview",uum_accn0260.xml,80444/xv77905,0,0,2,2
"Margaret Louise Smith papers",uum_accn2605.xml,80444/xv96121,1,0,1,2
"Utah Parent Teacher Association records",uum_accn1221.xml,80444/xv34402,0,2,0,2
"West Jordan Threshing photograph collection",uum_p0195.xml,80444/xv24282,0,2,0,2
"University of Utah Division of International Education records",uum_acc0251.xml,80444/xv36553,0,2,0,2
"University of Utah Office of International Education records",uum_acc0468.xml,80444/xv02624,0,1,1,2
"James Taylor Harwood papers",uum_ms0507.xml,80444/xv08413,0,2,0,2
"Stephanie Young Merzel photograph collection",uum_p1205.xml,80444/xv05789,0,2,0,2
"Henry Earl Havenor papers",uum_ms0173.xml,80444/xv59805,0,0,2,2
"Wallace L. Williams papers",uum_accn1612.xml,80444/xv99746,2,0,0,2
"Jack Warren Keuffel papers",uum_accn0935.xml,80444/xv48449,0,0,2,2
"Ezra C. Dalby papers",uum_accn2438.xml,80444/xv84561,0,2,0,2
"University of Utah Academic Policy and Advisory Committee meeting minutes and reports",uum_acc0099.xml,80444/xv25338,0,2,0,2
"H. Leo Marshall papers",uum_ms0286.xml,80444/xv60906,1,1,0,2
"Guy R. McKay papers",uum_ms0669.xml,80444/xv33908,0,0,2,2
"Jerry R. Andersen papers",uum_accn1798.xml,80444/xv95791,2,0,0,2
"George W. Teasdale papers",uum_accn1508.xml,80444/xv58563,0,0,2,2
"Brad Mauss papers",uum_accn2409.xml,80444/xv94937,2,0,0,2
"University of Utah Media Services KUER license application",uum_acc0154.xml,80444/xv21774,0,1,1,2
"Veterans of Foreign Wars (VFW) Atomic Post 4355 records",uum_accn1552.xml,80444/xv95819,0,0,2,2
"University of Utah Graduate School correspondence and memoranda",uum_acc0439.xml,80444/xv26797,0,1,1,2
"J. Boyer Jarvis papers",uum_accn2167.xml,80444/xv26315,0,2,0,2
"Vladimir Ussachevsky scores",uum_accn1151.xml,80444/xv52859,2,0,0,2
"Karen Ericksen papers",uum_accn1976.xml,80444/xv57431,0,2,0,2
"Lorraine Sevcovic papers",uum_ms0346.xml,80444/xv00204,0,0,2,2
"University of Utah Division of Continuing Education Model United Nations records",uum_acc0247.xml,80444/xv48620,1,1,0,2
"Glen Canyon Action Network records",uum_accn1805.xml,80444/xv31625,0,0,1,1
"Ora Lee Knecht correspondence",uum_accn1607.xml,80444/xv04263,0,1,0,1
"Henry P. Plenk papers",uum_accn1450.xml,80444/xv98559,0,0,1,1
"Bernice Cook papers",uum_accn1464.xml,80444/xv22457,0,0,1,1
"Rasmussen's Ranch photograph collection",uum_p0380.xml,80444/xv41845,0,1,0,1
"Daniel McElroy papers",uum_accn0293.xml,80444/xv72006,1,0,0,1
"Franklin E. Smith papers",uum_ms0280.xml,80444/xv09304,0,0,1,1
"Stanley David and June Kremer Lyman photograph collection",uum_p0181.xml,80444/xv35058,0,1,0,1
"Hyrum B. Calder papers",uum_accn1730.xml,80444/xv27566,1,0,0,1
"American West Center research projects records",uum_accn1939.xml,80444/xv47729,0,0,1,1
"Utah State Board of Regents records",uum_acc0323.xml,80444/xv37274,0,1,0,1
"University of Utah Graduate School of Education reports",uum_acc0174.xml,80444/xv50573,0,1,0,1
"J. Willard and Alice Sheets Marriott audio-visual collection",uum_a0164.xml,80444/xv02584,0,0,1,1
"Benjamin Willmore papers",uum_accn1669.xml,80444/xv55392,0,1,0,1
"University of Utah Department of Materials Science and Engineering list of graduates from 1947 until 1977",uum_acc0190.xml,80444/xv62994,0,1,0,1
"Ballet programs collection",uum_accn1390.xml,80444/xv76419,1,0,0,1
"Salt Lake Olympic Bid Committee records",uum_accn1267.xml,80444/xv46701,1,0,0,1
"Virgil Pershing Howe papers",uum_accn1971.xml,80444/xv89825,0,0,1,1
"Alpha Lambda Delta records",uum_acc0223.xml,80444/xv48852,0,1,0,1
"Thomas F. Dougherty photograph collection",uum_p0565.xml,80444/xv19903,0,0,1,1
"William Lang papers",uum_accn1519.xml,80444/xv86035,1,0,0,1
"Nauvoo High Council records",uum_accn2109.xml,80444/xv14697,0,0,1,1
"Richard W. Jackson article",uum_accn2314.xml,80444/xv79910,0,0,1,1
"Orson Spencer letter",uum_accn1518.xml,80444/xv85272,0,1,0,1
"Antonio A. Feliz papers",uum_accn0173.xml,80444/xv68487,1,0,0,1
"University of Utah Controller's Office records",uum_acc0378.xml,80444/xv71612,0,1,0,1
"Alice Lovina Manning papers",uum_accn2102.xml,80444/xv88479,0,1,0,1
"Richard Leveridge Hoxie notebooks",uum_accn2396.xml,80444/xv73626,0,1,0,1
"Utah Cherry Blossom Princesses records",uum_accn2377.xml,80444/xv33633,0,0,1,1
"Consortium for Utah Women in Higher Education records",uum_accn1531.xml,80444/xv46478,0,0,1,1
"Non-Utah Skiing photograph collection",uum_p0390.xml,80444/xv75759,0,1,0,1
"University of Utah Health Sciences Center Medical Center history project records",uum_acc0442.xml,80444/xv46005,0,1,0,1
"Northern Utah Scenery photograph collection",uum_p0241.xml,80444/xv51144,0,1,0,1
"Robert Harris Fife papers",uum_accn2087.xml,80444/xv18292,1,0,0,1
"Grand Lodge of Utah, Independent Order of Odd Fellows records",uum_accn0615.xml,80444/xv06301,0,1,0,1
"Thomas A. Leishman papers",uum_accn1740.xml,80444/xv23281,0,1,0,1
"Faith Terasawa papers",uum_accn1473.xml,80444/xv27124,0,1,0,1
"Ann Wechsler papers",uum_accn2358.xml,80444/xv60784,0,1,0,1
"Laura Christensen McCurdy Clark papers",uum_ms0372.xml,80444/xv71731,0,1,0,1
"Thomas Widdop autobiography",uum_ms0476.xml,80444/xv05438,0,1,0,1
"University of Utah Vice President for Academic Affairs academic department budget requests,",uum_acc0406.xml,80444/xv83914,0,1,0,1
"Harold T. Christensen photograph collection",uum_p0266.xml,80444/xv56658,0,0,1,1
"Preston and Helen Strobeck Linford papers",uum_accn2072.xml,80444/xv20202,0,1,0,1
"Leon Laizer Watters papers",uum_accn1273.xml,80444/xv42324,0,0,1,1
"Dakota Chase Hyde papers",uum_accn2776.xml,80444/xv82373,1,0,0,1
"Mildred Harris Olson papers",uum_accn0942.xml,80444/xv25286,1,0,0,1
"Sugarhouse Garden Club records",uum_accn2423.xml,80444/xv59997,0,1,0,1
"John Parker papers",uum_ms0519.xml,80444/xv56185,0,0,1,1
"Salt Lake Association of Community Councils records",uum_accn2282.xml,80444/xv26312,0,0,1,1
"Maxwell Myer Wintrobe photograph collection",uum_p0331.xml,80444/xv31884,1,0,0,1
"Jonathan Coleman papers",uum_accn1337.xml,80444/xv98733,0,1,0,1
"E. Lee Lasater papers",uum_accn1666.xml,80444/xv42343,1,0,0,1
"Beaver Combination Mining records",uum_accn0712.xml,80444/xv77825,0,1,0,1
"Richard Whitehead Young photograph collection",uum_p0104.xml,80444/xv29220,1,0,0,1
"Paul Thatcher family papers",uum_ms0198.xml,80444/xv93890,0,0,1,1
"Fredrick A. Carleson papers",uum_accn1813.xml,80444/xv65093,0,1,0,1
"University of Utah Medical Center Patient Relations Office records",uum_acc0248.xml,80444/xv62005,0,1,0,1
"Edward Girard Hale papers",uum_ms0653.xml,80444/xv83865,0,0,1,1
"Toshia Akai papers",uum_accn2225.xml,80444/xv60760,0,0,1,1
"Paul W. Hodson papers",uum_ms0554.xml,80444/xv77374,0,1,0,1
"Joseph Lee Robinson papers",uum_accn2162.xml,80444/xv33969,0,1,0,1
"George Snell photograph collection",uum_p0152.xml,80444/xv74896,1,0,0,1
"Neils S. and Ellen Gibson Smith Larsen family papers",uum_accn2295.xml,80444/xv12780,0,1,0,1
"W. J. Goodwin papers",uum_accn0957.xml,80444/xv15011,0,1,0,1
"Tenth Mountain Division photograph collection",uum_p0399.xml,80444/xv10122,0,0,1,1
"Cheves Walling photograph collection",uum_p0534.xml,80444/xv75582,0,0,1,1
"Park City Consolidated Mines Company reports and statements",uum_accn1178.xml,80444/xv75497,0,0,1,1
"Utah State Junior Chamber of Commerce photograph collection",uum_p0098.xml,80444/xv08938,1,0,0,1
"Elsie Ross Whittaker photograph collection",uum_p0533.xml,80444/xv98870,0,1,0,1
"Silver Reef, Utah photograph collection",uum_p0232.xml,80444/xv55480,0,0,1,1
"Brent Baker collection",uum_accn2499.xml,80444/xv42556,0,1,0,1
"William Luck journal",uum_ms0161.xml,80444/xv68658,0,1,0,1
"Sarah Rosella Derrick Sorensen papers",uum_accn2145.xml,80444/xv19351,0,0,1,1
"Edwin Evans papers",uum_accn1326.xml,80444/xv04870,1,0,0,1
"Frederic W. Ganzert papers",uum_acc0368.xml,80444/xv80395,0,1,0,1
"Wayne Richards photograph collection",uum_p0502.xml,80444/xv76184,0,0,1,1
"Emil L. Smith papers",uum_accn1008.xml,80444/xv25534,0,1,0,1
"Canyons resort records",uum_accn2026.xml,80444/xv86706,0,1,0,1
"Barrick Resources collection",uum_accn1527.xml,80444/xv09777,1,0,0,1
"Kurt Randolph Wegner diary",uum_accn1232.xml,80444/xv19052,0,1,0,1
"Nihon Matsuri records",uum_accn2750.xml,80444/xv38024,0,0,1,1
"Sigmund and Emma Helwing photograph collection",uum_p0155.xml,80444/xv68710,0,0,1,1
"Z.C.M.I. Main Street store facade report",uum_ms0568.xml,80444/xv52078,0,0,1,1
"Barbara Stewart Anderson photograph collection",uum_p1309.xml,80444/xv77688,0,1,0,1
"Steve Clegg papers",uum_accn2048.xml,80444/xv98944,1,0,0,1
"Eleanor C. W. Jarvis papers",uum_ms0030.xml,80444/xv41482,0,1,0,1
"James D. Still Mormon history collection",uum_accn1591.xml,80444/xv32894,0,0,1,1
"Lester Andrews Hubbard collection",uum_ms0158.xml,80444/xv83743,0,0,1,1
"University of Utah Industrial Services Division records",uum_acc0310.xml,80444/xv44766,0,1,0,1
"Hinckley Institute of Politics records",uum_acc0359.xml,80444/xv97705,0,1,0,1
"Notebook of collected quotations",uum_accn2846.xml,80444/xv26531,0,0,1,1
"Alfred Jones photograph collection",uum_p0548.xml,80444/xv52600,0,0,1,1
"Fred Lewis Markham papers",uum_accn1784.xml,80444/xv12600,0,0,1,1
"University of Utah Physical Plant and Operations Office records",uum_acc0352.xml,80444/xv25051,0,1,0,1
"Clifford C. Snyder papers",uum_accn1099.xml,80444/xv23535,1,0,0,1
"Emigration Office records",uum_accn2701.xml,80444/xv46807,1,0,0,1
"Barbara Bailey Hales papers",uum_accn1654.xml,80444/xv60162,0,1,0,1
"Eugene W. Whitaker's KZN radio collection",uum_accn1767.xml,80444/xv04940,0,0,1,1
"University of Utah Health Sciences Center Volunteer Auxiliary annual reports",uum_acc0438.xml,80444/xv53909,0,1,0,1
"George Numbers papers",uum_accn1847.xml,80444/xv12615,1,0,0,1
"American Issues Forum records",uum_acc0201.xml,80444/xv90664,0,1,0,1
"Isaac K. Russell papers",uum_accn1568.xml,80444/xv53057,1,0,0,1
"James Edward Talmage papers",uum_ms0304.xml,80444/xv57192,0,1,0,1
"Fred M. Oliver papers",uum_accn0831.xml,80444/xv66052,0,1,0,1
"The Wild Bunch photograph collection",uum_p0168.xml,80444/xv21701,0,0,1,1
"Jesse A. Walter papers",uum_accn2286.xml,80444/xv51330,0,1,0,1
"Rockville, Utah photograph collection",uum_p0080.xml,80444/xv18444,1,0,0,1
"Casey Buxton fliers and clippings",uum_accn1908.xml,80444/xv39663,0,0,1,1
"Claudius Y. Gates papers",uum_accn1589.xml,80444/xv78100,1,0,0,1
"University of Utah Registrar's Office Faculty schedules",uum_acc0177.xml,80444/xv69552,0,1,0,1
"David Oscar Kirk diary",uum_ms0317.xml,80444/xv34906,1,0,0,1
"Geffery R. Pollock collection",uum_accn2014.xml,80444/xv27627,0,1,0,1
"Rhett Stephens James papers",uum_ms0265.xml,80444/xv47351,1,0,0,1
"Brother Juniper's Tales on Navajoland typescript",uum_ms0266.xml,80444/xv44583,0,0,1,1
"Cottonwood Club Ski Program records",uum_accn2223.xml,80444/xv88833,0,0,1,1
"Utah Geological and Mineralogical Survey records",uum_acc0281.xml,80444/xv15692,0,1,0,1
"University of Utah Publications Council records",uum_acc0480.xml,80444/xv11853,0,1,0,1
"Phi Beta Kappa, Alpha of Utah records",uum_accn1787.xml,80444/xv28866,0,0,1,1
"David Jabusch papers",uum_accn2310.xml,80444/xv45266,1,0,0,1
"William Engel Millner oral history",uum_accn2321.xml,80444/xv78353,0,1,0,1
"Charles Elliott Dibble papers",uum_accn1371.xml,80444/xv01269,0,0,1,1
"Town Club records",uum_accn0790.xml,80444/xv55688,1,0,0,1
"Gerald Folsom papers",uum_accn2602.xml,80444/xv47909,0,0,1,1
"Walter Cottam slide collection",uum_p0007.xml,80444/xv50247,0,1,0,1
"Glen Canyon Institute records",uum_accn1671.xml,80444/xv38421,0,0,1,1
"University of Utah Vice President for Special Projects records",uum_acc0161.xml,80444/xv67846,0,1,0,1
"Utah Issues records",uum_accn2463.xml,80444/xv97860,0,0,1,1
"Shipler Studio papers",uum_accn1910.xml,80444/xv21661,0,1,0,1
"Occidental Hotel ledger",uum_accn1543.xml,80444/xv39706,1,0,0,1
"Lavina Fielding Anderson papers",uum_accn2204.xml,80444/xv60409,1,0,0,1
"Jack Walker photograph collection",uum_p0409.xml,80444/xv28536,1,0,0,1
"Calder Richards Consulting Engineers records",uum_accn2189.xml,80444/xv17901,0,1,0,1
"Idaho Stage Company ledger",uum_accn0273.xml,80444/xv05502,1,0,0,1
"University of Utah Department of Educational Studies records",uum_acc0466.xml,80444/xv28225,0,1,0,1
"Mignon H. Olive collection of University of Utah lecture audio recordings",uum_a1091.xml,80444/xv76516,0,0,1,1
"Society of the Sigma Xi charter",uum_acc0461.xml,80444/xv03231,0,1,0,1
"Provo bishops' meeting minutes",uum_ms0399.xml,80444/xv20764,0,0,1,1
"University of Utah Coordinator of Veterans Office correspondence and statistics",uum_acc0244.xml,80444/xv79928,0,1,0,1
"Josh Roberts advertisements and interview",uum_accn1902.xml,80444/xv20574,0,0,1,1
"Eugene H. Merrill papers",uum_accn1090.xml,80444/xv21072,0,0,1,1
"John McChrystal Wallace and William Ross Wallace papers",uum_accn1140.xml,80444/xv83288,0,1,0,1
"Christopher Strong uniform collection",uum_accn2680.xml,80444/xv51873,0,0,1,1
"Mitchell H. Kline papers",uum_accn1463.xml,80444/xv93902,0,1,0,1
"Terry Tempest Williams portrait photograph",uum_p0714.xml,80444/xv82125,0,0,1,1
"Bernard Z. Kastler papers",uum_accn0532.xml,80444/xv23913,1,0,0,1
"Pat Bagley papers",uum_accn2176.xml,80444/xv74789,0,1,0,1
"Lethe Coleman Tatje papers",uum_accn1187.xml,80444/xv15884,0,0,1,1
"Institute of the North American West records",uum_accn1293.xml,80444/xv09384,0,1,0,1
"M. Donald Thomas papers",uum_accn2312.xml,80444/xv80764,0,0,1,1
"Bernie A. Rhodes papers",uum_accn1268.xml,80444/xv07745,0,0,1,1
"Genevieve Atwood papers",uum_accn1217.xml,80444/xv60681,0,0,1,1
"Clarence Stevenson photograph collection",uum_p0718.xml,80444/xv84088,0,1,0,1
"Woody Anderson papers",uum_accn1233.xml,80444/xv60275,0,1,0,1
"University of Utah Graduate School of Social Work faculty meeting minutes and newsletters",uum_acc0168.xml,80444/xv18542,0,1,0,1
"Ida Mae Hanks papers",uum_accn1762.xml,80444/xv88830,0,0,1,1
"University of Utah Office of Research Administration correspondence and reports",uum_acc0269.xml,80444/xv95898,0,1,0,1
"Walker Brothers papers",uum_ms0080.xml,80444/xv59246,1,0,0,1
"Virginia Kelson papers",uum_accn1275.xml,80444/xv58422,1,0,0,1
"Anti-lynching petition collection",uum_accn2766.xml,80444/xv11114,0,0,1,1
"S. George Ellsworth speech",uum_accn0552.xml,80444/xv65863,0,0,1,1
"Karl Banks papers",uum_ms0263.xml,80444/xv14126,0,0,1,1
"Utah voting records",uum_accn0805.xml,80444/xv98471,0,1,0,1
"University of Utah Center for Public Affairs and Administration records",uum_acc0515.xml,80444/xv76943,0,1,0,1
"William Lee Stokes photograph collection",uum_p0529.xml,80444/xv85089,0,1,0,1
"University of Utah Department of Chemical Engineering correspondence and research proposals",uum_acc0414.xml,80444/xv92608,0,1,0,1
"Trent Harris papers",uum_accn2175.xml,80444/xv85485,1,0,0,1
"Elmina Shepard Taylor diary",uum_accn1362.xml,80444/xv29388,0,0,1,1
"Bingham and Garfield Railway Company records",uum_accn1922.xml,80444/xv09863,0,1,0,1
"Harry Thorsen article",uum_accn0685.xml,80444/xv69717,0,0,1,1
"Utah State Building Board University of Utah physical facility surveys",uum_acc0341.xml,80444/xv38366,0,1,0,1
"Utah Federation of Business and Professional Women's Club photograph collection",uum_p0352.xml,80444/xv20483,0,1,0,1
"Harold G. Reynolds papers",uum_accn1343.xml,80444/xv09649,0,0,1,1
"Alpine Mountain Club photograph collection",uum_p0010.xml,80444/xv95858,1,0,0,1
"Glade Peterson photograph collection",uum_p0587.xml,80444/xv75500,1,0,0,1
"Mineralogical Society of Utah records",uum_accn1198.xml,80444/xv60095,1,0,0,1
"Mark D. Thomas papers",uum_accn2637.xml,80444/xv59631,0,1,0,1
"Clyde L. Miller papers",uum_ms0571.xml,80444/xv26947,0,0,1,1
"Reed Smoot papers",uum_ms0449.xml,80444/xv17926,0,0,1,1
"Henry Clifford and Harriet Leona Myrup Hanson certificate",uum_accn2188.xml,80444/xv70721,0,1,0,1
"Americanism Up Front Seminar participant materials",uum_accn1093.xml,80444/xv25805,0,0,1,1
"Leland Bruderer papers",uum_accn2270.xml,80444/xv68884,1,0,0,1
"Barry Scholl papers",uum_accn1842.xml,80444/xv41519,0,1,0,1
"University of Utah Board of Trustees meeting minutes",uum_acc0430.xml,80444/xv28152,0,1,0,1
"Clara Jenseon Myers papers",uum_ms0590.xml,80444/xv38845,0,1,0,1
"James Sweeney oral history",uum_accn1869.xml,80444/xv06066,1,0,0,1
"H. Bowman Hawkes papers",uum_accn1238.xml,80444/xv81967,0,1,0,1
"Tomoko Ogi Moses papers",uum_accn2625.xml,80444/xv45495,1,0,0,1
"Alonzo Laker and Alice Maude Osmond Cook papers",uum_accn2163.xml,80444/xv98837,0,1,0,1
"Collection of University of Utah ephemera",uum_acc0436.xml,80444/xv64840,0,1,0,1
"Markham family histories",uum_accn1120.xml,80444/xv49578,0,1,0,1
"University of Utah Office of Research Administration monthly reports",uum_acc0123.xml,80444/xv48498,0,1,0,1
"Canyon Lodge Free and Accepted Masons of Utah certificate",uum_accn2490.xml,80444/xv38259,0,1,0,1
"William E. Rice papers",uum_accn2174.xml,80444/xv68005,0,0,1,1
"Constance Luprille Dillon papers",uum_accn2573.xml,80444/xv47628,0,1,0,1
"Ronald and Ilene Kingsbury papers",uum_ms0522.xml,80444/xv42248,1,0,0,1
"Alan L. Davis papers",uum_accn2138.xml,80444/xv84902,0,0,1,1
"Hurschell G. Urie manuscript",uum_accn1158.xml,80444/xv16101,0,0,1,1
"University of Utah College of Medicine self-study",uum_acc0292.xml,80444/xv59378,0,1,0,1
"Cecil W. Warren tribute by Edith Rich",uum_accn0584.xml,80444/xv53936,0,1,0,1
"Dorothy Taylor Moore property title",uum_accn2523.xml,80444/xv05352,0,0,1,1
"James L. Clayton papers",uum_accn2733.xml,80444/xv46524,0,0,1,1
"Jarvie Store Excavation Report photograph collection",uum_p0012.xml,80444/xv59048,0,0,1,1
"Dallas Wayne Nichol papers",uum_accn2195.xml,80444/xv34033,0,0,1,1
"Muster roll of steward, wardmaster, cooks, nurses, and matrons attached to the hospital of the Tenth Regiment of Infantry, Camp Floyd",uum_accn2806.xml,80444/xv83569,1,0,0,1
"J. K. Whitney correspondence",uum_ms0344.xml,80444/xv99411,0,0,1,1
"Anne M. Cook papers",uum_accn2829.xml,80444/xv76287,0,0,1,1
"Nevada photograph collection",uum_p0227.xml,80444/xv49862,0,1,0,1
"Friends of Gilgal Garden Audio-Visual Collection",uum_a0008.xml,80444/xv74279,1,0,0,1
"Tim DeChristopher protest collection",uum_accn2739.xml,80444/xv61856,1,0,0,1
"Daly-Judge Mining Company records",uum_accn1731.xml,80444/xv51434,0,1,0,1
"Alan E. Brockbank photograph collection",uum_p0359.xml,80444/xv32513,0,0,1,1
"Alfred Richins Jones papers",uum_accn1375.xml,80444/xv30401,0,1,0,1
"Alberta Henry photograph collection",uum_p1158.xml,80444/xv30120,0,1,0,1
"John M. Baldwin papers",uum_accn0761.xml,80444/xv27740,0,0,1,1
"Emerson R. Bailey papers",uum_ms0218.xml,80444/xv32870,0,1,0,1
"Utah State Board of Regents memoranda and reports",uum_acc0324.xml,80444/xv60113,0,1,0,1
"Bruce H. Jensen article",uum_accn0445.xml,80444/xv88769,0,1,0,1
"Scandinavian Conference and Reunion programs",uum_ms0644.xml,80444/xv17263,0,0,1,1
"Cleveland Smith Larsen papers",uum_accn2300.xml,80444/xv80276,1,0,0,1
"Lowell Jackson Thomas papers",uum_accn2591.xml,80444/xv73971,0,0,1,1
"Baha'i Faith of Salt Lake City records",uum_accn1052.xml,80444/xv86788,0,1,0,1
"Bluff, Utah photograph collection",uum_p0214.xml,80444/xv10311,1,0,0,1
"Frank F. Wipper papers",uum_accn2364.xml,80444/xv38970,1,0,0,1
"Charles A. Knight papers",uum_accn1665.xml,80444/xv94216,0,1,0,1
"Pleasant View Irrigation Company ledger",uum_accn2475.xml,80444/xv30035,0,0,1,1
"Ann Mousley Cannon papers",uum_ms0565.xml,80444/xv13320,0,1,0,1
"John T. Edward papers",uum_accn1710.xml,80444/xv95214,0,0,1,1
"George and Yasuko Yasuda papers",uum_accn2235.xml,80444/xv66796,0,1,0,1
"Joseph A. Geddes papers",uum_ms0347.xml,80444/xv67715,0,0,1,1
"Zion Evangelical Lutheran Church records",uum_accn1050.xml,80444/xv05783,0,0,1,1
"Insurance industry collection",uum_accn0865.xml,80444/xv33422,0,0,1,1
"David Kranes papers",uum_accn2450.xml,80444/xv83483,0,1,0,1
"Robert Van Nostrand papers",uum_accn0216.xml,80444/xv07565,0,1,0,1
"Floyd Garn Hatch papers",uum_accn0510.xml,80444/xv38616,1,0,0,1
"Joe J. Davich papers",uum_accn0405.xml,80444/xv67684,0,1,0,1
"Babcock Performing Readers records",uum_accn1927.xml,80444/xv30630,0,0,1,1
"University of Utah Teaching Fellows Advisory Committee memoranda",uum_acc0128.xml,80444/xv65908,0,1,0,1
"Avenues Street Fair records",uum_accn2746.xml,80444/xv93209,0,0,1,1
"Helen Bowring Ure papers",uum_accn1116.xml,80444/xv75033,0,1,0,1
"Utah Opera Company records",uum_accn1215.xml,80444/xv79055,1,0,0,1
"United States Geological Survey Coal lands survey records",uum_ms0210.xml,80444/xv46453,0,1,0,1
"Paul Robbins Papers",uum_accn2477.xml,80444/xv45098,0,0,1,1
"Henry B. Thompson diaries",uum_accn1743.xml,80444/xv62966,1,0,0,1
"Ellis L. Armstrong papers",uum_accn0367.xml,80444/xv05520,0,1,0,1
"John R. Wendel papers",uum_accn2137.xml,80444/xv34692,0,0,1,1
"Zella Skidmore McEntire papers",uum_accn1883.xml,80444/xv86392,1,0,0,1
"Walter C. Christensen cartoons",uum_accn0826.xml,80444/xv87380,1,0,0,1
"Sharon Keigher papers",uum_ms0270.xml,80444/xv49563,0,0,1,1
"Max Zimmer papers",uum_accn1725.xml,80444/xv50518,1,0,0,1
"Price City, Utah photograph collection",uum_p0229.xml,80444/xv22399,0,1,0,1
"Utah history collection",uum_accn0362.xml,80444/xv42840,0,0,1,1
"Dorothy Harvey papers",uum_accn2232.xml,80444/xv33157,1,0,0,1
"Charles Smith Merrill papers",uum_accn2299.xml,80444/xv93328,0,0,1,1
"Gary Horlacher papers",uum_accn2549.xml,80444/xv67315,0,0,1,1
"John R. Park papers",uum_ms0242.xml,80444/xv69485,1,0,0,1
"William C. Seifrit papers",uum_accn0735.xml,80444/xv12771,0,0,1,1
"Frederick Quinn papers",uum_accn2136.xml,80444/xv63421,0,1,0,1
"Daniel Hadlond Thomas papers",uum_accn1515.xml,80444/xv00900,1,0,0,1
"Harold T. Christensen papers",uum_accn0715.xml,80444/xv60531,0,1,0,1
"Sandra Kellogg Sutton papers",uum_accn1452.xml,80444/xv19998,1,0,0,1
"University of Utah Department of Plastic Surgery records",uum_acc0470.xml,80444/xv70520,0,1,0,1
"Francis W. Christensen papers",uum_accn1320.xml,80444/xv10736,0,1,0,1
"Exchange Club of Salt Lake City records",uum_accn1667.xml,80444/xv25640,0,1,0,1
"Council for Exceptional Children photograph collection",uum_p0153.xml,80444/xv15893,1,0,0,1
"Edwin Frederick Pike papers",uum_accn2648.xml,80444/xv02716,0,1,0,1
"Organization for Research on Women and Communications records",uum_accn2128.xml,80444/xv51290,0,0,1,1
"John F. Sytsma papers",uum_accn2402.xml,80444/xv41497,0,1,0,1
"Rotisserie Inn records",uum_accn2484.xml,80444/xv48950,0,0,1,1
"Eva A. Paxman papers",uum_ms0337.xml,80444/xv10140,0,0,1,1
"D. Michael Quinn papers",uum_accn0581.xml,80444/xv45751,0,1,0,1
"Myron L. and Lucille P. Sutton papers",uum_accn1763.xml,80444/xv76083,1,0,0,1
"Regnal W. Garff papers",uum_accn2063.xml,80444/xv06109,0,0,1,1
"Annette R. Dinwoodey papers",uum_accn0728.xml,80444/xv10601,0,1,0,1
"University of Utah Center for Historical Population Studies research records",uum_acc0443.xml,80444/xv22280,0,1,0,1
"Reba Lou Keele papers",uum_accn2368.xml,80444/xv05557,0,0,1,1
"State Arboretum of Utah records",uum_acc0339.xml,80444/xv70559,0,1,0,1
"Phi Chi Theta scrapbooks",uum_acc0415.xml,80444/xv22689,0,1,0,1
"Elizabeth R. Hayes papers",uum_accn2018.xml,80444/xv95184,0,1,0,1
"Danny L. Jorgensen papers",uum_accn2276.xml,80444/xv36080,1,0,0,1
"Dean May photograph collection",uum_p0553.xml,80444/xv12405,0,0,1,1
"Red Butte Garden and Arboretum records",uum_acc0528.xml,80444/xv62683,0,1,0,1
"Marriott Employees Staff Association (MESA) records",uum_accn1153.xml,80444/xv65704,0,0,1,1
"A. S. U. U. records",uum_acc0469.xml,80444/xv26779,0,1,0,1
"Wild Utah Project records",uum_accn2693.xml,80444/xv24002,1,0,0,1
"Sidney S. Fox photograph collection",uum_p0041.xml,80444/xv79467,1,0,0,1
"Abraham Alonzo Kimball journals",uum_accn2092.xml,80444/xv17437,1,0,0,1
"Ben Bullough papers",uum_accn1721.xml,80444/xv14605,1,0,0,1
"Irving H. Cohen papers",uum_accn0222.xml,80444/xv88168,1,0,0,1
"Archaeological and paleontological exploration project records",uum_ms0215.xml,80444/xv09103,0,1,0,1
"University of Utah Department of Chemistry records",uum_acc0458.xml,80444/xv67990,0,1,0,1
"Donald Ray Hall papers",uum_accn2001.xml,80444/xv32171,1,0,0,1
"Gordon Taylor and Florence Ivins Hyde papers",uum_ms0459.xml,80444/xv66488,0,0,1,1
"Ezra Clark Knowlton papers",uum_accn0389.xml,80444/xv90707,0,1,0,1
"Wood Hagenbarth Cattle Company records",uum_accn2647.xml,80444/xv23556,0,0,1,1
"University of Utah Department of Family and Community Medicine Hypertension Detection and Follow-Up Program records",uum_acc0405.xml,80444/xv79922,0,1,0,1
"Prisoners for conscience sake list",uum_accn0381.xml,80444/xv50366,0,0,1,1
"Berten Wendell Allred papers",uum_ms0216.xml,80444/xv58380,0,1,0,1
"Julia Brixen Bertoch papers",uum_accn1766.xml,80444/xv50955,0,0,1,1
"Junius S. Romney papers",uum_ms0546.xml,80444/xv97634,0,1,0,1
"Bingham Canyon collection",uum_accn1712.xml,80444/xv45645,0,0,1,1
"Eugene Merrill photograph collection",uum_p0363.xml,80444/xv66122,0,0,1,1
"John R. Winder papers",uum_accn2229.xml,80444/xv96765,1,0,0,1
"Charles L. Bernheimer expedition field notes",uum_accn0553.xml,80444/xv07290,1,0,0,1
"Amos Batchelder diary",uum_accn1085.xml,80444/xv18347,0,0,1,1
"David C. Knowlton papers",uum_accn1438.xml,80444/xv48162,1,0,0,1
"William John Todd NASA patch collection",uum_accn2548.xml,80444/xv64926,0,1,0,1
"University of Utah Board of Trustees meeting minutes",uum_acc0422.xml,80444/xv52288,0,1,0,1
"Richard E. Westwood papers",uum_ms0121.xml,80444/xv14883,0,1,0,1
"Jesse Lee Gilmore papers",uum_accn2245.xml,80444/xv20278,0,1,0,1
"Utah Engineering Experiment Station annual report",uum_acc0151.xml,80444/xv45068,0,1,0,1
"University of Utah Division of Continuing Education Women's Programs records",uum_acc0440.xml,80444/xv77459,0,1,0,1
"Charles R. and Jane A. Thompsen World War II airplane gunner films",uum_a0094.xml,80444/xv19213,0,0,1,1
"Frederick W. Cagle Jr. papers",uum_accn1620.xml,80444/xv86175,1,0,0,1
"George A. Meyer article",uum_ms0377.xml,80444/xv38247,0,0,1,1
"Mitchell Melich papers",uum_accn2050.xml,80444/xv50717,0,0,1,1
"Lawrence Scanlan papers",uum_ms0434.xml,80444/xv61254,0,1,0,1
"Neighborhood House photograph collection",uum_p0145.xml,80444/xv27984,1,0,0,1
"John A. Compton family papers",uum_ms0314.xml,80444/xv17419,0,0,1,1
"University of Utah Graduate School of Social Work accreditation and research records",uum_acc0255.xml,80444/xv33789,0,1,0,1
"University of Utah College of Medicine certificates",uum_acc0141.xml,80444/xv33926,0,1,0,1
"Intermountain-Pacific Rim Trade Project records",uum_acc0536.xml,80444/xv88668,0,1,0,1
"Samuel and Rosetta Livermore Smith family papers",uum_ms0027.xml,80444/xv71322,0,0,1,1
"Sol J. Selvin papers",uum_ms0489.xml,80444/xv23153,0,1,0,1
"University of Utah Public Relations Office records",uum_acc0083.xml,80444/xv25375,0,1,0,1
"Orson Winso Israelsen papers",uum_accn2269.xml,80444/xv84777,1,0,0,1
"Marriott Library records",uum_accn1138.xml,80444/xv40344,0,0,1,1
"James Blazzard family history",uum_accn0596.xml,80444/xv94323,0,1,0,1
"Standley Hunter Rich photograph collection",uum_p0020.xml,80444/xv31848,0,1,0,1
"James L. Lords papers",uum_acc0537.xml,80444/xv51745,0,1,0,1
"David Leigh Clark papers",uum_accn1819.xml,80444/xv98928,0,0,1,1
"Howard Campbell Price papers",uum_accn0947.xml,80444/xv72656,0,1,0,1
"Susan Wintrobe Walker papers",uum_accn2568.xml,80444/xv48623,0,0,1,1
"Joseph Young papers",uum_ms0054.xml,80444/xv92861,0,0,1,1
"Creighton Grant King papers",uum_accn2440.xml,80444/xv11508,1,0,0,1
"Yanbu Branch history",uum_accn1637.xml,80444/xv67172,0,1,0,1
"Louis E. Holley papers",uum_ms0235.xml,80444/xv21917,0,1,0,1
"Anthony and Herbert Schwartz papers",uum_accn2787.xml,80444/xv80291,0,0,1,1
"Orson W. Huntsman papers",uum_ms0069.xml,80444/xv10052,0,1,0,1
"University of Utah Liberal Education Council meeting minutes and reports",uum_acc0331.xml,80444/xv27636,0,1,0,1
"Florence McClellan Sheets papers",uum_accn1690.xml,80444/xv87145,0,1,0,1
"Elbert Thomas photograph collection",uum_p0003.xml,80444/xv56924,0,1,0,1
"University of Utah School of Mines and Mineral Industries status report",uum_acc0153.xml,80444/xv80407,0,1,0,1
"John and Bertha Clinton papers",uum_accn1165.xml,80444/xv16036,0,0,1,1
"Edward Partridge Jr. diaries",uum_ms0628.xml,80444/xv51684,0,1,0,1
"Rich Varga articles",uum_accn1904.xml,80444/xv42294,0,0,1,1
"Orson Pratt certificate",uum_ms0312.xml,80444/xv18328,0,1,0,1
"University of Utah University Battalion report books",uum_acc0136.xml,80444/xv38046,0,1,0,1
"William Wheeler papers",uum_ms0079.xml,80444/xv09869,0,0,0,0
"George W. Reed papers",uum_ms0184.xml,80444/xv08422,0,0,0,0
"Joseph Cannon papers",uum_accn1427.xml,80444/xv94378,0,0,0,0
"Hugh Olander papers",uum_accn1056.xml,80444/xv99533,0,0,0,0
"Orson Hyde papers",uum_ms0193.xml,80444/xv43264,0,0,0,0
"Morgan County history collection",uum_ms0396.xml,80444/xv73858,0,0,0,0
"Sarah "Sally" Cousins Elliott papers",uum_accn2428.xml,80444/xv68951,0,0,0,0
"William Rhodes ski clippings collection",uum_accn1643.xml,80444/xv60675,0,0,0,0
"Luther E. Eggersten papers",uum_accn1857.xml,80444/xv00201,0,0,0,0
"Adams-Matheson family biographies",uum_accn0392.xml,80444/xv00711,0,0,0,0
"Wilson H. Dusenberry papers",uum_ms0019.xml,80444/xv81011,0,0,0,0
"Teton Dam Disaster photograph collection",uum_p0211.xml,80444/xv66128,0,0,0,0
"Howard Tracy Hall papers",uum_accn2013.xml,80444/xv02102,0,0,0,0
"William Allen papers",uum_ms0404.xml,80444/xv56369,0,0,0,0
"Emma Kofler Helwing papers",uum_ms0155.xml,80444/xv23864,0,0,0,0
"Jerry Andersch papers",uum_accn1856.xml,80444/xv55923,0,0,0,0
"Great Buffalo Mining Company records",uum_accn1387.xml,80444/xv24072,0,0,0,0
"Utah Hairdressers Association records",uum_accn1826.xml,80444/xv82165,0,0,0,0
"Mike Ivers collection",uum_ms0370.xml,80444/xv14532,0,0,0,0
"Ladies of the Grand Army of the Republic records",uum_accn2771.xml,80444/xv01434,0,0,0,0
"Ronald B. DeWaal papers",uum_accn2263.xml,80444/xv26449,0,0,0,0
"John Oakley letter book",uum_accn1270.xml,80444/xv19906,0,0,0,0
"Joseph M. Locke papers",uum_accn1582.xml,80444/xv80380,0,0,0,0
"Danel W. Bachman papers",uum_ms0260.xml,80444/xv31576,0,0,0,0
"Joseph A. Young journal",uum_ms0233.xml,80444/xv99896,0,0,0,0
"Leslie Emsden photograph collection",uum_p1572.xml,80444/xv75292,0,0,0,0
"Argentine Mining Company records",uum_accn2804.xml,80444/xv36700,0,0,0,0
"William H. Smart diaries",uum_accn0276.xml,80444/xv08953,0,0,0,0
"Utah Heritage Foundation photograph collection",uum_p0274.xml,80444/xv17724,0,0,0,0
"Ray Miller photograph collection",uum_p1302.xml,80444/xv74310,0,0,0,0
"Forace George Green papers",uum_accn1503.xml,80444/xv72918,0,0,0,0
"The Utah Opera Company photograph collection",uum_p0550.xml,80444/xv41232,0,0,0,0
"Knights of Pythias records",uum_accn2003.xml,80444/xv26614,0,0,0,0
"Byron McGrath papers",uum_accn2529.xml,80444/xv85562,0,0,0,0
"First Congregational Church records",uum_accn0943.xml,80444/xv47695,0,0,0,0
"Karen Hale papers",uum_accn2336.xml,80444/xv68923,0,0,0,0
"Stirling Mining Company records",uum_accn0269.xml,80444/xv98141,0,0,0,0
"Utah Order of Women Legislators records",uum_ms0152.xml,80444/xv65792,0,0,0,0
"Lucius Marsden Durham papers",uum_accn1587.xml,80444/xv57257,0,0,0,0
"Salt Lake City Chamber of Commerce records",uum_accn0854.xml,80444/xv20211,0,0,0,0
"Luretta Young papers",uum_accn1060.xml,80444/xv14862,0,0,0,0
"Claude B. Morris papers",uum_accn2173.xml,80444/xv48056,0,0,0,0
"Biography of the Jensen-Lauritzen families",uum_accn0537.xml,80444/xv72314,0,0,0,0
"Alpine Training School scrapbook",uum_accn1645.xml,80444/xv35070,0,0,0,0
"Santa Clara Seep Ditch Company ledger",uum_accn2800.xml,80444/xv31365,0,0,0,0
"Jack E. Thomas papers",uum_accn2445.xml,80444/xv43582,0,0,0,0
"James Missey papers",uum_accn1746.xml,80444/xv35162,0,0,0,0
"Utah Flood Survey photograph collection",uum_p0208.xml,80444/xv01162,0,0,0,0
"Native Born prophecy",uum_ms0402.xml,80444/xv11679,0,0,0,0
"Califia Books records",uum_accn2086.xml,80444/xv22747,0,0,0,0
"Henry Earl Havenor photograph collection",uum_p0173.xml,80444/xv39147,0,0,0,0
"Kirtland Council minute book",uum_accn1618.xml,80444/xv48492,0,0,0,0
"Ora Lee Parthesius papers",uum_accn2170.xml,80444/xv78942,0,0,0,0
"M. M. Steele letter",uum_accn0557.xml,80444/xv75439,0,0,0,0
"University of Utah gymnastics collection",uum_accn2865.xml,80444/xv16571,0,0,0,0
"John B. Fairbanks photograph collection",uum_p0446.xml,80444/xv28497,0,0,0,0
"Green River Mining and Improvement Company records",uum_ms0663.xml,80444/xv96163,0,0,0,0
"Charles I. Wheat papers",uum_accn1106.xml,80444/xv73510,0,0,0,0
"Utah elections collection",uum_ms0464.xml,80444/xv34933,0,0,0,0
"June K. Lyman papers",uum_accn2466.xml,80444/xv61273,0,0,0,0
"Charlotte A. Quinn papers",uum_accn1977.xml,80444/xv36883,0,0,0,0
"Sumner Margetts Company photograph collection",uum_p0519.xml,80444/xv49905,0,0,0,0
"Ted Whitney papers",uum_accn0229.xml,80444/xv70492,0,0,0,0
"Utah Tibetan Association records",uum_accn2493.xml,80444/xv51525,0,0,0,0
"Gustav F. Raaum papers",uum_accn2192.xml,80444/xv88632,0,0,0,0
"Clarice Short papers",uum_accn0893.xml,80444/xv94970,0,0,0,0
"Eight O'Clock Club program",uum_accn2847.xml,80444/xv52783,0,0,0,0
"Durant Whittmore Gullick papers",uum_accn2241.xml,80444/xv70166,0,0,0,0
"Taylor Hyde Merrill photograph collection",uum_p0547.xml,80444/xv34417,0,0,0,0
"Marriott Employees Staff Association (MESA) photograph collection",uum_p0514.xml,80444/xv45907,0,0,0,0
"Helen Clawson Wells papers",uum_ms0257.xml,80444/xv96093,0,0,0,0
"Albert C. Smoot papers",uum_accn2257.xml,80444/xv75540,0,0,0,0
"Camp Floyd collection",uum_ms0191.xml,80444/xv30810,0,0,0,0
"University of Utah AirMed Department records",uum_accn2531.xml,80444/xv13677,0,0,0,0
"Pioneer Craft House records",uum_accn0694.xml,80444/xv16098,0,0,0,0
"Utahns for Effective Government photograph collection",uum_p0262.xml,80444/xv25225,0,0,0,0
"Mining industry scrapbook",uum_ms0214.xml,80444/xv96755,0,0,0,0
"William R. Gould photograph collection",uum_p0525.xml,80444/xv76245,0,0,0,0
"Dale Campbell Le Cheminant papers",uum_accn1315.xml,80444/xv97125,0,0,0,0
"Evelina Lavina Babbitt Cornell papers",uum_accn1374.xml,80444/xv03613,0,0,0,0
"Hudson Bay Company records",uum_accn2803.xml,80444/xv53796,0,0,0,0
"Josephine Streeper Chase papers",uum_ms0151.xml,80444/xv21438,0,0,0,0
"Irving B. McNulty papers",uum_accn1511.xml,80444/xv56271,0,0,0,0
"Alice Hart Osmond papers",uum_accn2161.xml,80444/xv20391,0,0,0,0
"Bartlett Wicks papers",uum_ms0514.xml,80444/xv34298,0,0,0,0
"Bret H. Parker papers",uum_accn2207.xml,80444/xv59750,0,0,0,0
"Scofield Mine Disaster photograph collection",uum_p0187.xml,80444/xv23300,0,0,0,0
"Dorthea R. Sauer papers",uum_accn2248.xml,80444/xv98645,0,0,0,0
"Ludwig Mies van der Rohe commemorative stamp",uum_accn0974.xml,80444/xv21325,0,0,0,0
"Gilbert R. Oberdas papers",uum_ms0383.xml,80444/xv77423,0,0,0,0
"Veteran Ski Instructors Association",uum_accn0214.xml,80444/xv74212,0,0,0,0
"Jean Ann McMurrin thesis",uum_ms0598.xml,80444/xv02136,0,0,0,0
"Orvin Nebeker Malmquist oral history interview",uum_accn0564.xml,80444/xv55108,0,0,0,0
"Robert C. Ecker photograph collection",uum_p1307.xml,80444/xv36968,0,0,0,0
"Mary Henderson essay",uum_accn2413.xml,80444/xv13851,0,0,0,0
"Utah Boys' Choir records",uum_ms0436.xml,80444/xv08843,0,0,0,0
"Bartlett Wicks photograph collection",uum_p0332.xml,80444/xv08316,0,0,0,0
"Nichiren Buddhist Temple photograph collection",uum_p0460.xml,80444/xv74444,0,0,0,0
"American Red Cross Utah Chapter records",uum_accn0876.xml,80444/xv51754,0,0,0,0
"Brigham Young Card papers",uum_accn2037.xml,80444/xv37008,0,0,0,0
"Phil D. Jensen diaries",uum_accn1779.xml,80444/xv21627,0,0,0,0
"Lysle W. Hansen papers",uum_accn2271.xml,80444/xv23684,0,0,0,0
"Amy Toda Meeker papers",uum_accn2764.xml,80444/xv22463,0,0,0,0
"James T. Steel papers",uum_ms0445.xml,80444/xv53820,0,0,0,0
"Southern States Communication Association records",uum_accn1661.xml,80444/xv88787,0,0,0,0
"Highways of the Ancients photograph collection",uum_p0192.xml,80444/xv80859,0,0,0,0
"Mormonism collection",uum_accn0858.xml,80444/xv15106,0,0,0,0
"Utah Sand and Gravel Products Company records",uum_ms0209.xml,80444/xv20367,0,0,0,0
"Joseph M. Locke photograph",uum_p0701.xml,80444/xv96826,0,0,0,0
"Emigration Canyon history records",uum_accn2115.xml,80444/xv54708,0,0,0,0
"Gilead Baptist Church records",uum_accn1131.xml,80444/xv26626,0,0,0,0
"Wyoming Sugar Company records",uum_accn1691.xml,80444/xv34240,0,0,0,0
"Thurman Wilkins correpondence",uum_accn2832.xml,80444/xv59558,0,0,0,0
"Elliott Irving Organick papers",uum_accn0906.xml,80444/xv51116,0,0,0,0
"Philip S. Thacher papers",uum_accn1094.xml,80444/xv93276,0,0,0,0
"Dennis H. Pack papers",uum_accn2405.xml,80444/xv25991,0,0,0,0
"Hugh Nibley papers",uum_ms0353.xml,80444/xv42507,0,0,0,0
"Utah Library Association photograph collection",uum_p0154.xml,80444/xv86325,0,0,0,0
"Halbert S. Greaves essay",uum_accn0536.xml,80444/xv05685,0,0,0,0
"First National Bank of Nephi ledger",uum_accn2007.xml,80444/xv76278,0,0,0,0
"Great Dike Gold Mines Corporation records",uum_accn1744.xml,80444/xv37805,0,0,0,0
"Fawn McKay Brodie photograph collection",uum_p0026.xml,80444/xv77371,0,0,0,0
"Scott G. Kenney photograph collection",uum_p0430.xml,80444/xv87295,0,0,0,0
"Fannie S. Dods photograph collection",uum_p0295.xml,80444/xv44427,0,0,0,0
"Chicano Scholarship Fund records",uum_accn2748.xml,80444/xv24453,0,0,0,0
"Rudolph Hope oral history interview",uum_ms0621.xml,80444/xv65728,0,0,0,0
"Utah Republican State Central Committee photograph collection",uum_p0174.xml,80444/xv34323,0,0,0,0
"Ashby Snow papers",uum_accn2684.xml,80444/xv15133,0,0,0,0
"William and Carrie Bales Martindale papers",uum_accn2153.xml,80444/xv84399,0,0,0,0
"New Klondike Mining Company records",uum_accn0549.xml,80444/xv34802,0,0,0,0
"Elsie Aldrich Edgell papers",uum_accn2398.xml,80444/xv14971,0,0,0,0
"Genteel Gentile photograph collection",uum_p0161.xml,80444/xv81518,0,0,0,0
"E. Keith Eddington papers",uum_accn1045.xml,80444/xv32281,0,0,0,0
"Alpha Lambda Delta records",uum_accn1890.xml,80444/xv83779,0,0,0,0
"Vinzenz Thum diary",uum_accn1159.xml,80444/xv66207,0,0,0,0
"A. Payne Kibbe papers",uum_accn2494.xml,80444/xv86474,0,0,0,0
"Westminster College of Salt Lake City articles of incorporation and amendments",uum_accn0571.xml,80444/xv76547,0,0,0,0
"Political scrapbook",uum_ms0213.xml,80444/xv41952,0,0,0,0
"Thomas S. Kimball papers",uum_accn2343.xml,80444/xv68975,0,0,0,0
"Delta Phi Literary and Debating Society records",uum_ms0058.xml,80444/xv01956,0,0,0,0
"Charles S. Bagley papers",uum_accn1470.xml,80444/xv16055,0,0,0,0
"Boyd Guthrie papers",uum_ms0204.xml,80444/xv91976,0,0,0,0
"William "Bill" Gustave Larson papers",uum_accn2633.xml,80444/xv07116,0,0,0,0
"Henry C. Eddington papers",uum_accn1836.xml,80444/xv52355,0,0,0,0
"Salt Lake County Grower's Association records",uum_accn2652.xml,80444/xv42922,0,0,0,0
"Norma Reynolds Dalby Freestone papers",uum_accn2651.xml,80444/xv89804,0,0,0,0
"Julie Ingeröed autobiography",uum_accn0398.xml,80444/xv14233,0,0,0,0
"Reed A. Stout papers",uum_accn1768.xml,80444/xv17019,0,0,0,0
"Allen-Millo Architectural Associates records",uum_accn2208.xml,80444/xv04187,0,0,0,0
"Kathy Nielson photograph collection",uum_p0706.xml,80444/xv27615,0,0,0,0
"Edward R. Hogan papers",uum_accn0205.xml,80444/xv14767,0,0,0,0
"Nettie Maria Davis Bradford autobiography",uum_accn0583.xml,80444/xv54675,0,0,0,0
"H. Bryon Mock photograph collection",uum_p0297.xml,80444/xv83135,0,0,0,0
"Isaac K. Russell photograph collection",uum_p0715.xml,80444/xv43618,0,0,0,0
"John L. Hilton papers",uum_accn0264.xml,80444/xv28723,0,0,0,0
"J. R. Mahoney papers",uum_accn1923.xml,80444/xv93054,0,0,0,0
"Clarence O. Johnson papers",uum_accn1179.xml,80444/xv34490,0,0,0,0
"Arendje Aerie Visser papers",uum_accn1137.xml,80444/xv69915,0,0,0,0
"Donna Hill papers",uum_accn1451.xml,80444/xv95141,0,0,0,0
"Powell centennial lecture",uum_accn0603.xml,80444/xv61065,0,0,0,0
"Faye Farnsworth Tholen papers",uum_accn2139.xml,80444/xv79980,0,0,0,0
"Marcelle Carver papers",uum_accn1610.xml,80444/xv45117,0,0,0,0
"D. Gill and Nedra Mortenson Warner autobiographies",uum_accn2619.xml,80444/xv38473,0,0,0,0
"Jane Elizabeth Lee Butler journal",uum_ms0129.xml,80444/xv56802,0,0,0,0
"Jesse H. Jameson papers",uum_accn2267.xml,80444/xv24273,0,0,0,0
"Norm Burton papers",uum_accn1814.xml,80444/xv12994,0,0,0,0
"Parley A. Christiansen papers",uum_accn1944.xml,80444/xv49951,0,0,0,0
"Intermountain Conference on Children's Literature records",uum_accn1600.xml,80444/xv26498,0,0,0,0
"Jon Ferguson papers",uum_accn0230.xml,80444/xv04351,0,0,0,0
"M. Lynn Bennion photograph collection",uum_p0455.xml,80444/xv58395,0,0,0,0
"The Hispanic photograph collection",uum_p0557.xml,80444/xv29650,0,0,0,0
"First Unitarian Church photograph collection",uum_p0282.xml,80444/xv22994,0,0,0,0
"Indians of North America collection",uum_ms0425.xml,80444/xv52841,0,0,0,0
"Charles A. Raymond account book",uum_ms0316.xml,80444/xv62527,0,0,0,0
"Council of Fifty manuscript",uum_ms0170.xml,80444/xv44845,0,0,0,0
"VaLois Chipman photograph collection",uum_p0554.xml,80444/xv91516,0,0,0,0
"Utah Film and Video Center poster collection",uum_accn2646.xml,80444/xv51449,0,0,0,0
"Francis M. Treseder photograph collection",uum_p0302.xml,80444/xv20550,0,0,0,0
"Omer Call Stewart photograph collection",uum_p0426.xml,80444/xv90026,0,0,0,0
"Eileen Hallet Stone papers",uum_accn2391.xml,80444/xv51464,0,0,0,0
"Vesta Pierce Crawford photograph collection",uum_p0125.xml,80444/xv79901,0,0,0,0
"Arnold H. Ehlers oral history transcript",uum_accn1495.xml,80444/xv58807,0,0,0,0
"Harry L. Aleson papers",uum_accn1435.xml,80444/xv74060,0,0,0,0
"Mary Allen papers",uum_accn2416.xml,80444/xv53515,0,0,0,0
"Joseph H. Carpenter papers",uum_accn2214.xml,80444/xv22583,0,0,0,0
"Alan Schoenberger papers",uum_accn1935.xml,80444/xv71197,0,0,0,0
"Waldo Midgley papers",uum_accn2038.xml,80444/xv49890,0,0,0,0
"Phillip M. Wright collection",uum_accn2120.xml,80444/xv24444,0,0,0,0
"Prolegomena",uum_ms0166.xml,80444/xv21752,0,0,0,0
"Brighton Ski Resort photograph collection",uum_p0379.xml,80444/xv49853,0,0,0,0
"University of Utah ski team collection",uum_accn2067.xml,80444/xv34783,0,0,0,0
"John Andreas Widstoe portrait photograph",uum_p0707.xml,80444/xv06771,0,0,0,0
"Michigan Communist Party collection",uum_accn2914.xml,80444/xv15203,0,0,0,0
"John Enoch Groberg papers",uum_accn2305.xml,80444/xv91732,0,0,0,0
"Transportation photograph collection",uum_p0180.xml,80444/xv33590,0,0,0,0
"Utah Parents for Gifted and Talented Children records",uum_accn1169.xml,80444/xv29824,0,0,0,0
"Mormon historians and historiography collection",uum_accn0713.xml,80444/xv36480,0,0,0,0
"Big Parade war bond drive collection",uum_accn0892.xml,80444/xv02450,0,0,0,0
"Utah Commitee for American-Soviet Relations records",uum_accn2349.xml,80444/xv98373,0,0,0,0
"M. Neff Smart papers",uum_accn0505.xml,80444/xv79983,0,0,0,0
"Darrell D. Robison papers",uum_accn1662.xml,80444/xv35269,0,0,0,0
"Marriott Library Exhibits Committee records",uum_accn0877.xml,80444/xv08697,0,0,0,0
"Timpanogos Cave National Monument records",uum_accn0978.xml,80444/xv03796,0,0,0,0
"Luella H. Nichols papers",uum_accn1331.xml,80444/xv96679,0,0,0,0
"Ray Iwao and Margine Mutsuko Sako Nagasawa papers",uum_accn2877.xml,80444/xv94943,0,0,0,0
"Frederick Herzberg photograph collection",uum_p0711.xml,80444/xv97442,0,0,0,0
"Tracy Aviary records",uum_ms0371.xml,80444/xv60723,0,0,0,0
"George V. Martin papers",uum_accn0997.xml,80444/xv84005,0,0,0,0
"VaLois S. Chipman papers",uum_accn1323.xml,80444/xv15750,0,0,0,0
"Larry James Warren papers",uum_accn1256.xml,80444/xv74182,0,0,0,0
"Jerry S. Dixon papers",uum_accn2383.xml,80444/xv53881,0,0,0,0
"Oquirrh School photograph collection",uum_p0320.xml,80444/xv74832,0,0,0,0
"William M. Purdy papers",uum_accn1509.xml,80444/xv37265,0,0,0,0
"Nephi Plaster and Manufacturing Company records",uum_accn0119.xml,80444/xv47421,0,0,0,0
"Natalie C. McMurrin papers",uum_accn2307.xml,80444/xv35452,0,0,0,0
"John Johnson Davies autobiography",uum_ms0172.xml,80444/xv70971,0,0,0,0
"Phyllis Southwick papers",uum_accn0971.xml,80444/xv09445,0,0,0,0
"John B. Young papers",uum_accn1738.xml,80444/xv05145,0,0,0,0
"Hattie M. Bellis letter",uum_accn2562.xml,80444/xv84536,0,0,0,0
"Dale Snyder papers",uum_accn2791.xml,80444/xv89923,0,0,0,0
"Goji Kodama papers",uum_accn2168.xml,80444/xv12985,0,0,0,0
"B. William Allred photograph collection",uum_p0216.xml,80444/xv29006,0,0,0,0
"William H. Bowers papers",uum_accn1036.xml,80444/xv15020,0,0,0,0
"John Scott papers",uum_accn1324.xml,80444/xv75448,0,0,0,0
"Ronald E. Poelman papers",uum_ms0457.xml,80444/xv08624,0,0,0,0
"Albert George Brain photograph collection",uum_p0503.xml,80444/xv47357,0,0,0,0
"Salt Lake City Regional/Urban Design Assistance Team (R/UDAT) records",uum_accn2287.xml,80444/xv34359,0,0,0,0
"A. W. Harlan papers",uum_accn0163.xml,80444/xv28067,0,0,0,0
"Great Salt Lake Yacht Club scrapbooks",uum_accn1534.xml,80444/xv60192,0,0,0,0
"Thomas R. Carlson papers",uum_accn1929.xml,80444/xv01632,0,0,0,0
"Fine Arts Club records",uum_accn0939.xml,80444/xv26757,0,0,0,0
"Daisy Rolapp Romney papers",uum_accn2556.xml,80444/xv50469,0,0,0,0
"United Church of Christ Congregational records",uum_ms0600.xml,80444/xv35473,0,0,0,0
"Paul B. Pixton papers",uum_accn2194.xml,80444/xv76455,0,0,0,0
"D.K. Hinkle Alt article",uum_accn2112.xml,80444/xv15835,0,0,0,0
"Gaylon W. Hansen papers",uum_accn1389.xml,80444/xv80639,0,0,0,0
"Duchesne, Utah photograph collection",uum_p0217.xml,80444/xv08819,0,0,0,0
"E. D. Jones papers",uum_accn0972.xml,80444/xv28921,0,0,0,0
"Alonzo P. Kesler papers",uum_accn2479.xml,80444/xv72348,0,0,0,0
"Robert W. Parry photograph collection",uum_p0584.xml,80444/xv73388,0,0,0,0
"Eckankar collection",uum_accn1433.xml,80444/xv39135,0,0,0,0
"Thomas A. Kerr papers",uum_accn1751.xml,80444/xv76989,0,0,0,0
"Beth S. Jarman papers",uum_ms0557.xml,80444/xv47232,0,0,0,0
"George R. Petrie thesis",uum_ms0295.xml,80444/xv92510,0,0,0,0
"Joan Woodbury papers",uum_accn2384.xml,80444/xv06924,0,0,0,0
"Utah Federation of Business and Professional Women's Clubs records",uum_ms0221.xml,80444/xv17776,0,0,0,0
"Milton B. Taylor paper",uum_ms0074.xml,80444/xv97280,0,0,0,0
"Gerald R. Ford proclamation",uum_accn2607.xml,80444/xv72076,0,0,0,0
"W. King Driggs letter",uum_accn0558.xml,80444/xv92568,0,0,0,0
"Joseph Taylor Family Organization records",uum_ms0301.xml,80444/xv97430,0,0,0,0
"Hattie Squier Hines papers",uum_accn2096.xml,80444/xv59802,0,0,0,0
"Utah State Federation of Business and Professional Women photograph collection",uum_p0221.xml,80444/xv60269,0,0,0,0
"Reconnaissance of Kaiparowits",uum_accn0600.xml,80444/xv71560,0,0,0,0
"Whitehead Mercantile Company ledger",uum_accn1162.xml,80444/xv86306,0,0,0,0
"Union, Utah photograph collection",uum_p0237.xml,80444/xv12429,0,0,0,0
"Aloysius S. Church papers",uum_accn2586.xml,80444/xv89508,0,0,0,0
"Child Protection Project",uum_accn2147.xml,80444/xv81527,0,0,0,0
"Beverly Bithell papers",uum_accn0817.xml,80444/xv24914,0,0,0,0
"Samuel Russell papers",uum_accn1316.xml,80444/xv88012,0,0,0,0
"Capitol Hill Community Council records",uum_accn1711.xml,80444/xv33193,0,0,0,0
"Alice Gold and Silver Mine records",uum_accn2408.xml,80444/xv65582,0,0,0,0
"William M. Stewart certificate",uum_accn0380.xml,80444/xv72268,0,0,0,0
"H. A. Strauss papers",uum_accn2181.xml,80444/xv58276,0,0,0,0
"Verna Roberts Jorgensen papers",uum_ms0595.xml,80444/xv48471,0,0,0,0
"<emph render="doublequote">Who has the ball</emph> cartoon by Shoemaker",uum_ms0467.xml,80444/xv70327,0,0,0,0
"George E. Bates papers",uum_accn2206.xml,80444/xv31903,0,0,0,0
"Dinosaur National Monument records",uum_accn0981.xml,80444/xv31442,0,0,0,0
"Christ United Methodist Church records",uum_accn1365.xml,80444/xv98446,0,0,0,0
"Middle East papyrus negative collection",uum_p0191.xml,80444/xv75634,0,0,0,0
"Los Angeles Olympic Games records inventory",uum_accn1749.xml,80444/xv99511,0,0,0,0
"Fullmer Latter union affiliation certificates",uum_accn1068.xml,80444/xv13458,0,0,0,0
"Blake Ostler papers",uum_accn1540.xml,80444/xv11279,0,0,0,0
"Murray Women's Civic Guild records",uum_accn2500.xml,80444/xv59692,0,0,0,0
"John A. Farrell papers",uum_accn0760.xml,80444/xv82394,0,0,0,0
"Judith F Jarrow papers",uum_accn2745.xml,80444/xv74490,0,0,0,0
"Zilla Linford Richards papers",uum_accn2373.xml,80444/xv37042,0,0,0,0
"Zerubbabel Snow diary",uum_ms0071.xml,80444/xv13204,0,0,0,0
"George F. and Florence Shermen Roberts papers",uum_accn2221.xml,80444/xv81649,0,0,0,0
"Rockport General Store account book",uum_accn0221.xml,80444/xv53262,0,0,0,0
"Ruth Peay photograph collection",uum_p0377.xml,80444/xv10791,0,0,0,0
"Don C. Woodward papers",uum_accn2592.xml,80444/xv33514,0,0,0,0
"Darrell J. Greenwell papers",uum_accn0522.xml,80444/xv83358,0,0,0,0
"Harold Moore papers",uum_accn1553.xml,80444/xv31427,0,0,0,0
"Musical heritage of southeastern Idaho collection",uum_accn0669.xml,80444/xv24389,0,0,0,0
"Bruce A. Crane photograph collection",uum_p1310.xml,80444/xv40756,0,0,0,0
"Kingsbury Congregational Church of Vernal records",uum_accn1088.xml,80444/xv74291,0,0,0,0
"George S. Bringhurst papers",uum_accn2264.xml,80444/xv74249,0,0,0,0
"Mary Armstrong Milligan papers",uum_accn1896.xml,80444/xv20715,0,0,0,0
"Larry R. Williams papers",uum_accn2094.xml,80444/xv19241,0,0,0,0
"Louis E. Viko papers",uum_ms0523.xml,80444/xv42303,0,0,0,0
"Isasora Duncan papers",uum_accn1899.xml,80444/xv83032,0,0,0,0
"Sylvan H. Wittwer papers",uum_accn1339.xml,80444/xv59936,0,0,0,0
"A. O. Garrett papers",uum_accn2482.xml,80444/xv92388,0,0,0,0
"ZCMI Choral Society concert programs",uum_accn1641.xml,80444/xv61331,0,0,0,0
"Escalante National Monument proposal collection",uum_accn1715.xml,80444/xv96945,0,0,0,0
"Joseph B. Rosembaum papers",uum_accn1033.xml,80444/xv13467,0,0,0,0
"J. E. Clayton letter",uum_accn0390.xml,80444/xv99475,0,0,0,0
"George B. Spencer papers",uum_accn0187.xml,80444/xv30734,0,0,0,0
"Pearl Jacobsen papers",uum_accn0154.xml,80444/xv33850,0,0,0,0
"Bear Dance poster",uum_accn2509.xml,80444/xv94213,0,0,0,0
"Nancy V. Young papers",uum_ms0411.xml,80444/xv29272,0,0,0,0
"Historic trees of Utah collection",uum_ms0405.xml,80444/xv89233,0,0,0,0
"David Hisato and Tamaki Tsubokura Yamate papers",uum_ms0680.xml,80444/xv21475,0,0,0,0
"Jedediah Foss Woolley Jr. papers",uum_accn1953.xml,80444/xv70758,0,0,0,0
"Robert O. and Bette Richins papers",uum_accn2600.xml,80444/xv99688,0,0,0,0
"Hooper, Eldredge and Company checkbook",uum_accn0896.xml,80444/xv95086,0,0,0,0
"W. Keith Wilson map collection",uum_accn1510.xml,80444/xv23614,0,0,0,0
"University of Utah Department of Medical Biophysics and Computing records",uum_acc0196.xml,80444/xv63632,0,0,0,0
"Bingham Stage Lines collection",uum_ms0330.xml,80444/xv20928,0,0,0,0
"James R. Clark papers",uum_accn2260.xml,80444/xv28176,0,0,0,0
"William Robert Sutherland papers",uum_accn1429.xml,80444/xv59671,0,0,0,0
"Lauretta L. Kidman papers",uum_accn0618.xml,80444/xv75894,0,0,0,0
"Marcia J. Galli papers",uum_accn0619.xml,80444/xv90466,0,0,0,0
"Harold Joseph Egoscue papers",uum_accn1969.xml,80444/xv33660,0,0,0,0
"Virginia Picht papers",uum_accn1166.xml,80444/xv25152,0,0,0,0
"History of the Roosevelt Stake",uum_accn1084.xml,80444/xv78250,0,0,0,0
"Emerson Tippetts papers",uum_accn1058.xml,80444/xv43862,0,0,0,0
"David W. Cummings papers",uum_accn0255.xml,80444/xv42620,0,0,0,0
"Joseph E. Beard papers",uum_accn1344.xml,80444/xv33084,0,0,0,0
"Salt Lake and Utah Railroad Company records",uum_accn2412.xml,80444/xv98327,0,0,0,0
"Railroad time book records",uum_accn2231.xml,80444/xv39910,0,0,0,0
"Boyd Gutherie photograph collection",uum_p0204.xml,80444/xv92260,0,0,0,0
"W. J. Sloan papers",uum_accn0289.xml,80444/xv20385,0,0,0,0
"M. Earl Miller papers",uum_accn1096.xml,80444/xv06494,0,0,0,0
"LeConte Stewart papers",uum_accn1177.xml,80444/xv73690,0,0,0,0
"Pembroke Stationery Company order book",uum_accn1536.xml,80444/xv04501,0,0,0,0
"Mormon puzzle records",uum_accn2031.xml,80444/xv04049,0,0,0,0
"Intermountain Power Project collection",uum_accn1482.xml,80444/xv18096,0,0,0,0
"Jan H. Brunvand photograph collection",uum_p0713.xml,80444/xv21707,0,0,0,0
"Venus Cahoon scrapbook",uum_accn2512.xml,80444/xv30895,0,0,0,0
"Bliss and Campbell architectural drawings",uum_accn2655.xml,80444/xv20358,0,0,0,0
"Hillary W. St. Clair papers",uum_accn2382.xml,80444/xv82308,0,0,0,0
"Harry S. Holcomb papers",uum_accn2315.xml,80444/xv42041,0,0,0,0
"Edina Literary and Debating Society records",uum_ms0059.xml,80444/xv58206,0,0,0,0
"Salt Lake City Library film collection",uum_accn2603.xml,80444/xv17404,0,0,0,0
"V. Mark Sumner report",uum_accn1459.xml,80444/xv47778,0,0,0,0
"Keene Curtis papers",uum_accn1468.xml,80444/xv23629,0,0,0,0
"Douglas Shipley papers",uum_accn2345.xml,80444/xv17816,0,0,0,0
"Robert Starr Waite papers",uum_accn0948.xml,80444/xv05963,0,0,0,0
"Borghild Marie Bergstedt Paulsen autobiography",uum_ms0162.xml,80444/xv15124,0,0,0,0
"Marjorie Chan papers",uum_accn2781.xml,80444/xv51736,0,0,0,0
"LaVerne A. Diehl papers",uum_accn2209.xml,80444/xv49084,0,0,0,0
"Bayard Mendenhall papers",uum_accn0215.xml,80444/xv48727,0,0,0,0
"Jayne Metos Coleman papers",uum_accn2472.xml,80444/xv07379,0,0,0,0
"Nauvoo steel engraving",uum_accn2613.xml,80444/xv16220,0,0,0,0
"Chris Jensen papers",uum_accn0410.xml,80444/xv41329,0,0,0,0
"Letter regarding travel from Chicago to Albuquerque",uum_accn2328.xml,80444/xv49682,0,0,0,0
"Richard K. Behrens papers",uum_accn2226.xml,80444/xv84036,0,0,0,0
"Lowell M. Durham papers",uum_accn0970.xml,80444/xv05047,0,0,0,0
"Craig Gorder photograph collection",uum_p0417.xml,80444/xv76025,0,0,0,0
"Stable ledger",uum_accn0573.xml,80444/xv08065,0,0,0,0
"Mormon History Association records",uum_accn0693.xml,80444/xv01348,0,0,0,0
"Salt Lake Abstract Company title",uum_accn2601.xml,80444/xv94577,0,0,0,0
"Paine brothers mining collection",uum_ms0349.xml,80444/xv48114,0,0,0,0
"Scott M. Matheson photograph collection",uum_p0290.xml,80444/xv08502,0,0,0,0
"Henry Chariton Jacobs papers",uum_accn2079.xml,80444/xv31704,0,0,0,0
"Richard K. Reuling papers",uum_accn2661.xml,80444/xv27218,0,0,0,0
"David Hanscom papers",uum_accn2424.xml,80444/xv64898,0,0,0,0
"Walter Gordon Clark papers",uum_accn2085.xml,80444/xv53604,0,0,0,0
"Utah Engineers Council records",uum_accn0587.xml,80444/xv30621,0,0,0,0
"John H. Benson papers",uum_ms0128.xml,80444/xv08755,0,0,0,0
"William and Madge Gygi papers",uum_accn1989.xml,80444/xv58914,0,0,0,0
"Measom family histories",uum_accn1118.xml,80444/xv71713,0,0,0,0
"Granite teacher training project",uum_accn0695.xml,80444/xv54296,0,0,0,0
"John A. Stone papers",uum_ms0395.xml,80444/xv15496,0,0,0,0
"Hays Gorey papers",uum_accn1596.xml,80444/xv29211,0,0,0,0
"William Rowley papers",uum_ms0061.xml,80444/xv03588,0,0,0,0
"Wallace S. Brooke papers",uum_accn1905.xml,80444/xv05850,0,0,0,0
"Coal shortage legislative hearings",uum_accn0479.xml,80444/xv01669,0,0,0,0
"Oprha Sweeten Boyden papers",uum_accn2828.xml,80444/xv08865,0,0,0,0
"John F. Flanagan papers",uum_accn1913.xml,80444/xv75622,0,0,0,0
"Lonnie Sparks papers",uum_accn1260.xml,80444/xv23544,0,0,0,0
"Salt Lake Valley Citizen's Council records",uum_ms0461.xml,80444/xv79101,0,0,0,0
"Salt Lake County Teachers Institute records",uum_accn2254.xml,80444/xv97412,0,0,0,0
"Shared Ministry in Utah records",uum_accn1646.xml,80444/xv29501,0,0,0,0
"Ole Pettit papers",uum_ms0250.xml,80444/xv99731,0,0,0,0
"Patterson family histories",uum_accn1119.xml,80444/xv63113,0,0,0,0
"Veterans Day records",uum_accn2721.xml,80444/xv99520,0,0,0,0
"Cyprian Marsh papers",uum_accn1627.xml,80444/xv62026,0,0,0,0
"Pro-Utah records",uum_ms0249.xml,80444/xv73056,0,0,0,0
"Virgin, Utah photograph collection",uum_p0239.xml,80444/xv66049,0,0,0,0
"Salt Lake Buddhist Church dedication program",uum_accn1499.xml,80444/xv43356,0,0,0,0
"Heber Lion Mining Company notice",uum_accn0548.xml,80444/xv02615,0,0,0,0
"Salt Lake City Corporation Planning Division records",uum_accn1946.xml,80444/xv21578,0,0,0,0
"Ted Johnson papers",uum_accn2788.xml,80444/xv42123,0,0,0,0
"Oregon-California Trails Association records",uum_accn1979.xml,80444/xv57440,0,0,0,0
"William Call papers",uum_accn0031.xml,80444/xv65902,0,0,0,0
"Young Women's journal records",uum_accn1538.xml,80444/xv81903,0,0,0,0
"S. Marsena Foster diaries",uum_ms0009.xml,80444/xv73529,0,0,0,0
"United Church of Christ (Congregational) photograph collection",uum_p0156.xml,80444/xv81600,0,0,0,0
"Richard Joseph LeBlanc, Sr. papers",uum_accn2122.xml,80444/xv23547,0,0,0,0
"Wilby Durham papers",uum_accn1708.xml,80444/xv85986,0,0,0,0
"Utah Statewide Coordinated Film History Project records",uum_accn0779.xml,80444/xv50567,0,0,0,0
"Jim Sullivan papers",uum_accn1425.xml,80444/xv21572,0,0,0,0
"Westwater, Utah collection",uum_accn1441.xml,80444/xv12686,0,0,0,0
"Beverly Bithell photograph collection",uum_p0260.xml,80444/xv94445,0,0,0,0
"Utah Schools photograph collection",uum_p0428.xml,80444/xv98651,0,0,0,0
"Dawn House papers",uum_accn1839.xml,80444/xv97769,0,0,0,0
"Milton Edwin Trenam papers",uum_accn1951.xml,80444/xv62808,0,0,0,0
"Lloyd Conyers papers",uum_ms0408.xml,80444/xv78713,0,0,0,0
"James H. Strang papers",uum_accn0884.xml,80444/xv09729,0,0,0,0
"Takasaburo and Lillian Sakaye Sekino papers",uum_accn2158.xml,80444/xv14477,0,0,0,0
"Elizabeth K. Burns essay",uum_accn0572.xml,80444/xv44897,0,0,0,0
"Auxiliary of the Reading Room for the Blind scrapbook",uum_accn2187.xml,80444/xv53329,0,0,0,0
"Ron Howard papers",uum_accn2855.xml,80444/xv41156,0,0,0,0
"George Q. Cannon photograph collection",uum_p0450.xml,80444/xv04583,0,0,0,0
"Thomas C. Griggs diaries",uum_accn0620.xml,80444/xv69381,0,0,0,0
"Utah Rivers Council records",uum_accn1933.xml,80444/xv56921,0,0,0,0
"Annie Eggertsen autobiography",uum_accn0782.xml,80444/xv52838,0,0,0,0
"Veda T. Hale collection",uum_accn1484.xml,80444/xv60003,0,0,0,0
"Utah Science Center Authority collection",uum_accn1501.xml,80444/xv14984,0,0,0,0
"Community Action Program photograph collection",uum_p0263.xml,80444/xv00561,0,0,0,0
"Hawley family papers",uum_ms0343.xml,80444/xv86550,0,0,0,0
"Harold F. Silver papers",uum_accn1551.xml,80444/xv77819,0,0,0,0
"Charles H. Walker papers",uum_accn2510.xml,80444/xv01605,0,0,0,0
"Atchison and Pike's Peak Railroad ledger",uum_accn2487.xml,80444/xv43606,0,0,0,0
"Larry H. Miller papers",uum_accn1379.xml,80444/xv68289,0,0,0,0
"Union Pacific Railroad vouchers",uum_ms0321.xml,80444/xv24740,0,0,0,0
"Young Men's Literary Association collection",uum_accn2253.xml,80444/xv67587,0,0,0,0
"Virginia Kelson photograph collection",uum_p0458.xml,80444/xv79748,0,0,0,0
"Amarilla Hamblin Lee papers",uum_ms0615.xml,80444/xv24954,0,0,0,0
"Tom Shannon papers",uum_accn2775.xml,80444/xv14837,0,0,0,0
"L. M. Sutton papers",uum_accn2266.xml,80444/xv88113,0,0,0,0
"Calvin D. Tolman papers",uum_accn1445.xml,80444/xv96517,0,0,0,0
"William F. X. McConnell article",uum_accn2146.xml,80444/xv89193,0,0,0,0
"Lucy Coila Workman family papers",uum_accn0321.xml,80444/xv45516,0,0,0,0
"McLean Watters photograph collection",uum_p0444.xml,80444/xv11203,0,0,0,0
"Mountain Meadows Association records",uum_accn1253.xml,80444/xv53900,0,0,0,0
"Joseph A. Young photograph collection",uum_p0233.xml,80444/xv70050,0,0,0,0
"Meriam P. Beard collection",uum_accn2178.xml,80444/xv67202,0,0,0,0
"Ariel C. Silver papers",uum_accn2456.xml,80444/xv57339,0,0,0,0
"Cottonwood Country Club photograph collection",uum_p1308.xml,80444/xv23333,0,0,0,0
"Erma Brunt Faldmo papers",uum_accn2130.xml,80444/xv28823,0,0,0,0
"Edgar Bering papers",uum_accn1488.xml,80444/xv87673,0,0,0,0
"Record of the Church of Jesus Christ of Latter-day Saints in the Harmony branch and ward",uum_accn0325.xml,80444/xv62448,0,0,0,0
"A. Selden Millward papers",uum_accn1912.xml,80444/xv15026,0,0,0,0
"Brian Paul Winterowd papers",uum_ms0426.xml,80444/xv56469,0,0,0,0
"Lewis M. Rogers papers",uum_accn1249.xml,80444/xv76043,0,0,0,0
"Nicholas Groesbeck Smith papers",uum_accn2078.xml,80444/xv60955,0,0,0,0
"Charles M. Pickett papers",uum_accn2131.xml,80444/xv68505,0,0,0,0
"Raymond Price papers",uum_accn2869.xml,80444/xv68490,0,0,0,0
"Dan Wesley Urry papers",uum_accn1183.xml,80444/xv08569,0,0,0,0
"Henry Clark Jackson papers",uum_accn0400.xml,80444/xv37930,0,0,0,0
"First Church of Christ, Scientist records",uum_accn1831.xml,80444/xv47860,0,0,0,0
"Mountain Sports Media press releases",uum_accn0155.xml,80444/xv01803,0,0,0,0
"Sue Jensen Weeks papers",uum_accn2179.xml,80444/xv60623,0,0,0,0
"Marvin H. Strong papers",uum_accn1872.xml,80444/xv15698,0,0,0,0
"James W. Varin ski publications collection",uum_accn1417.xml,80444/xv47531,0,0,0,0
"James Westfield papers",uum_accn2834.xml,80444/xv40881,0,0,0,0
"Harriet L. Reid memoir",uum_ms0274.xml,80444/xv79156,0,0,0,0
"Toshiko Marian Morimoto papers",uum_accn2190.xml,80444/xv57565,0,0,0,0
"Katie Lee manuscript",uum_accn2842.xml,80444/xv15036,0,0,0,0
"Haven G. Day papers",uum_accn1356.xml,80444/xv02188,0,0,0,0
"Hiram D. Upham letters",uum_accn0397.xml,80444/xv59228,0,0,0,0
"Journal of Asian Studies records",uum_accn2198.xml,80444/xv46969,0,0,0,0
"Bruce James Black papers",uum_accn1886.xml,80444/xv10968,0,0,0,0
"Amasa Mason Lyman papers",uum_accn0945.xml,80444/xv21173,0,0,0,0
"Bruce Plenk essays",uum_ms0296.xml,80444/xv51361,0,0,0,0
"Royal Coal Company payroll ledgers",uum_accn1186.xml,80444/xv06735,0,0,0,0
"Stock and Bond Certificate Collection",uum_ms0077.xml,80444/xv51071,0,0,0,0
"Utah Copper Company records",uum_accn1028.xml,80444/xv94940,0,0,0,0
"Network magazine records",uum_ms0537.xml,80444/xv16000,0,0,0,0
"Utah Newspaper Project collection",uum_accn2068.xml,80444/xv88375,0,0,0,0
"Classics Club records",uum_accn2436.xml,80444/xv56808,0,0,0,0
"Taylor H. Merrill papers",uum_accn1352.xml,80444/xv39382,0,0,0,0
"Joseph S. Willes papers",uum_ms0355.xml,80444/xv46713,0,0,0,0
"Louisa Wagoner Thorne diaries",uum_accn1010.xml,80444/xv32693,0,0,0,0
"Theron David Read papers",uum_accn2518.xml,80444/xv60241,0,0,0,0
"Coal Index",uum_accn1075.xml,80444/xv18563,0,0,0,0
"Susan Miller papers",uum_accn2756.xml,80444/xv17001,0,0,0,0
"Fred Harvey photograph collection",uum_p0482.xml,80444/xv00897,0,0,0,0
"William A. Britney papers",uum_accn0309.xml,80444/xv93939,0,0,0,0
"Eli A. Day papers",uum_ms0387.xml,80444/xv47595,0,0,0,0
"Frank Filkins photograph collection",uum_p0549.xml,80444/xv43017,0,0,0,0
"George Reynolds photograph collection",uum_p0523.xml,80444/xv77410,0,0,0,0
"Utah Medical Association records",uum_accn2015.xml,80444/xv52453,0,0,0,0
"Ambrosina Colombo Bonza oral history interview",uum_accn0807.xml,80444/xv18786,0,0,0,0
"Thomas Bradley letter",uum_ms0338.xml,80444/xv34735,0,0,0,0
"English postcard collection",uum_accn2520.xml,80444/xv75524,0,0,0,0
"James Pace papers",uum_accn0083.xml,80444/xv96701,0,0,0,0
"Clark J. Phelps papers",uum_accn2062.xml,80444/xv16143,0,0,0,0
"Marvin J. Bertoch papers",uum_accn1489.xml,80444/xv89294,0,0,0,0
"Growers' Market Company records",uum_accn2157.xml,80444/xv71093,0,0,0,0
"Ogden City Council minutes",uum_accn0326.xml,80444/xv81378,0,0,0,0
"Parik City Ski Association photograph collection",uum_p0406.xml,80444/xv04333,0,0,0,0
"ECKANKAR Records photograph collection",uum_p0582.xml,80444/xv64443,0,0,0,0
"Karolyn Wright McGuire papers",uum_accn2274.xml,80444/xv03723,0,0,0,0
"Wallace A. Goates sheet music collection",uum_accn1777.xml,80444/xv04104,0,0,0,0
"Peter H. Roth papers",uum_accn2566.xml,80444/xv91806,0,0,0,0
"Samuel Shimp travel notes",uum_accn2801.xml,80444/xv74090,0,0,0,0
"Jack Shapiro papers",uum_accn1849.xml,80444/xv01025,0,0,0,0
"Benjamin Fanklin Cummings papers",uum_ms0060.xml,80444/xv50216,0,0,0,0
"Culture Lure Club records",uum_accn1635.xml,80444/xv79248,0,0,0,0
"Salt Lake City Flooding photograph collection",uum_p0261.xml,80444/xv62167,0,0,0,0
"Lynn Pulsipher essay",uum_ms0279.xml,80444/xv82415,0,0,0,0
"Joseph Standing collection",uum_accn0956.xml,80444/xv39562,0,0,0,0
"Provo, Utah photograph collection",uum_p0088.xml,80444/xv40249,0,0,0,0
"Sundance Ski Area photograph collection",uum_p0383.xml,80444/xv69586,0,0,0,0
"Humanists of Utah records",uum_accn1280.xml,80444/xv52981,0,0,0,0
"Wilford E. Christensen papers",uum_accn2247.xml,80444/xv51971,0,0,0,0
"Ute Alpine Club records",uum_ms0438.xml,80444/xv88015,0,0,0,0
"Peter L. Kraus collection",uum_accn2324.xml,80444/xv45089,0,0,0,0
"Boy Scouts of America Troop 84 records",uum_accn2581.xml,80444/xv76296,0,0,0,0
"Mountain Lake Extension Mining Company records",uum_accn0292.xml,80444/xv24511,0,0,0,0
"Salt Lake Tribune photograph collection",uum_p0378.xml,80444/xv02661,0,0,0,0
"Alonzo Huckins diary",uum_ms0130.xml,80444/xv76071,0,0,0,0
"Rawlins B. Young papers",uum_accn1758.xml,80444/xv19625,0,0,0,0
"Carlton Culmsee article",uum_accn0753.xml,80444/xv94912,0,0,0,0
"Wilford Ence papers",uum_ms0119.xml,80444/xv00640,0,0,0,0
"Minute book of South Cottonwood Quorum of Seventies and Mendon Quorum of Seventies",uum_accn0323.xml,80444/xv53576,0,0,0,0
"Elmore Winfield LeRoy papers",uum_ms0256.xml,80444/xv72888,0,0,0,0
"Kurt Weill Foundation for Music collection",uum_accn1555.xml,80444/xv46032,0,0,0,0
"Vernal Holley papers",uum_accn1475.xml,80444/xv01464,0,0,0,0
"Trenton Falls, New York photograph collection",uum_p0236.xml,80444/xv36355,0,0,0,0
"Andrew Orr letters",uum_accn1272.xml,80444/xv57873,0,0,0,0
"I. C. C. Whitmore papers",uum_accn1965.xml,80444/xv87448,0,0,0,0
"Charles H. Monson essay competition collection",uum_accn0526.xml,80444/xv76385,0,0,0,0
"Ray Grass papers",uum_accn2874.xml,80444/xv65371,0,0,0,0
"Monument Park Ninth Ward and Stake newsletters",uum_accn1631.xml,80444/xv85696,0,0,0,0
"Ken Garff papers",uum_accn2237.xml,80444/xv97787,0,0,0,0
"Dialogue Foundation photograph collection",uum_p0589.xml,80444/xv45623,0,0,0,0
"Bingham Mines Company annual reports",uum_accn1940.xml,80444/xv84954,0,0,0,0
"Jennie M. Crabbe papers",uum_accn2255.xml,80444/xv61468,0,0,0,0
"Alexander Faddies diaries",uum_accn1757.xml,80444/xv83129,0,0,0,0
"Overland Stage Lines memorabilia",uum_accn0646.xml,80444/xv33663,0,0,0,0
"Bear River, Utah photograph collection",uum_p0213.xml,80444/xv81661,0,0,0,0
"Tandy Beal papers",uum_accn2044.xml,80444/xv28298,0,0,0,0
"Institute for Religious Research records",uum_accn0791.xml,80444/xv71673,0,0,0,0
"Ralf R. Woolley papers",uum_accn1407.xml,80444/xv50094,0,0,0,0
"Richard D. Van Orden papers",uum_accn0612.xml,80444/xv74008,0,0,0,0
"Emil Morris Whitesides papers",uum_accn2076.xml,80444/xv39657,0,0,0,0
"James Edward Talmage photograph collection",uum_p0703.xml,80444/xv76763,0,0,0,0
"Burns Bench Irrigation Company stock certificate registry books",uum_ms0636.xml,80444/xv49722,0,0,0,0
"Alaska photograph collection",uum_p0212.xml,80444/xv51339,0,0,0,0
"Elizabeth and Jimmy Miklavcic papers",uum_accn2819.xml,80444/xv09698,0,0,0,0
"Mark K. Allen papers",uum_accn1330.xml,80444/xv63882,0,0,0,0
"Salt Lake County reorganization records",uum_accn2039.xml,80444/xv08023,0,0,0,0
"Jerzy L. Feiner monograph",uum_accn1544.xml,80444/xv60910,0,0,0,0
"Jack Warren Keuffel photograph collection",uum_p0299.xml,80444/xv32400,0,0,0,0
"Rick Reese papers",uum_accn1424.xml,80444/xv73516,0,0,0,0
"Stephen C. Foster collection",uum_accn1317.xml,80444/xv01071,0,0,0,0
"Wasatch Westerners records",uum_accn0923.xml,80444/xv30831,0,0,0,0
"Fillmore, Utah photograph collection",uum_p0219.xml,80444/xv14236,0,0,0,0
"B. B. Wrapfr papers",uum_accn2365.xml,80444/xv53457,0,0,0,0
"Ralph Elliott Margetts papers",uum_ms0603.xml,80444/xv75701,0,0,0,0
"General store ledger page",uum_accn2525.xml,80444/xv75643,0,0,0,0
"Flora Stewart Bennion collection",uum_accn1623.xml,80444/xv30877,0,0,0,0
"Price, Utah photograph collection",uum_p0186.xml,80444/xv60272,0,0,0,0
"Patrice M. Arent papers",uum_accn2335.xml,80444/xv98370,0,0,0,0
"Sol J. Selvin photograph collection",uum_p0465.xml,80444/xv40328,0,0,0,0
"Mormon missionary in Germany manuscript",uum_accn2542.xml,80444/xv69049,0,0,0,0
"William B. Ashworth autobiography",uum_accn1087.xml,80444/xv72744,0,0,0,0
"Andrus family papers",uum_ms0327.xml,80444/xv87298,0,0,0,0
"Eunice Merrell Clifton papers",uum_accn2430.xml,80444/xv56314,0,0,0,0
"Salina, Utah photograph collection",uum_p0271.xml,80444/xv43701,0,0,0,0
"Russell Simon and Margaret Breer Fraser papers",uum_accn2511.xml,80444/xv70309,0,0,0,0
"John Anderson papers",uum_accn2250.xml,80444/xv38348,0,0,0,0
"Jim Shane Alta, Utah collection",uum_accn1071.xml,80444/xv14825,0,0,0,0
"Mormon businessman in Salt Lake City diaries",uum_accn2540.xml,80444/xv84735,0,0,0,0
"Karen Korfanta papers",uum_accn1689.xml,80444/xv62216,0,0,0,0
"William Simpson Gould papers",uum_accn1674.xml,80444/xv52728,0,0,0,0
"Mace K. Church papers",uum_accn1914.xml,80444/xv59442,0,0,0,0
"Spanish Trail collection",uum_accn1083.xml,80444/xv47973,0,0,0,0
"Arvo Van Alstyne photograph collection",uum_p0576.xml,80444/xv23413,0,0,0,0
"Curtis family histories",uum_accn1121.xml,80444/xv81945,0,0,0,0
"Coptic encyclopedia records",uum_accn1205.xml,80444/xv72390,0,0,0,0
"Mt. Nebo Sugar Beet and Land Company records",uum_accn1975.xml,80444/xv67181,0,0,0,0
"Sons of the Utah Pioneers certificate",uum_accn0245.xml,80444/xv81524,0,0,0,0
"Don Trimble papers",uum_accn2815.xml,80444/xv28192,0,0,0,0
"Walker family papers",uum_ms0463.xml,80444/xv94805,0,0,0,0
"Thomas Robinson Cutler biography",uum_accn0848.xml,80444/xv96499,0,0,0,0
"Lucille Iredale Carleson papers",uum_accn1811.xml,80444/xv29885,0,0,0,0
"Malad City Electrical Power Light System manuscript",uum_ms0326.xml,80444/xv34869,0,0,0,0
"Ossian F. Taylor papers",uum_accn1782.xml,80444/xv45217,0,0,0,0
"Conrad B. Harrison papers",uum_accn1504.xml,80444/xv88098,0,0,0,0
"American Association of Mining Engineers photograph collection",uum_p0159.xml,80444/xv51867,0,0,0,0
"Dorothy Bearnson papers",uum_accn1123.xml,80444/xv49728,0,0,0,0
"George E. Stewart article",uum_accn0528.xml,80444/xv34661,0,0,0,0
"Bent Franklin Larsen photograph collection",uum_p1447.xml,80444/xv17095,0,0,0,0
"Timothy Kendell autobiography",uum_ms0041.xml,80444/xv12338,0,0,0,0
"Utah Ski Archives Advisory Board records",uum_accn1806.xml,80444/xv19232,0,0,0,0
"Defeat of the Martin ministry papers",uum_accn1885.xml,80444/xv24313,0,0,0,0
"Einar Fredbo skiing scrapbook",uum_accn1586.xml,80444/xv11151,0,0,0,0
"Robert L. Miller papers",uum_accn2064.xml,80444/xv87655,0,0,0,0
"Helen O'Connell papers",uum_accn1873.xml,80444/xv82751,0,0,0,0
"Utah College Library Council records",uum_accn0961.xml,80444/xv67803,0,0,0,0
"History of the National Association of Postmasters of the United States, Utah Chapter",uum_accn2629.xml,80444/xv67568,0,0,0,0
"William Adams family papers",uum_accn1621.xml,80444/xv66232,0,0,0,0
"Utah National Prosperity Plan records",uum_ms0211.xml,80444/xv25976,0,0,0,0
"Tuesday Study Club records",uum_accn1443.xml,80444/xv36743,0,0,0,0
"Henry Maiben papers",uum_accn1845.xml,80444/xv27859,0,0,0,0
"Ethel M. Piper papers",uum_accn1542.xml,80444/xv46142,0,0,0,0
"Bonneville Towers collection",uum_ms0414.xml,80444/xv41720,0,0,0,0
"Arcadian Brotherhood of Intermountain States records",uum_accn1225.xml,80444/xv89944,0,0,0,0
"C. Edward Jacob papers",uum_ms0406.xml,80444/xv39483,0,0,0,0
"R. R. Stevens papers",uum_ms0428.xml,80444/xv19616,0,0,0,0
"Utah flood survey reports",uum_ms0208.xml,80444/xv12442,0,0,0,0
"Edward Hunter photograph collection",uum_p0027.xml,80444/xv89578,0,0,0,0
"North and East Regional Council of Neighborhood Associations records",uum_accn1636.xml,80444/xv45874,0,0,0,0
"Heber J. Sears papers",uum_accn2488.xml,80444/xv62475,0,0,0,0
"Pearl Biddlecome Baker papers",uum_accn1832.xml,80444/xv30804,0,0,0,0
"Electors of president and vice-president certificate of the governor",uum_accn0758.xml,80444/xv62826,0,0,0,0
"Theta Epsilon Sorority dance cards",uum_accn1082.xml,80444/xv18270,0,0,0,0
"League of Women's Voters of Salt Lake City photograph collection",uum_p0129.xml,80444/xv97082,0,0,0,0
"Byron Marchant papers",uum_accn1001.xml,80444/xv77005,0,0,0,0
"Spanish Speaking Organization for Community Integrity and Opportunity records (SOCIO) photograph collection",uum_p0708.xml,80444/xv67013,0,0,0,0
"Relief Society General Board records",uum_accn1974.xml,80444/xv34042,0,0,0,0
"Peter V. Karns papers",uum_accn1958.xml,80444/xv47158,0,0,0,0
"McCornick and Company records",uum_accn1964.xml,80444/xv09469,0,0,0,0
"Samantha Tryphena Brimhall Foley autobiography",uum_ms0591.xml,80444/xv66571,0,0,0,0
"Lucybeth Cardon Rampton photograph collection",uum_p0128.xml,80444/xv07968,0,0,0,0
"Utahns For Responsible Public Spending records",uum_accn1548.xml,80444/xv57217,0,0,0,0
"Dennis D. Gardner papers",uum_accn1870.xml,80444/xv26455,0,0,0,0
"Martha Springman Castagnoli papers",uum_accn2551.xml,80444/xv24746,0,0,0,0
"Jerry H. Dunton papers",uum_accn1851.xml,80444/xv42486,0,0,0,0
"Ralph Bassett Wright papers",uum_accn0862.xml,80444/xv38235,0,0,0,0
"Colorado photograph collection",uum_p0215.xml,80444/xv60937,0,0,0,0
"Utah Legislative Conference records",uum_accn0699.xml,80444/xv33078,0,0,0,0
"David Charles Williams papers",uum_accn2290.xml,80444/xv89065,0,0,0,0
"Cecil L. Mills, Jr. papers",uum_accn2833.xml,80444/xv71368,0,0,0,0
"Peter M. Mickelsen photograph collection",uum_p0453.xml,80444/xv62606,0,0,0,0
"Sheridan L. McGarry papers",uum_accn1595.xml,80444/xv15237,0,0,0,0
"Elbert Duncan Thomas speeches",uum_ms0294.xml,80444/xv54129,0,0,0,0
"Kim David Richards papers",uum_accn2734.xml,80444/xv78140,0,0,0,0
"Joseph L. Chandler papers",uum_accn1656.xml,80444/xv81243,0,0,0,0
"Nichiren Buddhist Temple records",uum_accn1296.xml,80444/xv55740,0,0,0,0
"John Fitch Kinney autobiography",uum_ms0303.xml,80444/xv15386,0,0,0,0
"Dean Thompson papers",uum_accn1853.xml,80444/xv46936,0,0,0,0
"Preston D. Linford papers",uum_accn1833.xml,80444/xv66928,0,0,0,0
"Lucy May Van Cott papers",uum_accn0717.xml,80444/xv61260,0,0,0,0
"Alta mining financial records",uum_accn1575.xml,80444/xv89828,0,0,0,0
"Magna Community Church records",uum_accn1115.xml,80444/xv00366,0,0,0,0
"Belnap family papers",uum_accn0399.xml,80444/xv06417,0,0,0,0
"Andrew W. Wiltse and Joel Farnham patent",uum_accn1332.xml,80444/xv19598,0,0,0,0
"John B. and Margaret Gibson Smith papers",uum_accn2293.xml,80444/xv18231,0,0,0,0
"Blue Key membership list",uum_accn0960.xml,80444/xv79205,0,0,0,0
"William C. Staines certificate of appointment",uum_ms0380.xml,80444/xv10058,0,0,0,0
"Intermountain Ski Instructors Association records",uum_accn0425.xml,80444/xv90725,0,0,0,0
"Helen Mae Shufelt Chindgren papers",uum_accn2618.xml,80444/xv72402,0,0,0,0
"Benjamin Morgan Roberts papers",uum_accn0701.xml,80444/xv10995,0,0,0,0
"George Crane autobiography",uum_ms0075.xml,80444/xv80755,0,0,0,0
"Salt Lake Temple dedication card",uum_accn2563.xml,80444/xv71603,0,0,0,0
"Marthinius A. Strand photograph collection",uum_p1306.xml,80444/xv22808,0,0,0,0
"Raymond Stewart photograph collection",uum_p0376.xml,80444/xv23840,0,0,0,0
"Don Lind photograph collection",uum_p0704.xml,80444/xv95867,0,0,0,0
"Asahel Hart Woodruff papers",uum_accn1442.xml,80444/xv36642,0,0,0,0
"Rose Thomas Graham papers",uum_accn2165.xml,80444/xv09487,0,0,0,0
"Arthur T. Lewis oral history interview",uum_accn0261.xml,80444/xv86987,0,0,0,0
"George Richard Hill papers",uum_accn0966.xml,80444/xv88226,0,0,0,0
"Albert C. Allen papers",uum_ms0581.xml,80444/xv84194,0,0,0,0
"Eleanor L. Nicholes papers",uum_accn1185.xml,80444/xv15408,0,0,0,0
"Mark Lindsey papers",uum_accn1713.xml,80444/xv02859,0,0,0,0
"Art Access/VSA Utah records",uum_accn2782.xml,80444/xv62457,0,0,0,0
"Richard Clay papers",uum_accn2485.xml,80444/xv04772,0,0,0,0
"Maxwell Myer Wintrobe papers",uum_accn0954.xml,80444/xv35186,0,0,0,0
"Geology index",uum_accn1634.xml,80444/xv64477,0,0,0,0
"Alma Garth Sorenson papers",uum_accn0132.xml,80444/xv35281,0,0,0,0
"Earl M. Wunderli papers",uum_accn1013.xml,80444/xv81216,0,0,0,0
"Miss Helen Snow Kimball Domestic Travel Award sketchbooks",uum_accn2521.xml,80444/xv81597,0,0,0,0
"Jacob Johnson papers",uum_ms0331.xml,80444/xv04336,0,0,0,0
"Religious Society of Friends records",uum_accn1780.xml,80444/xv05975,0,0,0,0
"Salt Lake City - Ulan Ude Friendship Committee records",uum_accn1907.xml,80444/xv55212,0,0,0,0
"Thomas George Brown papers",uum_accn2052.xml,80444/xv49212,0,0,0,0
"Chadwin H. Peirce papers",uum_accn1752.xml,80444/xv16983,0,0,0,0
"Utah Personnel and Guidance Association records",uum_accn0769.xml,80444/xv32626,0,0,0,0
"Ike Spencer scrapbook",uum_accn2768.xml,80444/xv10189,0,0,0,0
"Spanish-Speaking Organization for Community, Integrity and Opportunity (SOCIO) records",uum_accn1142.xml,80444/xv57015,0,0,0,0
"R. Thayne Robson papers",uum_accn2492.xml,80444/xv96420,0,0,0,0
"Randy K. Baker papers",uum_accn0348.xml,80444/xv06588,0,0,0,0
"Scrapbook of collected poetry",uum_accn2796.xml,80444/xv22277,0,0,0,0
"John Hardie diary",uum_accn0227.xml,80444/xv91397,0,0,0,0
"Utah State Historical Society Board of Trustees meeting minutes",uum_ms0633.xml,80444/xv92254,0,0,0,0
"Oratorio Society of Utah records",uum_accn1876.xml,80444/xv75778,0,0,0,0
"Hattie C. Hudson papers",uum_accn1700.xml,80444/xv62210,0,0,0,0
"American Mines Syndicate records",uum_accn2017.xml,80444/xv05160,0,0,0,0
"Kenneth R. Prentiss papers",uum_accn1928.xml,80444/xv99737,0,0,0,0
"Joyce Orlob Evans papers",uum_accn2385.xml,80444/xv07427,0,0,0,0
"James Wolk papers",uum_accn2706.xml,80444/xv41278,0,0,0,0
"Sharon Keigher photograph collection",uum_p0094.xml,80444/xv19665,0,0,0,0
"Wayne S. Brown papers",uum_accn1493.xml,80444/xv69104,0,0,0,0
"Home teachers meeting minutes",uum_accn0898.xml,80444/xv93164,0,0,0,0
"Amos Bottsford Fuller diary transcript",uum_ms0333.xml,80444/xv85592,0,0,0,0
"Collinston, Utah photograph collection",uum_p0245.xml,80444/xv96145,0,0,0,0
"Heber L. Magleby papers",uum_accn1881.xml,80444/xv28488,0,0,0,0
"John Hudson papers",uum_accn0674.xml,80444/xv91503,0,0,0,0
"John M. Baldwin photograph collection",uum_p0009.xml,80444/xv95654,0,0,0,0
"Oregon-Utah Trails Association records",uum_accn1329.xml,80444/xv70870,0,0,0,0
"John E. Carr papers",uum_accn1747.xml,80444/xv76260,0,0,0,0
"Joseph Stanley Russon papers",uum_accn0911.xml,80444/xv36410,0,0,0,0
"Darell D. Thorpe papers",uum_accn1563.xml,80444/xv82284,0,0,0,0
"Professional Ski Instructors Association, Intermountain Division photograph collection",uum_p0414.xml,80444/xv44903,0,0,0,0
"Cleofan records",uum_accn2585.xml,80444/xv25555,0,0,0,0
"Olympic Ski Team photograph collection",uum_p0373.xml,80444/xv90063,0,0,0,0
"Wendover Air Force Base collection",uum_accn1355.xml,80444/xv59149,0,0,0,0
"John Hoagland avalanche publications collection",uum_accn1571.xml,80444/xv15222,0,0,0,0
"Earl Andrew Miller papers",uum_accn1570.xml,80444/xv75921,0,0,0,0
"Milwaukee Railroad traveling freight agent sales kit",uum_accn2795.xml,80444/xv14083,0,0,0,0
"Glen Miller scrapbooks",uum_ms0015.xml,80444/xv49652,0,0,0,0
"William Wallace Newby papers",uum_ms0606.xml,80444/xv15356,0,0,0,0
"Eugene J. Holmes papers",uum_ms0192.xml,80444/xv07781,0,0,0,0
"Kate B. Carter article",uum_accn2557.xml,80444/xv61419,0,0,0,0
"Delbert V. Groberg papers",uum_accn1364.xml,80444/xv48168,0,0,0,0
"Thomas Taylor papers",uum_accn0745.xml,80444/xv25985,0,0,0,0
"Janet Pender Healy papers",uum_accn1421.xml,80444/xv20651,0,0,0,0
"W.C.B. Orrock gerneral merchandise account book",uum_accn0128.xml,80444/xv89163,0,0,0,0
"Utah State Insane Asylum records",uum_accn0372.xml,80444/xv96047,0,0,0,0
"Katrina Terzian Jensen papers",uum_accn2393.xml,80444/xv14132,0,0,0,0
"Hugo N. Olaiz collection",uum_accn2154.xml,80444/xv98464,0,0,0,0
"Clarence R. Wylie papers",uum_accn0593.xml,80444/xv75393,0,0,0,0
"Montana Territorial Penitentiary ledger",uum_accn0022.xml,80444/xv70343,0,0,0,0
"Elva Acklam Stark scrapbook",uum_accn1494.xml,80444/xv63830,0,0,0,0
"Drawings of Western History photograph collection",uum_p0185.xml,80444/xv64025,0,0,0,0
"Kaysville Art Club records",uum_accn1578.xml,80444/xv32644,0,0,0,0
"Richmond L. Clow papers",uum_accn1497.xml,80444/xv84252,0,0,0,0
"Edward J. Davies papers",uum_accn2574.xml,80444/xv60620,0,0,0,0
"Shirley Rumph papers",uum_accn2251.xml,80444/xv22512,0,0,0,0
"Walter Affleck Kerr papers",uum_ms0427.xml,80444/xv08584,0,0,0,0
"Utah Computer Society records",uum_accn2020.xml,80444/xv71472,0,0,0,0
"Snow Basin Ski Resort photograph collection",uum_p0374.xml,80444/xv98468,0,0,0,0
"Deseret News reprints",uum_accn2694.xml,80444/xv62362,0,0,0,0
"Harold Orlob papers",uum_accn2366.xml,80444/xv05996,0,0,0,0
"Rio Grande Southern Railroad records",uum_accn2051.xml,80444/xv76165,0,0,0,0
"John McAllister papers",uum_accn2213.xml,80444/xv64666,0,0,0,0
"Communications ephemera collection",uum_accn1276.xml,80444/xv74645,0,0,0,0
"Union Times collection",uum_ms0605.xml,80444/xv32360,0,0,0,0
"Patricia Maynetta King papers",uum_accn1736.xml,80444/xv13360,0,0,0,0
"Salt Lake City Engineer photograph collection",uum_p0170.xml,80444/xv48388,0,0,0,0
"Herbert B. Maw papers",uum_ms0532.xml,80444/xv64739,0,0,0,0
"Gibson Condie papers",uum_accn2091.xml,80444/xv96301,0,0,0,0
"Enos and Jemima Child Stookey papers",uum_accn1022.xml,80444/xv18682,0,0,0,0
"Andrew Jensen photograph collection",uum_p0162.xml,80444/xv68905,0,0,0,0
"Art Barn records",uum_ms0273.xml,80444/xv62417,0,0,0,0
"John A. Dixon papers",uum_accn1018.xml,80444/xv42510,0,0,0,0
"Melba Goff Matthews papers",uum_accn1932.xml,80444/xv56680,0,0,0,0
"Clayton Cheney papers",uum_accn2431.xml,80444/xv58993,0,0,0,0
"Salt Lake City and County Building restoration records",uum_accn1097.xml,80444/xv37124,0,0,0,0
"Spring City (Utah) City Council meeting minutes",uum_accn0429.xml,80444/xv72045,0,0,0,0
"Sarah Carmichael Williamson article",uum_accn2770.xml,80444/xv91934,0,0,0,0
"Grant B. Bitter papers",uum_accn1072.xml,80444/xv96221,0,0,0,0
"Fielding K. Smith papers",uum_accn0889.xml,80444/xv41610,0,0,0,0
"Helper, Utah photograph collection",uum_p0222.xml,80444/xv38125,0,0,0,0
"Manti, Utah photograph collection",uum_p0084.xml,80444/xv31631,0,0,0,0
"John D. Summerhays photograph collection",uum_p0275.xml,80444/xv68429,0,0,0,0
"Allen J. Fletcher papers",uum_accn0266.xml,80444/xv52481,0,0,0,0
"O. Ragnar Linde papers",uum_accn1462.xml,80444/xv72637,0,0,0,0
"E. Frank Sanguinetti papers",uum_accn2193.xml,80444/xv43115,0,0,0,0
"John T. Orton paper",uum_accn1704.xml,80444/xv36303,0,0,0,0
"C.A. Kenacton papers",uum_accn2104.xml,80444/xv06100,0,0,0,0
"Cuban War Parade photograph collection",uum_p0476.xml,80444/xv68295,0,0,0,0
"Robert C. Ecker papers",uum_accn2218.xml,80444/xv32485,0,0,0,0
"James Whitmore papers",uum_accn2280.xml,80444/xv91207,0,0,0,0
"Emily H. Cannon papers",uum_accn1164.xml,80444/xv99237,0,0,0,0
"Francis H. Zimbeaux correspondence",uum_accn2737.xml,80444/xv57235,0,0,0,0
"Capitol Hill collection",uum_accn1422.xml,80444/xv00607,0,0,0,0
"Utah Council of Defense records",uum_ms0107.xml,80444/xv48925,0,0,0,0
"Diary detailing a trip across the continent",uum_accn1370.xml,80444/xv87866,0,0,0,0
"Jack Witherspoon papers",uum_accn2053.xml,80444/xv90042,0,0,0,0
"Inventories to the XV Winter Olympic Games",uum_accn1576.xml,80444/xv54550,0,0,0,0
"Andrew Lalo Gallegos papers",uum_accn1419.xml,80444/xv74792,0,0,0,0
"Centenary United Methodist Church records",uum_accn2166.xml,80444/xv11154,0,0,0,0
"Bear Creek Mining Company reports",uum_accn2670.xml,80444/xv63674,0,0,0,0
"Aubrey family papers",uum_accn2240.xml,80444/xv62500,0,0,0,0
"James Henry Sinquefield oral history interview",uum_accn1012.xml,80444/xv54895,0,0,0,0
"Utah Women's History Association records",uum_ms0432.xml,80444/xv60140,0,0,0,0
"Steve Lacey papers",uum_accn0776.xml,80444/xv71267,0,0,0,0
"Marsha Ballif Midgley papers",uum_accn1781.xml,80444/xv30749,0,0,0,0
"Joseph H. Michell diary",uum_accn1770.xml,80444/xv59039,0,0,0,0
"John M. Owada papers",uum_accn2414.xml,80444/xv97183,0,0,0,0
"James S. Campbell papers",uum_accn0563.xml,80444/xv41717,0,0,0,0
"John W. Dawson papers",uum_accn2346.xml,80444/xv91235,0,0,0,0
"Facades: a study of historic Utah buildings",uum_ms0493.xml,80444/xv63659,0,0,0,0
"Niels P. Larsen brochure",uum_accn2811.xml,80444/xv58160,0,0,0,0
"Francis Lee family historical accounts",uum_ms0322.xml,80444/xv47094,0,0,0,0
"Provo Community Congregational Church records",uum_ms0442.xml,80444/xv00613,0,0,0,0
"Melvin E. Lewis papers",uum_accn1668.xml,80444/xv26544,0,0,0,0
"Otto N. Toomey papers",uum_accn1707.xml,80444/xv96078,0,0,0,0
"Alma O. Erekson papers",uum_accn1490.xml,80444/xv42312,0,0,0,0
"Elton LeRoy Taylor papers",uum_accn1360.xml,80444/xv77340,0,0,0,0
"Eckley M. Keach diary",uum_accn1844.xml,80444/xv03564,0,0,0,0
"Philip Lasky papers",uum_accn0832.xml,80444/xv65243,0,0,0,0
"Political campaign literature collection",uum_ms0480.xml,80444/xv23690,0,0,0,0
"Rebecca Rosetta Peterson Bean papers",uum_accn1773.xml,80444/xv83981,0,0,0,0
"Frederick William Larson papers",uum_accn2106.xml,80444/xv09890,0,0,0,0
"LDS Church statistics records",uum_accn2752.xml,80444/xv11877,0,0,0,0
"Peter J. Christofferson papers",uum_ms0421.xml,80444/xv77166,0,0,0,0
"E. A. Child papers",uum_ms0352.xml,80444/xv80078,0,0,0,0
"Utah Commission on the Organization of the Executive Branch of the Government records",uum_accn1173.xml,80444/xv73919,0,0,0,0
"A. Russell Gray biography",uum_ms0448.xml,80444/xv60842,0,0,0,0
"William Clark McFerrin papers",uum_accn2447.xml,80444/xv07058,0,0,0,0
"Jennings Grandee Olson Jr. papers",uum_accn1693.xml,80444/xv95474,0,0,0,0
"Allan Moll papers",uum_accn1716.xml,80444/xv35662,0,0,0,0
"Kaysville Presbyterian Church history",uum_accn1516.xml,80444/xv00115,0,0,0,0
"Juab County Sheep Owners Association records",uum_accn2578.xml,80444/xv58413,0,0,0,0
"Chamber Music Society of Sale Lake City photograph collection",uum_p0552.xml,80444/xv90759,0,0,0,0
"Don Gale papers",uum_accn2584.xml,80444/xv54220,0,0,0,0
"Blue Tea Society records",uum_accn0159.xml,80444/xv76458,0,0,0,0
"Arthur Conan Doyle papers",uum_accn2126.xml,80444/xv59213,0,0,0,0
"Rachel Seamons Hancey autobiography",uum_ms0348.xml,80444/xv88659,0,0,0,0
"Swiss Singing and Yodeling Festival records",uum_ms0437.xml,80444/xv56893,0,0,0,0
"James Thompson diary",uum_accn1291.xml,80444/xv46105,0,0,0,0
"Students Against Apartheid collection",uum_accn1311.xml,80444/xv78582,0,0,0,0
"Orange A. Olsen papers",uum_accn2313.xml,80444/xv75851,0,0,0,0
"Cary Trivanovich papers",uum_accn2159.xml,80444/xv80087,0,0,0,0
"James S. R. Wilson diary",uum_ms0131.xml,80444/xv19479,0,0,0,0
,,Totals,11777,10530,10450,32757
