Title,Document Name,Ark Identifier,July,August,September,Total
"Herald Journal Newspaper Photographs,",uus_p001.xml,80444/xv77938,465,549,521,1535
"A-Board historical photograph collection",uus_aboardcoll.xml,80444/xv63613,364,421,434,1219
"Compton Photograph Studio Archive collection",uus_p0313.xml,80444/xv71670,285,241,100,626
"Utah State University Buzzer Yearbook Photograph Collection (P0531)",uus_p0531.xml,80444/xv07794,181,212,145,538
"Assorted Photograph Collections",uus_assortedpocoll.xml,80444/xv76242,83,152,277,512
"USU student folklore genre collection of speech",uus_folkcoll008a_3.xml,80444/xv01016,131,112,163,406
"Utah State University undergraduate student fieldwork collection",uus_folkcoll008usu.xml,80444/xv86462,124,100,166,390
"Cache County tax assessment photograph collection,",uus_p0012.xml,80444/xv09988,124,119,104,347
"Claridge family photograph collection,",uus_p0143.xml,80444/xv27847,104,145,59,308
"USU Photographic Services Collection.",uus_p0376.xml,80444/xv00213,65,147,93,305
"James N. Holdaway Papers",uus_mss328.xml,80444/xv92337,7,258,7,272
"Pond Brothers Store papers",uus_mss107.xml,80444/xv11791,1,269,1,271
"Outlook magazine photograph collection",uus_p0320.xml,80444/xv67926,89,103,73,265
"4-H Club photograph collection",uus_p0114.xml,80444/xv05398,85,110,69,264
"Becker Brewing and Malting Company records",uus_cainemss031.xml,80444/xv52359,65,111,84,260
"Utah Statesman Photograph Collection",uus_p0395.xml,80444/xv99420,74,95,80,249
"Ada Morrell Family Scrapbook Collection,",uus_p0355.xml,80444/xv06253,64,103,78,245
"Newell Hart papers",uus_cainemss003.xml,80444/xv75030,77,108,55,240
"Floyd and Edith Morgan Papers",uus_mss222.xml,80444/xv88760,9,217,9,235
"The High School Student Folklore Collection",uus_folkcoll055.xml,80444/xv59487,57,77,99,233
"Mormon diaries",uus_mss018.xml,80444/xv27203,94,79,53,226
"The Logan Island Defense Committee Papers",uus_mss141.xml,80444/xv17340,8,213,0,221
"Edgar B. Brossard photograph collection",uus_p0111.xml,80444/xv32278,50,97,72,219
"Andrew L. Heggie and Corinne Godfrey Heggie photograph collection",uus_p0121.xml,80444/xv83343,63,107,48,218
"Crookston family papers",uus_mss071.xml,80444/xv03927,34,38,135,207
"Utah State University historical photo-board collection",uus_usupho1.xml,80444/xv76126,61,92,53,206
"Jack and Charmian London correspondence and papers",uus_mss010.xml,80444/xv27206,60,76,65,201
"The National Cowboy Poetry Gathering collection",uus_folkcoll011g.xml,80444/xv27954,66,76,58,200
"Utah State University County Extension Agent Report Photograph Collection",uus_p0138.xml,80444/xv31335,75,80,43,198
"Robert W. McDill papers",uus_mss121.xml,80444/xv17129,0,194,3,197
"Ellsworth family photograph collection,",uus_p0142.xml,80444/xv18179,65,66,57,188
"Edgar Bernard Brossard papers",uus_mss004.xml,80444/xv14538,7,26,148,181
"Utah State University publicity portraits",uus_p0326.xml,80444/xv68896,51,59,63,173
"American Folklore Society records",uus_mss206.xml,80444/xv94586,50,68,48,166
"Western states cowboy poetry collection",uus_folkcoll011f.xml,80444/xv45220,64,38,61,163
"John Suiter photography collection",uus_p0375.xml,80444/xv61560,46,60,56,162
"Peter Maughan papers",uus_mss037.xml,80444/xv93002,25,83,45,153
"Montpelier Historical Society archives",uus_mss197.xml,80444/xv95745,36,69,45,150
"The Francis Wilson Gunnell Family Record",uus_mss301.xml,80444/xv40670,58,58,30,146
"Utah State University. Faculty. Publications of the faculty",uus_8_8_37.xml,80444/xv51663,50,42,52,144
"USU student folklore genre collection of supernatural nonreligious legends",uus_folkcoll008a_7supernaturalnonreligious.xml,80444/xv63192,14,42,87,143
"USU student folklore genre collection of tales and jokes",uus_folkcoll008a_4.xml,80444/xv83386,35,43,64,142
"John Kenneth Cannon Photograph Collection",uus_p0382.xml,80444/xv34939,34,39,69,142
"Dee Smith Photograph Collection",uus_p0438.xml,80444/xv10403,38,58,31,127
"The Crabtree Family Papers",uus_mss327.xml,80444/xv81130,42,57,27,126
"Utah State University graduate student fieldwork collection",uus_folkcoll008grad.xml,80444/xv78375,53,36,36,125
"C.E. Johnson photograph collection,",uus_p0011.xml,80444/xv91802,36,46,42,124
"William Alexander and Mary E. Carter papers",uus_cainemss029.xml,80444/xv50091,23,67,33,123
"Intermountain Indian School photograph collection",uus_p0327.xml,80444/xv45184,32,50,41,123
"Ridgway Family Papers",uus_cainemss008.xml,80444/xv13992,29,56,34,119
"Fife American Collection",uus_folkcoll004_2.xml,80444/xv14770,42,35,36,113
"Utah Construction Company/Bowman photograph collection",uus_p0328.xml,80444/xv43917,17,69,23,109
"Gary Smith Papers",uus_mss132.xml,80444/xv17303,45,33,31,109
"Leonard J. Arrington Papers",uus_ljaha001.xml,80444/xv42800,39,30,40,109
"Frederick P. Champ papers",uus_mss050.xml,80444/xv11087,42,29,38,109
"Ronald V. Jensen Living Historical Farm Photographs",uus_p0356.xml,80444/xv13534,36,33,35,104
"The Skaggs Foundation cowboy poetry collection : authors A-L",uus_folkcoll011_1.xml,80444/xv41781,35,25,42,102
"Delmar Clive Tingey Photograph Collection,",uus_p0015.xml,80444/xv17352,0,66,35,101
"Mormon immigrant portrait collection",uus_p0027.xml,80444/xv63992,40,31,29,100
"J. Edward Decker papers",uus_mss210.xml,80444/xv47717,27,35,36,98
"Teton Dam Disaster Oral History transcriptions and tapes",uus_mss058.xml,80444/xv11578,41,24,32,97
"C.R. Savage photograph collection",uus_p0038.xml,80444/xv85305,26,40,31,97
"Mormon Affidavits & Petitions Relating to the Missouri Persecutions",uus_cainemss019.xml,80444/xv20477,32,30,34,96
"Fife Mormon collection",uus_folkcoll004_1.xml,80444/xv34716,34,34,26,94
"Utah State University Fife Folklore Conference student fieldwork collection",uus_folkcoll008ffc.xml,80444/xv70388,34,30,29,93
"Utah-Idaho Central Railroad Company, Wellsville Station Papers",uus_mss061.xml,80444/xv28366,0,61,30,91
"James Foster Scott Papers",uus_mss180.xml,80444/xv36776,34,29,28,91
"World War II Rationing Stamps Program",uus_mss088.xml,80444/xv05780,23,42,25,90
"Ariel Benson photograph collection.",uus_p0471.xml,80444/xv25061,33,36,20,89
"Knights of Phythias. Resolute Lodge No. 16 (Mercur, Utah) ledger",uus_cainemss025.xml,80444/xv18304,0,57,32,89
"Joel E. Ricks Cache Valley history collection",uus_mss046.xml,80444/xv93618,32,32,25,89
"Agricultural College of Utah Cyanotypes,",uus_p0014.xml,80444/xv64944,34,25,29,88
"College of Natural Resources photograph collection",uus_p0526.xml,80444/xv55532,1,55,31,87
"The Skaggs Foundation cowboy poetry collection : authors M-Z,",uus_folkcoll011_2.xml,80444/xv27481,29,23,35,87
"Daryl Chase Photograph Collection",uus_p0131.xml,80444/xv01119,35,32,20,87
"Charles Gilbert Wood Papers",uus_mss191.xml,80444/xv62713,36,37,13,86
"Ranch Family Documentation Project",uus_folkcoll049.xml,80444/xv57559,28,26,30,84
"Robert Rust photograph collection",uus_p0317.xml,80444/xv05786,23,37,24,84
"Smithfield diaries",uus_mss034.xml,80444/xv24880,29,32,23,84
"Walter Lehrman Beat Generation photograph collection",uus_p0577.xml,80444/xv95904,17,17,48,82
"Simmonds family photograph collection",uus_p0105.xml,80444/xv05914,16,46,19,81
"Brigham Young College photograph and memorabilia collection,",uus_p0008.xml,80444/xv65588,22,33,26,81
"William B. Preston Papers",uus_mss268.xml,80444/xv91189,22,37,22,81
"Retired originals collection",uus_p0329.xml,80444/xv34088,18,29,34,81
"Winslow Whitney Smith Papers",uus_mss247.xml,80444/xv95111,1,56,23,80
"Gary Smith photograph collection",uus_p0106.xml,80444/xv43756,21,43,16,80
"The Grouse Creek (Utah) Cultural Survey collection",uus_folkcoll021.xml,80444/xv88137,28,27,25,80
"Charles Potts papers",uus_mss486.xml,80444/xv37246,24,26,29,79
"Alfred Gordon Erickson Photograph Collection",uus_p0479.xml,80444/xv14440,32,27,19,78
"John Henry Humphrey Barker papers",uus_mss025.xml,80444/xv44860,20,47,10,77
"Whitney Smith photograph collection",uus_p0034.xml,80444/xv25277,17,36,24,77
"S. George Ellsworth photograph collection",uus_p0025.xml,80444/xv10845,29,27,21,77
"Soemu Toyoda Tribunal Transcripts",uus_mss195.xml,80444/xv58850,20,19,38,77
"Ann Nolan Clark drafts",uus_mss023.xml,80444/xv44924,16,36,24,76
"George Washington Thatcher family papers",uus_mss047.xml,80444/xv79324,30,8,38,76
"Barre Toelken Fieldwork Image Collection",uus_folkcoll035a.xml,80444/xv44381,21,21,33,75
"Gustav Lorenz Becker Photograph Collection",uus_p0361.xml,80444/xv44802,24,28,23,75
"Living traditions of the Bear River Heritage Area survey",uus_folkcoll029.xml,80444/xv99685,21,29,24,74
"Raymond C. Somers photograph collection",uus_p0324.xml,80444/xv34503,29,25,20,74
"First National Bank of Logan- Credit",uus_mss171.xml,80444/xv01889,2,49,23,74
"World War II veterans scrapbook",uus_mss183.xml,80444/xv35894,13,36,25,74
"19th Century Western Stereo-views Collection",uus_p0349.xml,80444/xv28820,23,20,30,73
"The Jensen Historical Farm Research Collection",uus_mss236.xml,80444/xv57568,30,30,12,72
"F. Ross Peterson Papers",uus_mss252.xml,80444/xv34832,20,24,27,71
"Mormons for ERA",uus_mss225.xml,80444/xv98071,20,23,27,70
"USU student folklore genre collection of belief",uus_folkcoll008a_2.xml,80444/xv36322,11,19,39,69
"Brigham Young College records",uus_mss001.xml,80444/xv44787,18,29,22,69
"Lowry Nelson writings and papers",uus_mss017.xml,80444/xv58740,27,29,12,68
"Charles Ramsden Bailey papers",uus_mss053.xml,80444/xv05551,23,35,9,67
"George Thomas papers",uus_mss116.xml,80444/xv77001,23,25,18,66
"Daniel H. Wells Papers",uus_mss302.xml,80444/xv06524,33,13,19,65
"Roskelley Family Photograph Collection,",uus_p0013.xml,80444/xv34295,18,24,22,64
"Folklore in the news collection",uus_folkcoll032.xml,80444/xv04849,30,9,25,64
"Lundstrom Furniture Company records",uus_mss138.xml,80444/xv53833,21,27,16,64
"Gary B. Hansen papers",uus_mss319.xml,80444/xv99734,25,24,14,63
"Teton Dam disaster collection",uus_folkcoll027.xml,80444/xv94137,22,18,23,63
"Orson F. Whitney Letters",uus_mss167.xml,80444/xv43170,2,31,30,63
"Bullen Family Photographs,",uus_p0018.xml,80444/xv44619,16,26,20,62
"Dee Glen Smith Oral Histories",uus_mss273.xml,80444/xv77270,32,17,12,61
"S. George Ellsworth papers",uus_mss228.xml,80444/xv97897,20,20,19,59
"Morrisite collection",uus_cainemss010.xml,80444/xv02597,36,13,10,59
"William Neff Photograph Collection",uus_p0334.xml,80444/xv22091,29,22,8,59
"Range management collection",uus_bookcoll17.xml,80444/xv44946,14,22,22,58
"Woodland family papers",uus_mss490.xml,80444/xv47372,38,14,6,58
"Hector Lee field recording collection",uus_folkcoll006.xml,80444/xv47738,14,21,23,58
"Ida-Marie Jensen Papers",uus_mss062.xml,80444/xv39266,26,27,5,58
"San Francisco Punk Flyers collection",uus_mss523.xml,80444/xv17514,14,25,19,58
"J. Bracken Lee papers",uus_usuemss001.xml,80444/xv35812,27,20,11,58
"Brigham Young University student fieldwork collection",uus_folkcoll007.xml,80444/xv47683,16,9,32,57
"The Dolph Andrus photograph collection",uus_p0542.xml,80444/xv26892,7,23,26,56
"The Marie Fuhriman Olsen Oral History Collection",uus_folkcoll050.xml,80444/xv03970,13,15,27,55
"Harry Reuben Reynolds photograph collection,",uus_p0004.xml,80444/xv61871,15,28,12,55
"G. Malcolm Laws, Jr. papers",uus_mss232.xml,80444/xv03576,16,6,33,55
"Baker and Johnston photograph collection",uus_p0474.xml,80444/xv65188,18,25,12,55
"USU student folklore genre collection of customs",uus_folkcoll008a_1.xml,80444/xv09976,4,20,30,54
"Joseph Jeppe Larsen photograph collection",uus_p0372.xml,80444/xv79644,17,24,13,54
"Utah State University ROTC Photographs",uus_p0350.xml,80444/xv98254,19,19,16,54
"Dewitt/Palmer family photograph collection",uus_p0124.xml,80444/xv30398,22,16,16,54
"Ranch Family Documentation Project photograph collection",uus_p0467.xml,80444/xv34738,21,22,11,54
"Dr. William H. Hopkins Addendum Collection",uus_p0360.xml,80444/xv21139,6,26,21,53
"Thatcher Opera House photograph collection",uus_p0399.xml,80444/xv10479,17,18,18,53
"Samuel Roskelley papers",uus_mss065.xml,80444/xv00094,17,20,16,53
"Nelson B. Wadsworth papers",uus_mss458.xml,80444/xv03884,23,18,12,53
"Bullen Family Papers",uus_mss378.xml,80444/xv06408,21,20,12,53
"Logan Temple collection",uus_mss112.xml,80444/xv26461,23,17,13,53
"Lark, Utah, Oral Interviews",uus_mss339.xml,80444/xv15603,25,19,8,52
"Leonard J. Arrington photograph collection",uus_p0316.xml,80444/xv38223,19,23,10,52
"Intermountain Indian School architectural drawings",uus_mss493.xml,80444/xv62988,4,5,43,52
"Helen Mar Kimball Whitney Papers",uus_mss179.xml,80444/xv92462,24,8,19,51
"Gunn McKay Papers",uus_mss086.xml,80444/xv30389,24,7,20,51
"Charles H. Bridges, Jr., missionary diaries and correspondence",uus_mss308.xml,80444/xv54483,16,22,12,50
"Larsen Family Photograph Collection,",uus_p0006.xml,80444/xv12289,18,16,15,49
"Postcard collection",uus_p0031.xml,80444/xv12420,16,16,17,49
"Wheeler's geographical survey stereoscopic views",uus_p0325.xml,80444/xv05364,21,15,13,49
"The Papers of Congressman James V. Hansen",uus_mss351.xml,80444/xv82138,15,21,13,49
"Goodwin family photograph collection",uus_p0032.xml,80444/xv07397,13,19,15,47
"Floyd T. Morgan photograph collection",uus_p0414.xml,80444/xv66604,16,11,20,47
"Fife Folklore Archives student media collection",uus_folkcoll008b.xml,80444/xv44580,15,11,20,46
"Cache County Aerial photograph collection.",uus_p0383.xml,80444/xv84960,13,17,16,46
"Kenneth Wayne Brewer Papers",uus_mss275.xml,80444/xv39746,13,22,10,45
"Wayland D. Hand folklore papers",uus_mss297.xml,80444/xv71936,20,13,12,45
"The Latino/Latina Voices Project",uus_folkcoll038.xml,80444/xv83200,6,12,27,45
"Laura R. Merrill photograph collection",uus_p0362.xml,80444/xv75607,12,25,8,45
"Alonzo George Barber : papers",uus_mss079.xml,80444/xv87774,18,8,18,44
"Cache County plat map photograph collection",uus_p0322.xml,80444/xv85202,20,15,9,44
"Jens and Mary Emma Jensen collection",uus_mss392.xml,80444/xv64285,21,15,8,44
"Ida Hunt Udall photograph collection",uus_p0311.xml,80444/xv47448,18,18,8,44
"John Wilford Carlson papers",uus_mss027.xml,80444/xv19607,18,15,11,44
"William Alexander Carter, account ledger",uus_mss168.xml,80444/xv36462,14,23,6,43
"Orson F. Whitney Diaries",uus_mss188.xml,80444/xv04257,9,21,13,43
"Cache Valley Home & Garden Club Records",uus_mss336.xml,80444/xv06576,1,24,18,43
"Deseret String Band Collection",uus_folkcoll52.xml,80444/xv67947,13,18,12,43
"Gisbert Bossard/Max Florence Photograph Collection,",uus_p0002.xml,80444/xv28479,13,16,14,43
"Briant H. Stringham photograph collection",uus_p0365.xml,80444/xv96948,9,18,16,43
"John William Fitzgerald papers",uus_mss102.xml,80444/xv47512,15,8,19,42
"Ernest Fred Johnson World War I Papers",uus_mss326.xml,80444/xv24130,4,5,33,42
"William S. Wilson Iwo Jima photographs",uus_p0342.xml,80444/xv62976,14,16,12,42
"The North Cache High School Papers",uus_mss136.xml,80444/xv58230,15,11,16,42
"Joel Edward Ricks Papers",uus_mss114.xml,80444/xv08605,21,8,13,42
"Westminster College Student Folklore Collection",uus_folkcoll043.xml,80444/xv19088,3,8,30,41
"'Sun Pictures of Rocky Mountain Scenery' photograph collection,",uus_p0019.xml,80444/xv36932,12,9,20,41
"Newell Hart photographs",uus_p0251.xml,80444/xv79556,11,13,16,40
"Palmer DeLong papers",uus_mss519.xml,80444/xv98550,7,10,23,40
"L.M. Winsor papers",uus_mss098.xml,80444/xv30731,16,9,15,40
"Orson Winso Israelsen irrigation photographs",uus_p0358.xml,80444/xv03680,11,17,12,40
"Jan Roush Student Folklore Writing Collection",uus_mss259.xml,80444/xv58419,11,10,19,40
"Heber H. Thomas Photograph Collection",uus_p0466.xml,80444/xv46704,19,10,11,40
"Jefferson Middle School time capsule photograph collection",uus_p0145.xml,80444/xv04681,15,13,11,39
"Thatcher family photograph collection",uus_p0036.xml,80444/xv79000,18,11,10,39
"Thatcher Brothers Banking Co. records",uus_mss003.xml,80444/xv85131,22,8,9,39
"Gary B. Hansen Photograph Collection.",uus_p0384.xml,80444/xv40911,17,11,11,39
"Swaner Family Oral History Project",uus_folkcoll0060.xml,80444/xv46444,11,9,19,39
"USU student folklore genre collection of songs",uus_folkcoll008a_5.xml,80444/xv36282,6,8,24,38
"Herschel Bullen, Jr. papers",uus_mss178.xml,80444/xv78393,17,12,9,38
"Cache Valley Refugee Oral History Project",uus_folkcoll0058.xml,80444/xv67608,4,10,24,38
"George H. Emert Papers",uus_3_1_13_2.xml,80444/xv62786,18,11,9,38
"James O. Martin Civil War Collection",uus_mss285.xml,80444/xv97573,14,12,12,38
"D. Wynne Thorne Papers",uus_mss299.xml,80444/xv16235,1,0,36,37
"Nibley family photographs",uus_p0315.xml,80444/xv53207,11,13,13,37
"George W. Reed papers",uus_mss115.xml,80444/xv73352,8,18,11,37
"Sevier River Land and Water Company Papers",uus_mss334.xml,80444/xv87976,17,6,13,36
"Allen W. Stokes Papers",uus_mss215.xml,80444/xv30462,14,15,7,36
"The National Press Photographers Association Clip Contest collection",uus_p0136.xml,80444/xv25057,7,7,22,36
"H. Baxter Liebler papers",uus_cainemss011.xml,80444/xv38824,16,9,11,36
"Topaz Internment Camp Documents",uus_mss170.xml,80444/xv89102,20,10,6,36
"Christian Christiansen Bindrup papers",uus_mss030.xml,80444/xv28228,11,13,11,35
"John August Carlson papers",uus_mss026.xml,80444/xv99398,13,19,3,35
"Utah Wilderness Association records",uus_mss200.xml,80444/xv75259,12,11,12,35
"USU student folklore genre collection of contemporary legends",uus_folkcoll008a_7contemporary.xml,80444/xv15270,0,3,32,35
"USU Student Services photograph collection",uus_p0451.xml,80444/xv80895,4,19,12,35
"Susan Sunada papers",uus_mss059.xml,80444/xv04827,11,18,6,35
"William H. Hopkins photograph collection",uus_p0319.xml,80444/xv19689,9,17,9,35
"Cache Citizen Photograph Collection,",uus_p0379.xml,80444/xv59371,11,15,8,34
"USU student folklore genre collection of supernatural religious legends",uus_folkcoll008a_7supernaturalreligious.xml,80444/xv07513,14,8,12,34
"Valeen T. Avery Papers",uus_mss316.xml,80444/xv30181,7,11,16,34
"Moses Thatcher Sr. papers",uus_mss022.xml,80444/xv45404,6,15,13,34
"Austin E. and Alta S. Fife papers",uus_mss281.xml,80444/xv36505,23,2,9,34
"Nathaniel Vary Jones papers",uus_mss158.xml,80444/xv93057,18,5,11,34
"John M. Cannon papers",uus_mss270.xml,80444/xv74929,10,21,3,34
"James Crockwell photograph collection",uus_p0102.xml,80444/xv90728,19,6,9,34
"USU student folklore genre collection of games and pranks",uus_folkcoll008a_6.xml,80444/xv81375,3,8,23,34
"Anthon James Nielsen papers",uus_mss044.xml,80444/xv56246,10,10,13,33
"Edith Tippets Hayes Papers",uus_mss333.xml,80444/xv28457,10,8,15,33
"Heber Cyrus Snell papers",uus_mss032.xml,80444/xv09158,11,11,10,32
"Design Workshop, Inc.",uus_mss347.xml,80444/xv17855,16,10,6,32
"A. Ray Oliver photograph collection",uus_p0332.xml,80444/xv91738,7,20,5,32
"The Willis and Wayment Family Papers",uus_mss329.xml,80444/xv00292,8,21,3,32
"The Fife Folklore Conference collection",uus_folkcoll031.xml,80444/xv88607,4,8,20,32
"LuAnn Ferrin photograph collection",uus_p0127.xml,80444/xv02816,8,12,11,31
"John I. White photograph collection",uus_p0037.xml,80444/xv27459,11,11,9,31
"Susan Sunada addendum",uus_mss503.xml,80444/xv28784,10,11,10,31
"Sierra Club, Utah Chapter archives",uus_mss148.xml,80444/xv03390,16,8,7,31
"Fife Folklore Archives Oral History collection",uus_folkcoll037.xml,80444/xv89437,6,9,15,30
"Idaho 2nd Infantry Expedition to Mexico",uus_p0030.xml,80444/xv05407,7,11,12,30
"Utah Cooperative Association Photograph Collection.",uus_p0385.xml,80444/xv47692,17,5,8,30
"Vicky D. Burgess Papers",uus_mss321.xml,80444/xv97622,13,7,10,30
"William H. Neff Architectural Papers",uus_mss311.xml,80444/xv86810,22,3,5,30
"Charles W. Nibley Family Papers",uus_mss256.xml,80444/xv09713,14,9,7,30
"Tomáš G. Masaryk Papers",uus_mss233.xml,80444/xv40643,10,5,14,29
"Utah Grazing Notes",uus_mss009.xml,80444/xv20513,17,3,9,29
"Charles Batten Photograph Collection",uus_p0473.xml,80444/xv51470,13,11,5,29
"William Henry Jackson Hayden survey albertypes",uus_p0345.xml,80444/xv96304,8,7,14,29
"USU student folklore genre collection of character legends",uus_folkcoll008a_7character.xml,80444/xv53784,2,9,18,29
"R. Gilbert Moore papers",uus_mss514.xml,80444/xv44082,21,4,4,29
"Joseph Smith III portrait",uus_p0331.xml,80444/xv55429,13,11,4,28
"San Francisco Earthquake Snapshots",uus_p0346.xml,80444/xv10705,10,8,10,28
"Horace Hall Cummings family papers",uus_mss226.xml,80444/xv46743,14,7,7,28
"The William Budge Missionary Journal",uus_mss356.xml,80444/xv46035,5,14,8,27
"Samuel P. Cowley papers",uus_mss156.xml,80444/xv35003,2,13,12,27
"F. Ross Peterson Photograph Collection.",uus_p0391.xml,80444/xv72570,11,11,5,27
"Utah Cooperative Association",uus_mss129.xml,80444/xv28604,8,4,15,27
"Cowboy poetry poster collection",uus_folkcoll011h.xml,80444/xv07769,17,0,9,26
"Charles Kelly photograph collection,",uus_p0003.xml,80444/xv56350,8,15,3,26
"Anderson Lumber Co. Papers",uus_mss349.xml,80444/xv40185,12,12,2,26
"Willard and Bessie Ballard papers",uus_mss265.xml,80444/xv86831,2,18,6,26
"Elizabeth Pickett Tolman diary",uus_mss487.xml,80444/xv38537,9,10,7,26
"Episcopal Church bishop portraits",uus_p0028.xml,80444/xv13500,9,15,2,26
"Edward A. Ferguson World War II correspondence",uus_mss303.xml,80444/xv05856,6,17,3,26
"Orson Winso Israelsen papers",uus_mss031.xml,80444/xv95730,16,7,3,26
"USU student folklore genre collection of material culture",uus_folkcoll008a_8.xml,80444/xv71188,8,4,14,26
"Caroline Barnes Crosby family papers",uus_mss229a.xml,80444/xv40148,16,8,1,25
"Rocky Mountain Faculty Athletic Conference archives",uus_mss014.xml,80444/xv28643,3,10,12,25
"Smithfield Oral History Project",uus_folkcoll048.xml,80444/xv91705,12,4,9,25
"Addison Pratt family papers",uus_mss228b.xml,80444/xv39932,14,5,6,25
"USU student folklore genre collection of E-lore",uus_folkcoll008a_9.xml,80444/xv32928,0,9,16,25
"Cache Community Connections Oral History Project",uus_folkcoll047.xml,80444/xv38369,3,4,18,25
"Death Valley region photographs",uus_p0126.xml,80444/xv54928,6,13,6,25
"USU Athletics photograph collection",uus_p0418.xml,80444/xv96463,7,10,8,25
"Melville Irrigation Company Papers",uus_mss140.xml,80444/xv09545,6,12,7,25
"Ione Bennion photograph collection",uus_p0371.xml,80444/xv58987,5,13,6,24
"Betsy Jane Tenney Loose Papers",uus_mss177.xml,80444/xv02523,8,12,4,24
"Champ family papers",uus_mss130.xml,80444/xv96951,8,7,9,24
"John W. Fitzgerald Photograph Collection.",uus_p0377.xml,80444/xv60314,12,9,3,24
"Sam Agins collection : reel-to-reel tapes",uus_folkcoll030d.xml,80444/xv92489,12,1,11,24
"Virginia Hanson papers",uus_mss217.xml,80444/xv27334,7,3,14,24
"USU student folklore genre collection of human condition legends",uus_folkcoll008a_7humancondition.xml,80444/xv14239,7,6,11,24
"Larry Elsner sketchbooks",uus_mss511.xml,80444/xv80178,9,7,7,23
"Veneta Nielsen Papers",uus_mss315.xml,80444/xv63449,12,0,11,23
"Utah/Idaho High Altitude Aerial Photograph Collection",uus_p0330.xml,80444/xv47143,7,10,6,23
"Diary of Mary Emma Bird",uus_mss151.xml,80444/xv41799,7,8,8,23
"Tueller family photograph collection",uus_p0204.xml,80444/xv40466,6,3,14,23
"Laurence A. Stoddart Papers",uus_mss51.xml,80444/xv04498,12,7,4,23
"Arthur D. Smith range management photograph collection",uus_p0021.xml,80444/xv28894,5,11,7,23
"L.M. Winsor photograph collection",uus_p0343.xml,80444/xv40353,9,6,8,23
"Austin Fife photograph collection,",uus_p0141.xml,80444/xv35012,9,6,8,23
"Women's Literary Club Papers (Logan, Utah),",uus_mss254.xml,80444/xv44360,14,0,9,23
"George B. Caine papers",uus_mss298.xml,80444/xv27697,1,13,9,23
"Oliver A. Jenson photograph collection",uus_p0357.xml,80444/xv48406,6,9,8,23
"Frankland J. Kennard Vernal CCC Camp photographs,",uus_p0108.xml,80444/xv74862,9,9,5,23
"Mary Lucetta Shumway Thompson Diaries",uus_mss052.xml,80444/xv31256,2,0,20,22
"Ted W. Daniel Photograph Collection",uus_p0373.xml,80444/xv25793,5,8,9,22
"David Lane Wright papers",uus_mss002.xml,80444/xv41299,3,14,5,22
"Orson Smith Papers",uus_mss357.xml,80444/xv11541,7,11,4,22
"Irene Griffith Talbot correspondence",uus_mss452.xml,80444/xv02798,14,5,3,22
"Miscellaneous Oral History Collection",uus_mss461.xml,80444/xv81146,4,18,0,22
"Bear River Migratory Bird Refuge photographs,",uus_p0020.xml,80444/xv89230,2,14,6,22
"Carlton Culmsee papers",uus_mss221.xml,80444/xv21850,4,8,10,22
"Millville History Collection, <emph render="italic">Millville Memories</emph> Papers,",uus_mss161.xml,80444/xv77334,1,12,9,22
"The LaGrande Peterson family photograph collection",uus_p0110.xml,80444/xv61688,12,6,4,22
"Design Workshop, Inc. Photographs",uus_p0394.xml,80444/xv93600,6,7,9,22
"Wasatch Research Center photograph collection",uus_p0464.xml,80444/xv09982,8,9,5,22
"Jeff Goldberg papers",uus_mss492.xml,80444/xv34649,12,5,5,22
"Bear River Club histories",uus_mss427.xml,80444/xv92996,6,3,12,21
"Nolan James Nelson photograph collection",uus_p0388.xml,80444/xv09738,6,7,8,21
"Eva Wennergren Diaries",uus_mss152.xml,80444/xv36825,6,1,14,21
"September 11, 2001 USU student documentary collection",uus_folkcoll026.xml,80444/xv87231,3,8,10,21
"Deta P. Neeley Papers",uus_mss277.xml,80444/xv77606,13,7,1,21
"Davis and Weber Counties Canal Company papers",uus_mss111.xml,80444/xv28564,9,8,4,21
"Brigham Young financial records",uus_mss042.xml,80444/xv94705,15,1,5,21
"Folklore newsletter collection",uus_folkcoll015.xml,80444/xv59460,4,3,14,21
"Richard Welling Roskelley Papers",uus_mss284.xml,80444/xv37164,1,11,9,21
"J.P. Smith Printing Company records",uus_mss431.xml,80444/xv99395,10,9,2,21
"Italian-Americans in the West : Utah section collection",uus_folkcoll033.xml,80444/xv04876,10,1,10,21
"USU Interfaith Initiative",uus_folkcoll0057.xml,80444/xv23181,10,0,11,21
"Mary Taggart papers",uus_mss406.xml,80444/xv25103,2,16,3,21
"Vanez T. Wilson Photograph Collection",uus_p0468.xml,80444/xv43038,12,4,4,20
"Sam Agins collection: fieldwork cassette tapes",uus_folkcoll030f.xml,80444/xv00045,3,6,11,20
"Addison Pratt Research",uus_mss228e.xml,80444/xv00946,8,5,7,20
"Utah Wilderness Association photograph collection",uus_p0369.xml,80444/xv30990,8,4,8,20
"Utah State University student activity photographs",uus_p0312.xml,80444/xv61947,6,9,5,20
"Joseph Arch Geddes photograph collection",uus_p0112.xml,80444/xv92306,8,7,5,20
"Cache Valley Presbyterian Church Oral History Collection",uus_folkcoll044.xml,80444/xv10546,5,7,8,20
"Utah-Idaho Central Railroad Company, Mendon Station Papers",uus_mss60.xml,80444/xv94613,7,6,7,20
"Maxwell D. Cohn photograph collection,",uus_p0007.xml,80444/xv67819,5,11,4,20
"Papers of General John Kenneth Cannon",uus_mss041.xml,80444/xv25619,9,6,5,20
"John N. Downing family business records",uus_mss264.xml,80444/xv51113,13,2,5,20
"Logan Boy Scout Troop 5 photograph album",uus_p0364.xml,80444/xv43746,4,12,4,20
"James E. Sisson III Papers",uus_mss290.xml,80444/xv96170,5,10,5,20
"Clyde T. Hardy photograph collection",uus_p0392.xml,80444/xv27523,4,10,6,20
"James Foster Scott photograph collection",uus_p0120.xml,80444/xv96627,4,6,9,19
"Anderson Photograph Studio archive",uus_p0252.xml,80444/xv94003,5,8,6,19
"Bartlie T. Cardon Photograph Collection,",uus_p0005.xml,80444/xv27099,7,7,5,19
"John I. White papers",uus_mss201.xml,80444/xv41470,6,3,10,19
"Blacksmith Fork Canyon photographs,",uus_p0026.xml,80444/xv08462,7,9,3,19
"West Cache Irrigation Company : records",uus_mss097.xml,80444/xv95013,6,10,3,19
"Thatcher family papers",uus_mss093.xml,80444/xv03115,13,3,3,19
"American Gold Star Mothers minutes and scrapbook",uus_mss049.xml,80444/xv82891,9,4,6,19
"David Lane Wright addendum",uus_mss039.xml,80444/xv85739,2,12,5,19
"Laura R. Merrill papers",uus_mss119.xml,80444/xv33587,10,1,8,19
"League of Women Voters of Cache County papers",uus_mss155.xml,80444/xv03283,6,3,10,19
"Public Folklore Collection",uus_folkcoll45.xml,80444/xv08578,3,6,10,19
"French family album,",uus_p0109.xml,80444/xv69393,4,10,5,19
"Nat Stein Papers",uus_msscaine027.xml,80444/xv15707,10,4,5,19
"Edward P. Cliff papers",uus_mss013.xml,80444/xv19540,11,7,1,19
"Briant H. Stringham papers",uus_mss048.xml,80444/xv12982,1,8,9,18
"Edwin L. Peterson Family Photograph Collection",uus_p0393.xml,80444/xv11560,3,9,6,18
"Capitol Theatre papers",uus_cainemss009.xml,80444/xv95581,11,1,6,18
"Twin Lakes Canal Company Papers",uus_mss203.xml,80444/xv50668,11,3,4,18
"Joseph Jeppe Larsen Papers",uus_mss312.xml,80444/xv38836,6,9,3,18
"Sonne, Conway B",uus_p0118.xml,80444/xv30316,5,8,5,18
"Ray B. West Papers",uus_mss076.xml,80444/xv74850,7,5,6,18
"Sorensen Family Papers",uus_mss344.xml,80444/xv97113,12,6,0,18
"Norman V. Hancock papers",uus_mss489.xml,80444/xv97512,12,0,6,18
"Jay Anderson foodways research collection",uus_folkcoll017b.xml,80444/xv81814,7,1,10,18
"American Falls Canal and Power Company papers",uus_mss109.xml,80444/xv07412,3,8,7,18
"USU Homecoming Photograph Collection",uus_p0387.xml,80444/xv67614,3,9,6,18
"LaGrande Peterson Family Papers",uus_mss313.xml,80444/xv51501,6,6,6,18
"Sylvan E. Needham, Sr. Photo Album",uus_p0117.xml,80444/xv64611,6,7,5,18
"Anti-litter campaign collection",uus_mss104.xml,80444/xv89120,9,1,7,17
"Mae Crookston Wennegren photograph collection",uus_p0130.xml,80444/xv90267,5,7,5,17
"Father Harold Baxter Liebler and Brother Juniper photograph collection,",uus_p0103.xml,80444/xv40399,7,3,7,17
"Water in the West",uus_bookcoll38.xml,80444/xv84716,8,3,6,17
"Noble Nielsen photograph collection",uus_p0363.xml,80444/xv78729,1,5,11,17
"Swett Ranch Oral Histories",uus_mss283.xml,80444/xv65576,2,3,12,17
"Arthur W. Hart Papers",uus_cainemss013.xml,80444/xv68853,8,4,5,17
"Cache Valley Historical Society Papers",uus_mss043.xml,80444/xv86056,7,6,4,17
"George Dewey Clyde Photograph Collection",uus_p0374.xml,80444/xv41268,4,6,7,17
"Patience Thatcher diaries and papers",uus_mss405.xml,80444/xv32418,8,7,2,17
"Napper family photograph collection",uus_p0359.xml,80444/xv34826,5,10,2,17
"Clair Smith Papers",uus_mss248.xml,80444/xv97775,9,4,4,17
"Richmond history papers",uus_mss434.xml,80444/xv20797,7,9,1,17
"Papers of John T. Caine",uus_cainemss33.xml,80444/xv36392,3,7,7,17
"Logan City School District",uus_mss237.xml,80444/xv59082,7,7,3,17
"Oliver L. Peterson : diaries",uus_mss101.xml,80444/xv49771,6,5,5,16
"Harry Reuben Reynolds papers",uus_mss106.xml,80444/xv00973,8,7,1,16
"United States Bureau of Fisheries photographs,",uus_p0016.xml,80444/xv54602,0,10,6,16
"Royce S. Bringhurst Papers",uus_mss515.xml,80444/xv47241,0,16,0,16
"Franklin County Beet Growers papers",uus_mss205.xml,80444/xv81994,6,7,3,16
"Twin Lakes Canal Company photograph collection",uus_p0029.xml,80444/xv68890,8,6,2,16
"Senator John P. Holmgren papers",uus_mss133.xml,80444/xv07669,5,7,4,16
"May Swenson addendum",uus_mss485.xml,80444/xv85885,10,4,2,16
"Ed Decker photograph collection",uus_p0344.xml,80444/xv14385,11,1,4,16
"Carlton Fordis Culmsee photograph collection",uus_p0128.xml,80444/xv13189,6,2,8,16
"Kenneth Wayne Brewer Photographs",uus_p0381.xml,80444/xv99295,7,3,6,16
"The Folklore Society of Utah Collection.",uus_folkcoll028.xml,80444/xv90362,0,3,13,16
"Shoshone Indian portrait collection",uus_p0292.xml,80444/xv63784,1,5,10,16
"Cache Valley medical literature collection",uus_mss286.xml,80444/xv23010,5,5,6,16
"Jenny M. Smith's Indian Student Placement Program oral histories",uus_mss294.xml,80444/xv48199,4,11,1,16
"Singin' Sam Agins photograph collection",uus_p0134.xml,80444/xv30285,1,7,8,16
"Davis County Watershed Rehabilitation and Management Articles and Reports",uus_mss479.xml,80444/xv26565,12,3,1,16
"Emily H. Richardson papers",uus_mss403.xml,80444/xv26074,13,0,3,16
"Grant Redford Papers",uus_mss245.xml,80444/xv04086,10,6,0,16
"Abby Groesbeck Jenson diaries and account books",uus_mss123.xml,80444/xv72714,0,3,12,15
"Pratt family photograph collection",uus_p0280.xml,80444/xv51733,7,5,3,15
"Dr. George F. Knowlton photograph collection",uus_p0115.xml,80444/xv24218,4,6,5,15
"Bishop and Peterson Professional Engineers papers",uus_mss045.xml,80444/xv70272,3,8,4,15
"Lincoln Ellison Papers",uus_mss317.xml,80444/xv03265,7,4,4,15
"Fred W. Hodgson Architectural Drawings",uus_mss346.xml,80444/xv54293,6,5,4,15
"Serge N. Benson Papers,",uus_mss323.xml,80444/xv01089,10,5,0,15
"The Papers of Alison Comish Thorne",uus_mss216.xml,80444/xv46170,4,0,11,15
"Callister Family Papers",uus_mss335.xml,80444/xv71298,4,8,3,15
"Lisa Godfrey thesis papers",uus_mss276.xml,80444/xv19744,5,7,3,15
"George H. Robinson photograph collection",uus_p0272.xml,80444/xv10635,9,1,5,15
"LeGrande Rich Humphreys papers",uus_mss036.xml,80444/xv62307,7,4,4,15
"Melba Johnson World War II correspondence",uus_mss309.xml,80444/xv79614,8,1,6,15
"John Suiter papers",uus_mss480.xml,80444/xv25408,9,3,3,15
"Wayne D. Criddle papers",uus_mss307.xml,80444/xv73931,3,4,8,15
"Milton Merrill papers",uus_mss080.xml,80444/xv48666,7,4,4,15
"Henry Peterson papers",uus_mss105.xml,80444/xv01531,10,2,3,15
"Ione Bennion Papers",uus_mss320.xml,80444/xv99368,0,1,14,15
"Central Utah Project: Capturing Utah's share of the Colorado River",uus_folkcoll056.xml,80444/xv59140,4,3,8,15
"Wilford R. Gardner papers",uus_mss269.xml,80444/xv40728,6,6,3,15
"Providence City Oral History Project",uus_folkcoll053.xml,80444/xv22653,1,7,7,15
"William F. Lye South African manuscripts",uus_mss260.xml,80444/xv89343,3,1,11,15
"Mormon enigma : Emma Hale Smith : manuscript",uus_mss085.xml,80444/xv04064,3,6,6,15
"William Theron Barker photograph collection",uus_p0123.xml,80444/xv60037,6,7,2,15
"Logan Temple Time Books",uus_mss223.xml,80444/xv92761,5,4,6,15
"Collecting Memories: Oral Histories of American Folklorists",uus_folkcoll046.xml,80444/xv25149,2,2,11,15
"Carl E. Hayden National Forest collection",uus_mss015.xml,80444/xv30307,2,12,1,15
"William A. Wilson slide collection",uus_folkcoll034.xml,80444/xv09179,3,0,11,14
"Alfred H. Caine papers",uus_cainemss016.xml,80444/xv01837,9,5,0,14
"Smith Brothers Lumber Company Papers",uus_mss342.xml,80444/xv19256,0,7,7,14
"Architectural Design West PC papers",uus_archmss1.xml,80444/xv90505,7,4,3,14
"Sevier County Drainage District #4 Records",uus_mss235.xml,80444/xv51940,6,6,2,14
"Mormons for ERA photograph collection",uus_p0144.xml,80444/xv97470,4,5,5,14
"Joel E. Fletcher Photograph Collection",uus_p0380.xml,80444/xv62557,4,5,5,14
"The American Association of University Women",uus_mss124.xml,80444/xv52825,1,0,13,14
"Mathew M. Forster Photograph Collection,",uus_p0010.xml,80444/xv67327,6,4,4,14
"Wayne O. Goodwin family papers",uus_mss258.xml,80444/xv76406,10,1,3,14
"Joan Crum: Deer Lodge, Montana Genealogies",uus_mss157.xml,80444/xv02322,5,6,3,14
"First Presbyterian Church of Logan collection",uus_p0132.xml,80444/xv25958,2,10,2,14
"LaVell Cooley photograph collection",uus_p0101.xml,80444/xv30639,2,5,7,14
"David Lane Wright photograph collection",uus_p0135.xml,80444/xv40310,5,6,3,14
"US Forest Service Photograph Collection.",uus_p0378.xml,80444/xv38040,4,6,4,14
"Ralph A. Busco's Research on German and Italian P.O.W.s in Utah and Idaho",uus_mss134.xml,80444/xv28619,4,6,4,14
"Utah State University student fieldwork collection",uus_folkcoll008fieldwork.xml,80444/xv77713,5,2,7,14
"Edgar B. Brossard addendum",uus_mss220.xml,80444/xv19741,4,8,2,14
"Bound manuscripts collection",uus_mss238.xml,80444/xv65136,0,4,10,14
"The Reverend Paul Jones Photographs 1913 Collection",uus_p0564.xml,80444/xv77029,10,4,0,14
"Lyman S. Willardson Photograph Collection",uus_p0419.xml,80444/xv87838,2,7,5,14
"Herschel Bullen, Sr. papers",uus_mss182.xml,80444/xv92745,2,8,4,14
"St. John's Episcopal Church : records",uus_mss077.xml,80444/xv54885,8,4,2,14
"Frank Calkins papers",uus_mss029.xml,80444/xv48287,4,9,1,14
"Cache Valley Cowboy Rendezvous Collection",uus_folkcoll051.xml,80444/xv57254,3,6,4,13
"Old Main Fire photograph collection",uus_p0430.xml,80444/xv92965,2,4,7,13
"Cache Valley portfolio",uus_p0122.xml,80444/xv95721,1,8,4,13
"Utah State University Logan Canyon Land Use Management Oral History Collection",uus_folkcoll042.xml,80444/xv87823,0,3,10,13
"Utah capitol competition : project of Cannon, Fetzer and Ramm Hansen Architects",uus_p0107.xml,80444/xv06521,4,4,5,13
"Glen Taggart photograph collection",uus_p0426.xml,80444/xv96279,0,9,4,13
"Logan Artists Group papers",uus_mss126.xml,80444/xv06213,7,1,5,13
"Singin' Sam Agins papers",uus_mss230.xml,80444/xv00067,5,0,8,13
"Edgar Bentley Mitchell Papers",uus_mss322.xml,80444/xv06356,5,3,5,13
"Willie Ottogary Papers",uus_mss263.xml,80444/xv27645,9,0,4,13
"Thatcher Brothers Banking Company Safety Deposit Boxes",uus_mss175.xml,80444/xv98931,2,3,8,13
"The Yellowstone Fires of 1988 Thesis Research Materials",uus_mss330.xml,80444/xv22000,12,1,0,13
"Utah State University historical materials",uus_10_2.xml,80444/xv58856,1,4,8,13
"Gäbler family papers",uus_mss513.xml,80444/xv58404,12,0,1,13
"Walter H. Gardner collection",uus_mss057.xml,80444/xv54290,0,6,7,13
"B. G. Olesen Western Manuscript Collection",uus_mssolesen1.xml,80444/xv39083,7,6,0,13
"College of Agriculture photograph collection.",uus_p0624.xml,80444/xv21826,8,4,1,13
"Richard Welling Roskelley photograph collection",uus_p0429.xml,80444/xv71099,1,2,10,13
"American Civil Liberties Union versus the Logan School District collection",uus_mss056.xml,80444/xv33258,12,0,1,13
"Sidney Stevens Implement Company papers",uus_mss007.xml,80444/xv98147,4,8,1,13
"Golden Spike Oral Histories",uus_mss291.xml,80444/xv69232,9,4,0,13
"Howell family papers",uus_cainemss005.xml,80444/xv52868,3,6,3,12
"Peter Schmid photograph collection",uus_p0314.xml,80444/xv99591,3,4,5,12
"Howard L. Cox papers",uus_mss006.xml,80444/xv19439,5,5,2,12
"Maria Ellsworth papers",uus_mss229.xml,80444/xv05932,2,8,2,12
"Whitney and Alice Smith Collection",uus_mss379.xml,80444/xv50393,9,3,0,12
"World War II collection",uus_mss478.xml,80444/xv15484,3,4,5,12
"Daryl Chase Papers",uus_3_1_10_2.xml,80444/xv29708,3,3,6,12
"Preston School District Time Capsule",uus_mss239.xml,80444/xv66238,5,3,4,12
"Topons Canal Company documents",uus_mss108.xml,80444/xv96429,11,0,1,12
"Cache County (Utah) school districts papers",uus_mss040.xml,80444/xv36645,8,3,1,12
"Sam Agins collection : video and beta tapes",uus_folkcoll030c.xml,80444/xv10778,5,1,6,12
"Fort Washakie photograph collection",uus_p0291.xml,80444/xv07904,0,5,7,12
"Henry Clark Jackson papers",uus_mss475.xml,80444/xv52612,4,3,5,12
"Business and Professional Women's Club, Logan chapter papers",uus_mss120.xml,80444/xv30813,4,0,8,12
"Merrill family papers",uus_mss117.xml,80444/xv62222,4,8,0,12
"Samuel E. Clark Papers",uus_mss366.xml,80444/xv65689,12,0,0,12
"Utah Cooperative Extension Division Photographs,",uus_p0017.xml,80444/xv92532,0,8,4,12
"Samuel Claridge research",uus_mss228c.xml,80444/xv52444,1,8,3,12
"John F. Blauer World War I photograph collection",uus_p0502.xml,80444/xv15933,5,2,5,12
"Wayne D. Criddle photograph collection",uus_p0353.xml,80444/xv38586,4,3,5,12
"Cache Chamber of Commerce papers",uus_mss293.xml,80444/xv54714,1,4,7,12
"Utah juniper photograph collection",uus_p0366.xml,80444/xv82354,1,4,7,12
"Charles R. Batten papers",uus_mss426.xml,80444/xv47259,3,8,1,12
"Rhett James collection",uus_mss456.xml,80444/xv40319,1,5,6,12
"W.P.A. history of grazing collection",uus_mss008.xml,80444/xv44970,3,3,6,12
"Paul Swenson Papers",uus_mss476.xml,80444/xv94833,1,2,9,12
"Raymond and Samuel Taylor Correspondence",uus_mss145.xml,80444/xv46853,5,6,1,12
"Bobbie Coray Papers",uus_mss422.xml,80444/xv16729,0,3,9,12
"Jack and Hildreth Webb papers",uus_mss510.xml,80444/xv33914,2,6,4,12
"Doyle Rees photograph collection",uus_p0408.xml,80444/xv97671,6,2,4,12
"A. Douglas Allen Photo Collection",uus_p0476.xml,80444/xv74545,3,3,6,12
"Sorosis Society photograph collection",uus_p0139.xml,80444/xv26745,1,5,5,11
"USU Student Folklore Genre Collection of Riddles",uus_folkcoll008a_10.xml,80444/xv28958,0,0,11,11
"Bear River High School records",uus_mss413.xml,80444/xv26382,7,1,3,11
"E.G. Peterson Papers",uus_3_1_6_2.xml,80444/xv37738,7,3,1,11
"USU Irrigation Engineering Photograph Collection.",uus_p0389.xml,80444/xv37344,2,7,2,11
"Papers of Louis L. Madsen",uus_3_1_8_2.xml,80444/xv65524,0,6,5,11
"Klaus J. Hansen papers",uus_mss457.xml,80444/xv93377,4,3,4,11
"The Utah Education Association Papers",uus_mss063.xml,80444/xv97463,8,3,0,11
"Asa Wayne Arrington photograph collection",uus_p0428.xml,80444/xv22451,4,4,3,11
"George D. Clyde research materials",uus_mss279.xml,80444/xv05313,10,1,0,11
"Papers of Henry Aldous Dixon",uus_3_1_9_2.xml,80444/xv15014,8,3,0,11
"Walter Hoge papers",uus_mss300.xml,80444/xv53213,4,5,2,11
"James Prestini Collection",uus_mss360.xml,80444/xv58071,4,3,4,11
"Trenton-Clarkston Mill and Elevator Company Records",uus_mss198.xml,80444/xv61959,1,2,8,11
"James C. Miller Papers",uus_mss35.xml,80444/xv16857,4,5,2,11
"Cardon Realty Company",uus_mss173.xml,80444/xv91821,7,1,3,11
"David King and Ida F. Hunt Udall family papers,",uus_mss229b.xml,80444/xv02365,5,3,3,11
"USU Libraries",uus_p0420.xml,80444/xv67642,6,3,2,11
"Cache County records collection",uus_countymss001.xml,80444/xv90603,4,3,4,11
"Utah Weather Station Records",uus_mss470.xml,80444/xv90377,7,2,2,11
"R. Gilbert Moore photograph collection.",uus_p0552.xml,80444/xv10253,11,0,0,11
"Frederick P. Champ photograph collection",uus_p0354.xml,80444/xv67022,3,1,7,11
"Hatch correspondence",uus_mss070.xml,80444/xv56259,3,4,4,11
"Pleasant View, Utah, LDS Relief Society Records",uus_mss266.xml,80444/xv07159,7,3,1,11
"The Papers of Kermit Hall",uus_3_1_14_2.xml,80444/xv44030,3,2,6,11
"USU student folklore genre collection of etiological legends",uus_folkcoll008a_7etiological.xml,80444/xv52661,3,0,8,11
"Papers of Lyman Willardson",uus_14_4_2_45b.xml,80444/xv46841,8,0,3,11
"Utah State Agricultural College. College of Engineering. Office of the Dean. Dean's war production training files",uus_rg14_4_1_17a.xml,80444/xv10772,10,0,1,11
"Scrapbook of Liquor Related Articles from Rigby, Idaho",uus_mss193.xml,80444/xv04626,6,0,5,11
"Logan 7th Ward Treasurer's Cash Account Ledger",uus_mss162.xml,80444/xv40505,4,3,4,11
"Martin Harris Pageant records",uus_mss243.xml,80444/xv05999,4,2,4,10
"Thurlow Smith and Mary LaRene Butler Smith Diaries",uus_mss483.xml,80444/xv62030,5,3,2,10
"Utah Boys' State participant records",uus_mss096.xml,80444/xv52536,9,0,1,10
"Utah State Farm Bureau vs. National Farmers Union Service court documents",uus_mss495.xml,80444/xv09707,6,1,3,10
"Utah Mortgage and Loan Corporation Records",uus_mss131.xml,80444/xv90945,1,6,3,10
"Broberg Family photograph collection",uus_p0422.xml,80444/xv46154,9,0,1,10
"Allan M. West : papers",uus_mss078.xml,80444/xv15527,5,5,0,10
"Western Sustainable Agricultural Research and Education (SARE)",uus_17_41_58.xml,80444/xv02770,1,4,5,10
"Parkinson Family letters",uus_mss521.xml,80444/xv05084,3,4,3,10
"Leon C. Gaylord papers",uus_mss150.xml,80444/xv20632,0,6,4,10
"Utah American Revolution Bicentennial Commission papers",uus_mss092.xml,80444/xv44110,7,3,0,10
"Heber C. Snell photograph collection",uus_p0133.xml,80444/xv31680,2,6,2,10
"Aaron Parley Christiansen daybooks",uus_mss094.xml,80444/xv02026,5,1,4,10
"Stoddard Family Papers",uus_mss137.xml,80444/xv64852,8,0,2,10
"Echo Roller Mill papers",uus_mss127.xml,80444/xv96887,3,2,5,10
"Lynn S. Huffaker daybooks",uus_mss153.xml,80444/xv93469,10,0,0,10
"Community Improvement Through Local History Project oral histories",uus_mediacoll006.xml,80444/xv47653,3,4,3,10
"Louise Degn Broadcast Archive",uus_mss437.xml,80444/xv07925,1,5,4,10
"Jack H. Berryman papers",uus_mss289.xml,80444/xv29833,3,2,5,10
"Utah Resettlement Project Papers",uus_mss146.xml,80444/xv53985,7,2,1,10
"University of California at Berkeley photograph album",uus_p0035.xml,80444/xv95510,0,5,5,10
"International Association of Laboratory Schools Collection",uus_mss287.xml,80444/xv37561,2,8,0,10
"Willis Dial Thesis Materials",uus_mss367.xml,80444/xv39877,10,0,0,10
"United States Geologic Survey photograph collection,",uus_p0116.xml,80444/xv26754,0,4,6,10
"William D. Hurst Papers",uus_mss362.xml,80444/xv73037,1,0,9,10
"Thomas Family Letters",uus_mss337.xml,80444/xv12951,10,0,0,10
"James Bradley papers",uus_mss455.xml,80444/xv36358,6,0,4,10
"Kenneth Godfrey Papers",uus_mss399.xml,80444/xv71551,3,5,2,10
"May Swenson papers",uus_mss282.xml,80444/xv48208,1,0,9,10
"USU Student Union Photograph Collection",uus_p0367.xml,80444/xv08700,0,7,2,9
"Miscellaneous snapshots collection",uus_p0113.xml,80444/xv24743,3,2,4,9
"USU Sorority Women's Intramurals photograph collection",uus_p0439.xml,80444/xv20159,1,2,6,9
"Petra Horn-Marsh oral history collection",uus_mss444.xml,80444/xv48461,0,7,2,9
"Cache County American Legion Obituaries",uus_mss192.xml,80444/xv04495,9,0,0,9
"Darrin Smith photograph collection.",uus_p0351_darrinsmith.xml,80444/xv78707,0,8,1,9
"B.A. Etcheverry water reclamation photograph collection",uus_p0104.xml,80444/xv93203,0,5,4,9
"Federal Resettlement Project Oral Histories",uus_mss401.xml,80444/xv72448,5,2,2,9
"Hezekiah Sumner Hatch family photographs",uus_p0530.xml,80444/xv24789,3,3,3,9
"John A. and Leah D. Widtsoe photograph collection",uus_p0250.xml,80444/xv49136,2,4,3,9
"Joseph Arch Geddes papers",uus_mss075.xml,80444/xv84576,1,3,5,9
"George C. Jensen : papers",uus_mss073.xml,80444/xv89889,0,4,5,9
"John W. Young Papers",uus_cainemss026.xml,80444/xv58990,1,3,5,9
"Jack H. Berryman Photograph Collection",uus_p0368.xml,80444/xv99505,1,2,6,9
"Newton Library photograph collection.",uus_p0584.xml,80444/xv99536,2,3,4,9
"Cache Chamber of Commerce Photographs and Films.",uus_p0404.xml,80444/xv52014,4,4,1,9
"American Civil Liberties Union, Logan Chapter records",uus_mss261.xml,80444/xv18704,3,1,5,9
"John S. Flannery papers",uus_mss271.xml,80444/xv61898,2,4,3,9
"The Salt Lake Opera Company Records",uus_cainemss30.xml,80444/xv66668,6,1,2,9
"Merl LaVoy photograph collection.",uus_p0601.xml,80444/xv56622,7,2,0,9
"Conway B. Sonne Papers",uus_ljahamss008.xml,80444/xv70040,8,0,1,9
"Galand Neild Papers",uus_mss280.xml,80444/xv47650,0,0,9,9
"Papers of the Hyde Park Ladies Literary Club",uus_cainemss021.xml,80444/xv31750,9,0,0,9
"Stanford O. Cazier Papers",uus_3_1_12_2.xml,80444/xv80923,6,2,1,9
"Brant C. Short Sagebrush Rebellion Papers",uus_mss391.xml,80444/xv20138,8,1,0,9
"Western views photograph album",uus_p0205.xml,80444/xv80541,4,1,4,9
"Camp Downey oral histories",uus_mss468.xml,80444/xv21667,1,1,7,9
"Rodello Hunter papers",uus_mss028.xml,80444/xv89083,3,4,2,9
"Wilson F. McDill Papers",uus_mss122.xml,80444/xv63098,2,0,7,9
"Donald A. Drage papers",uus_mss385.xml,80444/xv91180,0,5,3,8
"Edwin L. Peterson World War II Propaganda",uus_mss274.xml,80444/xv38583,5,2,1,8
"Delta Elementary School yearbook photograph collection",uus_p0140.xml,80444/xv50350,0,2,6,8
"Seventh Ward Irrigation Company : records",uus_mss100.xml,80444/xv59255,8,0,0,8
"Kootenai River Valley agricultural photographs",uus_p0125.xml,80444/xv45227,0,5,3,8
"Allen Ginsberg photograph collection.",uus_p0591.xml,80444/xv21716,8,0,0,8
"E. LaRetta Gibbons missionary diary",uus_mss288.xml,80444/xv01077,5,1,2,8
"International Cooperation Association general files",uus_23_14_1.xml,80444/xv24124,5,0,3,8
"Utah State University Intermountain Herbarium photograph collection",uus_p0119.xml,80444/xv89471,0,2,6,8
"Fife Mormon Collection",uus_mss211.xml,80444/xv63653,3,1,4,8
"Gary Horlacher surveys",uus_mss462.xml,80444/xv29376,0,3,5,8
"Norbert DeByle Watershed Records",uus_mss376.xml,80444/xv86642,4,4,0,8
"Mendon, Utah Records",uus_mss257.xml,80444/xv56555,5,3,0,8
"Thomas E. Lloyd journal",uus_mss400.xml,80444/xv04766,0,1,7,8
"Winslow Farr Smith Papers",uus_mss246.xml,80444/xv12890,3,2,3,8
"Caine Archive of Intermountain Americana Miscellanea",uus_cainemss001.xml,80444/xv92218,1,5,2,8
"Corinne Business Letters",uus_mss241.xml,80444/xv47247,1,3,4,8
"E.B. Olesen photograph collection",uus_p0318.xml,80444/xv14859,1,3,4,8
"C. W. Lauritzen papers",uus_mss024.xml,80444/xv27691,5,3,0,8
"Delmar C. Tingey Papers",uus_18_12_13_17.xml,80444/xv49658,8,0,0,8
"Mutual Improvement Association manuscript newsletters of Hyrum, Utah",uus_mss067.xml,80444/xv55374,0,3,5,8
"Edward P. Cliff photograph collection",uus_p0352.xml,80444/xv38281,1,5,2,8
"Utah State Agricultural College. School of Engineering. Office of the Dean files",uus_rg14_4_1_17.xml,80444/xv83767,8,0,0,8
"Franklin S. Harris Papers",uus_3_1_7_2.xml,80444/xv56906,4,3,1,8
"Ed McClanahan Papers",uus_mss394.xml,80444/xv35067,2,6,0,8
"<emph render="italic">Kingdom Come</emph> Drafts",uus_mss020.xml,80444/xv19381,6,0,2,8
"Box Elder County Aerial Photograph Collection",uus_p0472.xml,80444/xv26766,1,3,4,8
"Francis R. Martin Papers",uus_mss353.xml,80444/xv37200,2,4,2,8
"Western States Folklore Society Papers",uus_mss465.xml,80444/xv36437,3,3,2,8
"King Hendricks papers",uus_mss441.xml,80444/xv02865,3,1,4,8
"Fife Americana Collection",uus_mss212.xml,80444/xv49829,0,6,2,8
"Franklin County, Idaho Post Office Location Records",uus_mss38.xml,80444/xv79919,3,3,2,8
"John P. Taggart papers",uus_mss520.xml,80444/xv49676,4,4,0,8
"J. Arbon Christensen radio transcripts",uus_mss231.xml,80444/xv10571,0,4,4,8
"Reynold Noble papers",uus_mss459.xml,80444/xv97363,0,0,8,8
"George Washington Thatcher Papers",uus_mss135.xml,80444/xv70529,1,4,3,8
"Correspondence concerning Jim Bridger and Louis Vasquez",uus_cainemss028.xml,80444/xv26705,0,5,2,7
"Fife Family Missionary Diaries",uus_mss355.xml,80444/xv30725,2,4,1,7
"E. M. Brown Store Records",uus_mss395.xml,80444/xv35195,4,3,0,7
"Barre Toelken sound recording collection",uus_folkcoll035b.xml,80444/xv20861,1,1,5,7
"1890 Western Travel Album photograph collection.",uus_p0603.xml,80444/xv13040,0,1,6,7
"Papers of Don Jensen",uus_14_1_7_3_26.xml,80444/xv52957,1,3,3,7
"Survey notebooks and maps of Nephi and Lorenzo Anderson,",uus_mss089.xml,80444/xv79168,6,1,0,7
"The military science and tactics photograph collection",uus_p0137.xml,80444/xv66250,0,2,5,7
"Ann Godfrey Hansen literary manuscript",uus_mss420.xml,80444/xv79171,4,2,1,7
"Frank Kelsey papers",uus_mss467.xml,80444/xv37417,6,0,1,7
"Rudy Lukez Wilderness Conservation Papers",uus_mss324.xml,80444/xv85186,0,5,2,7
"Milton Abrams papers",uus_mss471.xml,80444/xv53442,4,2,1,7
"Northern Utah Association of Calligraphers papers",uus_mss463.xml,80444/xv15380,0,0,7,7
"Friends of Bear River Collection",uus_mss332.xml,80444/xv65820,5,2,0,7
"Jensen Haslem Architects collection",uus_mss517.xml,80444/xv78695,2,2,3,7
"Logan Society of Friends Records",uus_mss196.xml,80444/xv48641,7,0,0,7
"George Dewey Clyde papers",uus_mss176.xml,80444/xv47460,4,2,1,7
"Utah Fish and Game photograph collection",uus_p0545.xml,80444/xv89410,3,1,3,7
"John C. Anderson journal",uus_mss143.xml,80444/xv76892,2,2,3,7
"Heinrich Diederichsen correspondence",uus_mss033.xml,80444/xv05792,1,4,2,7
"Harold G. Wood papers",uus_mss012.xml,80444/xv97253,1,4,2,7
"USU Student Entertainment photograph collection",uus_p0434.xml,80444/xv82965,0,1,6,7
"John L. Smith Papers",uus_mss473.xml,80444/xv51538,7,0,0,7
"The Newton, Utah Historical Documents Collection",uus_mss306.xml,80444/xv64221,4,0,3,7
"Union & Jordan Irrigation Company Papers",uus_mss253.xml,80444/xv06646,0,4,3,7
"Jack London photograph collection.",uus_p0551.xml,80444/xv28634,3,1,3,7
"Ernest Dupille travelogue and photographs",uus_p0146.xml,80444/xv52297,0,4,3,7
"Bernard Alfred Etcheverry specifications",uus_mss219.xml,80444/xv68081,1,1,4,6
"Louisa Barnes Pratt research",uus_mss228f.xml,80444/xv47644,3,1,2,6
"Logan City Light And Power Plant Papers",uus_mss072.xml,80444/xv18679,0,0,6,6
"Reid W. Wangsgaard Papers",uus_mss295.xml,80444/xv99102,0,4,2,6
"The Grouse Creek photograph collection",uus_p0201.xml,80444/xv48324,0,1,5,6
"Franklin H. Wyatt papers",uus_mss113.xml,80444/xv04672,0,3,3,6
"Rich County Aerial photograph collection",uus_p0470.xml,80444/xv09118,1,2,3,6
"Hunter S. Thompson documentary interviews",uus_mss388.xml,80444/xv01062,5,1,0,6
"Reynold Marvin Kirby papers",uus_cainemss002.xml,80444/xv31829,2,4,0,6
"Frank Kelsey photograph collection",uus_p0537.xml,80444/xv68539,3,1,2,6
"George D. Clyde speeches",uus_mss255.xml,80444/xv38351,0,3,3,6
"Western Literature Association Conferences Papers",uus_mss068.xml,80444/xv19796,5,0,1,6
"Association of Newspaper Classified Advertising Managers (ANCAM) records",uus_mss418.xml,80444/xv78689,4,2,0,6
"Edward B. Hanson Papers",uus_mss159.xml,80444/xv27474,2,3,1,6
"Ernesto Edwards photograph collection",uus_p0588.xml,80444/xv23736,3,3,0,6
"Ernest Mahan Papers",uus_mss142.xml,80444/xv75747,6,0,0,6
"Marcus de Lafayette Simpson Correspondence",uus_cainemss032.xml,80444/xv03756,0,0,6,6
"Eldon J. Gardner Photograph Collection",uus_p0390.xml,80444/xv44406,3,1,2,6
"Hyrum Larsen journals",uus_cainemss017.xml,80444/xv22528,4,0,2,6
"Leith J. Corbridge Family Papers",uus_mss448.xml,80444/xv67562,3,1,2,6
"International Circulation Managers Association records",uus_mss125.xml,80444/xv44067,0,0,6,6
"McQuown - DeVoto papers",uus_mss054.xml,80444/xv46929,6,0,0,6
"Franklin County (Idaho). East Side Schools records,",uus_cainemss006.xml,80444/xv43228,3,1,2,6
"Anne M. Butler papers",uus_14_6_5_17c.xml,80444/xv07171,0,3,3,6
"Utah National Register of Historic Places",uus_mss165.xml,80444/xv02627,3,0,3,6
"West Cache Irrigation Company Papers",uus_mss361.xml,80444/xv75216,2,0,4,6
"Book Table Records",uus_mss242.xml,80444/xv91836,2,2,2,6
"Valeen T. Avery Photograph Collection",uus_p0386.xml,80444/xv08074,3,1,2,6
"Erwin U. Moser papers",uus_mss460.xml,80444/xv71719,0,0,6,6
"Hezekiah Sumner Hatch family papers",uus_mss305.xml,80444/xv43005,2,2,2,6
"Vanez T. Wilson Papers",uus_mss363.xml,80444/xv93643,5,0,1,6
"Sid Perkes Theater Set Designs",uus_mss380.xml,80444/xv90145,3,1,2,6
"Charles Edwin Loose Political Correspondence",uus_mss172.xml,80444/xv98025,0,5,1,6
"First Presbyterian Church Papers",uus_mss368.xml,80444/xv35449,3,1,2,6
"Realia",uus_cainemss020.xml,80444/xv26596,3,2,0,5
"The children sang : the life and music of Evan Stephens with the Mormon Tabernacle Choir",uus_mss169.xml,80444/xv09060,0,5,0,5
"Utah Commencement Program",uus_mss325.xml,80444/xv96365,2,3,0,5
"Thirkell Family letters",uus_mss398.xml,80444/xv17617,5,0,0,5
"Musical Heritage Studies of Southeastern Idaho: Transcripts",uus_mss064.xml,80444/xv13909,1,2,2,5
"Edwin L. Peterson-Eisenhower Campaign Documents",uus_mss174.xml,80444/xv41647,0,1,4,5
"Farmers Cooperative Irrigation Company papers",uus_mss110.xml,80444/xv72247,1,3,1,5
"C.W. Carter Photograph Collection",uus_p0548.xml,80444/xv83151,0,5,0,5
"Wade H. Andrews papers",uus_17_16_17.xml,80444/xv64688,1,3,1,5
"Nelson Wadsworth photograph collection",uus_p0585.xml,80444/xv85424,2,3,0,5
"Papers of Glen L. Taggart, addendum 1",uus_3_1_11_3.xml,80444/xv61730,0,0,5,5
"Utah Farm Bureau Federation Collection",uus_mss213.xml,80444/xv52151,0,2,3,5
"Papers of Glen L. Taggart, addendum 2",uus_3_1_11_5.xml,80444/xv92987,5,0,0,5
"Jack Croft papers",uus_mss453.xml,80444/xv83477,2,3,0,5
"Frank Calkins Papers Addendum",uus_mss091.xml,80444/xv84765,0,3,2,5
"Charles W. Fox papers",uus_mss066.xml,80444/xv02468,0,2,3,5
"Asahel Henry Smith and Pauline Udall family papers,",uus_mss228h.xml,80444/xv05371,3,1,1,5
"John A. Widtsoe Papers",uus_3_1_5_2.xml,80444/xv27871,0,1,4,5
"Willard Peterson photograph collection",uus_p0469.xml,80444/xv62277,1,1,3,5
"People for Wise Water Planning Papers",uus_mss304.xml,80444/xv72805,0,0,5,5
"Robert B. Day papers",uus_mss404.xml,80444/xv74395,0,1,4,5
"Bruce Anderson papers",uus_mss424.xml,80444/xv04830,4,0,1,5
"B.L.F.E. Re-Echo Lodge #195 Records, Montpelier, Idaho",uus_cainemss022.xml,80444/xv49111,0,3,2,5
"Golden Hour Club records",uus_cainemss015.xml,80444/xv03103,1,1,3,5
"American Legion Women's Auxiliary Scrapbook",uus_mss416.xml,80444/xv01641,0,2,3,5
"Charles Bullen papers",uus_mss428.xml,80444/xv53048,5,0,0,5
"Newton Literary Club Records&gt;",uus_mss249.xml,80444/xv83520,3,0,1,4
"Heber L. Olson Papers",uus_mss348.xml,80444/xv77685,1,0,3,4
"Henry Milton Reeves papers",uus_mss499.xml,80444/xv48889,1,3,0,4
"Jerald E. Christiansen Papers",uus_mss310.xml,80444/xv54501,0,4,0,4
"Kowallis Implement Company records",uus_mss436.xml,80444/xv40301,0,4,0,4
"Ernest C. Jeppsen photograph collection.",uus_p0575.xml,80444/xv77050,0,2,2,4
"Laura R. Merrill Newberry & Caldecott Book Award Winners",uus_mss090.xml,80444/xv10437,0,1,3,4
"Files of USDA/ARS Crops Research Lab",uus_17_21_45.xml,80444/xv20040,4,0,0,4
"The Harry Simon Navy ROTC Photographs Collection",uus_p0402.xml,80444/xv35870,3,1,0,4
"International Student Council general files",uus_25_7_1_5_45.xml,80444/xv50024,1,0,3,4
"Mary M. Marks photograph collection.",uus_p0597.xml,80444/xv51721,0,0,4,4
"Samaria, Idaho, history records",uus_mss446.xml,80444/xv03030,3,1,0,4
"Files of Planting and Seeding Western Range Lands",uus_17_21_45b.xml,80444/xv97045,2,0,2,4
"Brotherhood of Railroad Trainmen Lodge #607",uus_cainemss023.xml,80444/xv14642,0,1,3,4
"Utah Education Association Addendum",uus_mss63ii.xml,80444/xv52694,1,0,3,4
"Cache Valley Medical Association papers",uus_mss209.xml,80444/xv32012,0,1,3,4
"<emph render="italic">One who was valiant</emph> Drafts",uus_mss021.xml,80444/xv30184,2,0,2,4
"Andrew L. Heggie Papers",uus_mss383.xml,80444/xv73843,4,0,0,4
"William I. Palmer Papers",uus_mss331.xml,80444/xv96362,4,0,0,4
"Cardon Family Papers",uus_mss481.xml,80444/xv62405,0,2,2,4
"Utah Governor's Committee on Public Welfare and Emergency Relief : papers",uus_mss099.xml,80444/xv06716,4,0,0,4
"Reece and Bonnie Nielsen Papers",uus_mss384.xml,80444/xv12576,3,1,0,4
"Hal Glicksman Address Book",uus_mss466.xml,80444/xv04406,0,0,4,4
"A.A.U.W. Junior Program Committee Collection",uus_mss340.xml,80444/xv91140,0,0,4,4
"Barre Toelken Papers",uus_15_2_12_26.xml,80444/xv94607,0,3,1,4
"Walter H. Gardner photograph collection",uus_p0370.xml,80444/xv53100,2,0,2,4
"Willard Weld Clark papers",uus_mss272.xml,80444/xv89352,0,1,3,4
"<emph render="italic">A Literary History of the American West</emph> Drafts",uus_mss147.xml,80444/xv49090,0,0,4,4
"William Hampton Marshall papers",uus_mss445.xml,80444/xv92294,0,4,0,4
"David Meltzer Papers",uus_mss526.xml,80444/xv64669,0,0,4,4
"The Mound Fort Ward, Ogden Eighth Ward Papers",uus_mss128.xml,80444/xv97497,4,0,0,4
"Ladies Auxiliary of the B.L.F.E. Liberty Lodge #397 Montpelier, Idaho",uus_cainemss024.xml,80444/xv44021,0,2,2,4
"Citizens for the Protection of Logan Canyon/Logan Canyon Coalition Papers",uus_mss314.xml,80444/xv63458,1,2,1,4
"High Uintas Preservation Council Records",uus_mss390.xml,80444/xv29177,4,0,0,4
"John Milton Bernhisel III missionary diaries",uus_mss292.xml,80444/xv72622,4,0,0,4
"Bryan Fetzer Carr diaries",uus_mss425.xml,80444/xv35595,0,0,3,3
"Cache County Sheriff's Office correspondence",uus_mss262.xml,80444/xv33114,0,2,1,3
"Western Society of Soil Science Records",uus_mss267.xml,80444/xv90756,0,2,1,3
"Edwin L. Peterson family papers",uus_mss509.xml,80444/xv92773,3,0,0,3
"Utah Wool Growers Association Addendum",uus_mss218.xml,80444/xv69567,3,0,0,3
"Virginia Parker Papers",uus_mss396.xml,80444/xv46151,1,2,0,3
"Colorado and Washington Grazing Interview Transcripts",uus_mss016.xml,80444/xv65484,0,0,3,3
"Garth Jones collection",uus_mss477.xml,80444/xv67883,0,0,3,3
"Glen Taggart Speeches",uus_3_1_11_4.xml,80444/xv86663,3,0,0,3
"Eldon J. Gardner papers",uus_mss472.xml,80444/xv87509,0,0,3,3
"The Hortense McEwen Letters",uus_mss296.xml,80444/xv77130,0,2,1,3
"Carlisle family papers",uus_mss527.xml,80444/xv20425,2,0,1,3
"Izatt Service Records",uus_mss389.xml,80444/xv87716,0,1,2,3
"Booklore Club scrapbooks",uus_mss423.xml,80444/xv60614,0,1,2,3
"Ed McClanahan photograph collection",uus_p0569.xml,80444/xv79187,1,1,1,3
"Tueller Family Papers",uus_mss377.xml,80444/xv60043,0,2,1,3
"Riter Brothers Drug Company Records",uus_mss224.xml,80444/xv59600,0,1,2,3
"Axel Johnson papers,",uus_cainemss004.xml,80444/xv46261,0,0,3,3
"First Security Bank photograph collection",uus_p0533.xml,80444/xv44085,3,0,0,3
"Cache County politics : notes and papers",uus_mss069.xml,80444/xv29101,0,0,3,3
"Papers of S. George Ellsworth",uus_14_6_5_1_26.xml,80444/xv19396,0,0,3,3
"Clyde A. Milner II papers",uus_14_6_5_17e.xml,80444/xv15139,2,1,0,3
"Charlotte Wright Papers",uus_mss387.xml,80444/xv88998,0,0,3,3
"Utah State Power Plant : papers",uus_mss074.xml,80444/xv29144,0,1,2,3
"Frederick Kowallis papers",uus_mss451.xml,80444/xv67877,0,3,0,3
"Preston Family Photograph Collection",uus_p0247.xml,80444/xv84365,0,3,0,3
"Glen E. Stringham Papers",uus_14_4_2_45d.xml,80444/xv52511,0,1,2,3
""Logan Past, Present, Future" Papers",uus_mss208.xml,80444/xv28375,2,0,1,3
"Orson Gurney Smith photograph collection.",uus_p0576.xml,80444/xv97528,2,0,1,3
"Portage, Utah Receipts from the Bishop's Storehouse",uus_mss202.xml,80444/xv52294,0,2,1,3
"Joseph H. Wilde Missionary Diaries",uus_mss358.xml,80444/xv54669,1,2,0,3
"Austin Douglas Allen Papers",uus_mss382.xml,80444/xv33444,3,0,0,3
"Gunnar Rasmuson papers",uus_mss508.xml,80444/xv25350,3,0,0,3
"William Miller and William Patterson Union Pacific Railroad Correspondence",uus_mss374.xml,80444/xv21060,3,0,0,3
"Mike Johnson Papers",uus_mss372.xml,80444/xv19821,2,0,1,3
"Western travel album photograph collection",uus_p0129.xml,80444/xv50326,0,1,2,3
"Bridger Folk Music Society papers",uus_mss507.xml,80444/xv30703,3,0,0,3
"Forster family papers",uus_mss240.xml,80444/xv00888,1,2,0,3
"Reorganized Church of Jesus Christ of Latter Day Saints Collection",uus_mss369.xml,80444/xv14956,0,0,3,3
"United States Bureau of Fisheries Idaho Survey Unit records",uus_mss186.xml,80444/xv60348,1,1,1,3
"West Cache Irrigation Company Secretary's Papers,",uus_mss199.xml,80444/xv60845,1,2,0,3
"John Duncan Brite papers",uus_mss005.xml,80444/xv38748,0,2,1,3
"Ernest C. Jeppsen papers",uus_mss435.xml,80444/xv69293,0,0,3,3
"David E. Tanner Papers",uus_mss345.xml,80444/xv50579,0,1,2,3
"Cardon Family photgraph collection",uus_p0541.xml,80444/xv83740,1,2,0,3
"Utah Wool Growers Association papers",uus_mss055.xml,80444/xv89242,1,0,2,3
"Virginia Stacey papers",uus_mss408.xml,80444/xv47689,0,0,3,3
"<emph render="italic">Utah's heritage</emph> research",uus_mss228d.xml,80444/xv43801,0,2,1,3
"Mendon Historical Documents",uus_mss166.xml,80444/xv18576,0,1,2,3
"Manti Waterworks Construction Papers",uus_mss144.xml,80444/xv79544,0,2,1,3
"Chris Cokinos book drafts",uus_mss429.xml,80444/xv94439,0,1,1,2
"Wyoming Sheep Ranch photograph collection.",uus_p0593.xml,80444/xv14526,0,0,2,2
"Austin Family Documents",uus_mss139.xml,80444/xv26739,2,0,0,2
"Eva B. Israelsen Diaries",uus_mss393.xml,80444/xv58239,0,1,1,2
"Get-Away-Special (GAS) Program",uus_14_8_6_55.xml,80444/xv93258,0,2,0,2
"College of HASS Deans Files",uus_14_6_1_17.xml,80444/xv97158,2,0,0,2
"The May Swenson photograph collection",uus_p0437.xml,80444/xv03918,0,1,1,2
"Papers of Frank Boyer Salisbury",uus_14_1_9_26.xml,80444/xv65060,1,0,1,2
"D.E. Burley telegrams",uus_mss522.xml,80444/xv85437,2,0,0,2
"Amalgamated Sugar Company-Lewiston Sugar Company records",uus_mss278.xml,80444/xv78732,0,2,0,2
"Lincoln Ellison photograph collection",uus_p0556.xml,80444/xv26110,0,1,1,2
"F. Jay Haynes photograph collection",uus_p0565.xml,80444/xv47906,0,2,0,2
"Ronald Jensen photograph collection.",uus_p0572.xml,80444/xv65039,2,0,0,2
"William Preston Thomas papers",uus_14_1_4_26.xml,80444/xv07077,0,2,0,2
"Alene Petty Papers",uus_mss354.xml,80444/xv92593,1,1,0,2
"John H. Roskelley Mission Diaries",uus_mss359.xml,80444/xv80081,0,2,0,2
"Asa Wayne Arrington papers",uus_mss409.xml,80444/xv94149,0,2,0,2
"Berten Wendell Allred",uus_mss118.xml,80444/xv88146,1,0,1,2
"Alice Lindahl papers",uus_mss414.xml,80444/xv74343,0,2,0,2
"The Co-op Service",uus_mss343.xml,80444/xv00363,0,0,2,2
"Farmers Grain Cooperative Business Papers",uus_mss365.xml,80444/xv12182,0,2,0,2
"American Society of Range Management, Utah Section : records",uus_mss081.xml,80444/xv96017,0,0,2,2
"Carol O'Connor papers",uus_14_6_5_17d.xml,80444/xv14773,0,1,1,2
"Snyder Sisters Travel Album photograph collection.",uus_p0566.xml,80444/xv02191,0,0,1,1
"Albert G. Peyton diary",uus_mss525.xml,80444/xv22647,0,0,1,1
"Professional Activities of Norman Keith Roberts",uus_14_2_6_45.xml,80444/xv63504,0,0,1,1
"Vernon J. Larsen papers",uus_mss449.xml,80444/xv99276,0,1,0,1
"William I. Bunker papers",uus_mss454.xml,80444/xv22979,0,1,0,1
"Presidential Papers of Glen L. Taggart",uus_3_1_11_2.xml,80444/xv47567,0,0,1,1
"Edith Nyman Gunnell Valentines",uus_mss438.xml,80444/xv31594,0,1,0,1
"Fielding Social Development Club records",uus_cainemss014.xml,80444/xv14685,0,0,1,1
"Emma Eccles Jones papers",uus_mss410.xml,80444/xv99426,0,0,1,1
"Ronald Jensen collection",uus_mss512.xml,80444/xv90261,0,0,1,1
"Amy Madsen Beecher scrapbook",uus_mss417.xml,80444/xv45315,1,0,0,1
"International Programs (Global Engagement), Office Files",uus_22_45b.xml,80444/xv66262,0,1,0,1
"USU International Student Assosiation Collection Addendum.",uus_p0581.xml,80444/xv70278,0,0,1,1
"Walter E. Peay Papers",uus_mss373.xml,80444/xv59350,0,0,1,1
"Parley P. Black Papers",uus_mss338.xml,80444/xv53527,0,0,1,1
"Lund Utah Scrapbook photograph collection",uus_p0555.xml,80444/xv69680,0,0,1,1
"Datus M. Hammond papers",uus_mss103.xml,80444/xv66937,1,0,0,1
"Erastus G. Farmer papers",uus_mss251.xml,80444/xv28805,1,0,0,1
"Earl Madsen Papers",uus_mss187.xml,80444/xv88558,1,0,0,1
"James Clarence Ellsworth family papers",uus_mss228a.xml,80444/xv39297,1,0,0,1
"Sarah Patience Paskett autograph books",uus_mss488.xml,80444/xv66110,0,1,0,1
"Utah Idaho Central Railway Providence Station Records",uus_mss163.xml,80444/xv95501,0,0,1,1
"North Logan Telephone and Electric Company records",uus_mss407.xml,80444/xv09094,0,1,0,1
"Jack G. Webb photograph collection.",uus_p0586.xml,80444/xv09475,0,1,0,1
"Heber J. Grant Presentation Book",uus_p0573.xml,80444/xv97216,0,0,1,1
"Frank Godfrey letters",uus_mss524.xml,80444/xv20935,0,0,1,1
"Utah Water Research Laboratory general files",uus_17_9_2.xml,80444/xv19058,1,0,0,1
"Teton Dam reports",uus_mss469.xml,80444/xv50274,0,0,1,1
"Papers of Glen Taggart while at Michigan State University",uus_mss083.xml,80444/xv28161,0,0,1,1
"Bishop Bruce Collection",uus_14_4_1_17d.xml,80444/xv23660,1,0,0,1
"Logan Branch of the National League of American Pen Women Papers",uus_mss352.xml,80444/xv36328,1,0,0,1
"The Utah Beet Growers Association Papers",uus_mss204.xml,80444/xv73678,0,1,0,1
"Conover Wright papers",uus_mss464.xml,80444/xv60473,0,1,0,1
"James H. Crockwell papers",uus_mss250.xml,80444/xv61935,1,0,0,1
"Papers of James P. Shaver",uus_17_17_17.xml,80444/xv27380,1,0,0,1
"Andy Gibbons scrapbooks",uus_mss419.xml,80444/xv53393,1,0,0,1
"Idaho State and Savings Bank",uus_cainemss007.xml,80444/xv65838,0,0,0,0
"R.A. Bacon Manuscript",uus_cainemss012.xml,80444/xv59411,0,0,0,0
"Mink Creek Stockmen’s Association records",uus_mss442.xml,80444/xv10687,0,0,0,0
"Utah Home Economics Association Papers",uus_mss095.xml,80444/xv67083,0,0,0,0
"J. Cecil Alter Radio Show Transcripts",uus_mss440.xml,80444/xv37789,0,0,0,0
"Cache County Library Study material",uus_mss386.xml,80444/xv26269,0,0,0,0
"David J. Smith photograph collection.",uus_p0478.xml,80444/xv48339,0,0,0,0
"Proposal for Change in Cache County Government Structure Papers",uus_mss318.xml,80444/xv83984,0,0,0,0
"Vegetation restudy, Great Rift, Southeastern Idaho, Records",uus_14_7_3_76b.xml,80444/xv81195,0,0,0,0
"Girard H. Rapp papers",uus_mss430.xml,80444/xv39120,0,0,0,0
"Avard T. Fairbanks collection",uus_mss421.xml,80444/xv24505,0,0,0,0
"Kappa Chapter of Phi Upsilon Omicron papers",uus_25_8_1_9_45.xml,80444/xv99444,0,0,0,0
"Unknown",uus_14_7_18.xml,80444/xv99600,0,0,0,0
"Oral History Association records",uus_mss228g.xml,80444/xv77328,0,0,0,0
"Crops Research Lab Arid Pasture and Range&gt;",uus_17_21_45c.xml,80444/xv12963,0,0,0,0
"Franklin Davis Thatcher photograph collection",uus_p0554.xml,80444/xv47982,0,0,0,0
"Ray B. West Drafts of <emph render="italic">Kingdom Come</emph>",uus_mss011.xml,80444/xv69253,0,0,0,0
"The Fair Store Records",uus_mss402.xml,80444/xv57971,0,0,0,0
"Provo River Division Reports",uus_mss370.xml,80444/xv92620,0,0,0,0
"Ora Hoskins papers",uus_mss371.xml,80444/xv45330,0,0,0,0
"Samuel Taylor legislative papers",uus_mss412.xml,80444/xv22732,0,0,0,0
"<emph render="italic">Uranium fever, or, No talk under 1 million</emph>",uus_mss194.xml,80444/xv20883,0,0,0,0
"William E. Wood Family papers",uus_mss450.xml,80444/xv29022,0,0,0,0
"International Programs (Global Engagement) Office Files",uus_22_45c.xml,80444/xv02169,0,0,0,0
"Junior Miller Oral History Interviews",uus_mss397.xml,80444/xv18994,0,0,0,0
"Bruce Anderson photograph collection",uus_p0571.xml,80444/xv91281,0,0,0,0
"Franklin City, Idaho, minutes",uus_mss474.xml,80444/xv70330,0,0,0,0
"American Association of Familly and Consumer Sciences papers",uus_mss415.xml,80444/xv84747,0,0,0,0
"Signal Service Corps Ledgers",uus_mss341.xml,80444/xv98074,0,0,0,0
"Jed Wasden papers",uus_mss432.xml,80444/xv93295,0,0,0,0
"Wayne Estes interviews",uus_mss494.xml,80444/xv53674,0,0,0,0
"Logan Rotary Club papers",uus_mss234.xml,80444/xv38391,0,0,0,0
"Vardis Fisher Papers",uus_mss350.xml,80444/xv58721,0,0,0,0
"Alunite LDS Branch Records",uus_mss207.xml,80444/xv07473,0,0,0,0
"Wade Andrews photograph collection",uus_p0443.xml,80444/xv36593,0,0,0,0
"William E. Bell papers",uus_mss411.xml,80444/xv49798,0,0,0,0
"Logan Second Ward records",uus_mss447.xml,80444/xv85757,0,0,0,0
"Alfred Hart photograph collection.",uus_p0563.xml,80444/xv16040,0,0,0,0
"Unknown",uus_p0560.xml,80444/xv28033,0,0,0,0
"Noble Nielsen Papers",uus_mss375.xml,80444/xv61026,0,0,0,0
"Mountain States Athletic Conference papers",uus_mss433.xml,80444/xv13128,0,0,0,0
"International Programs (Global Engagement), Office Files",uus_22_45a.xml,80444/xv26654,0,0,0,0
"Robert James Evans Papers",uus_14_1_7_1_26.xml,80444/xv16561,0,0,0,0
"Gaylen Ashcroft Photograph Collection",uus_p0550.xml,80444/xv05661,0,0,0,0
"Logan Chapter of the Mormon Battalion Association Historical Record",uus_mss364.xml,80444/xv21356,0,0,0,0
"Sunshine Terrace Foundation Records",uus_mss381.xml,80444/xv23007,0,0,0,0
,,Totals,9459,11717,9977,31153
