Title,Document Name,Ark Identifier,April,May,June,Total
"Herald Journal Newspaper Photographs,",uus_p001.xml,80444/xv77938,387,380,357,1124
"Compton Photograph Studio Archive collection",uus_p0313.xml,80444/xv71670,315,300,334,949
"A-Board historical photograph collection",uus_aboardcoll.xml,80444/xv63613,334,281,294,909
"Ronald V. Jensen Living Historical Farm Photographs",uus_p0356.xml,80444/xv13534,293,265,148,706
"Cache County tax assessment photograph collection,",uus_p0012.xml,80444/xv09988,98,146,111,355
"Utah State University Buzzer Yearbook Photograph Collection (P0531)",uus_p0531.xml,80444/xv07794,117,116,120,353
"Utah State University undergraduate student fieldwork collection",uus_folkcoll008usu.xml,80444/xv86462,86,80,106,272
"Western states cowboy poetry collection",uus_folkcoll011f.xml,80444/xv45220,80,75,106,261
"Assorted Photograph Collections",uus_assortedpocoll.xml,80444/xv76242,76,89,88,253
"Jack and Charmian London correspondence and papers",uus_mss010.xml,80444/xv27206,56,114,61,231
"Outlook magazine photograph collection",uus_p0320.xml,80444/xv67926,51,88,90,229
"USU student folklore genre collection of speech",uus_folkcoll008a_3.xml,80444/xv01016,56,84,85,225
"USU Photographic Services Collection.",uus_p0376.xml,80444/xv00213,61,73,75,209
"Becker Brewing and Malting Company records",uus_cainemss031.xml,80444/xv52359,75,68,62,205
"Ada Morrell Family Scrapbook Collection,",uus_p0355.xml,80444/xv06253,49,78,72,199
"Newell Hart papers",uus_cainemss003.xml,80444/xv75030,42,89,62,193
"American Folklore Society records",uus_mss206.xml,80444/xv94586,44,36,105,185
"4-H Club photograph collection",uus_p0114.xml,80444/xv05398,49,66,68,183
"The High School Student Folklore Collection",uus_folkcoll055.xml,80444/xv59487,47,57,69,173
"Ellsworth family photograph collection,",uus_p0142.xml,80444/xv18179,56,52,61,169
"Walter Lehrman Beat Generation photograph collection",uus_p0577.xml,80444/xv95904,12,103,54,169
"Utah Statesman Photograph Collection",uus_p0395.xml,80444/xv99420,50,42,75,167
"Utah State University County Extension Agent Report Photograph Collection",uus_p0138.xml,80444/xv31335,54,73,40,167
"The National Cowboy Poetry Gathering collection",uus_folkcoll011g.xml,80444/xv27954,42,72,52,166
"Mormon diaries",uus_mss018.xml,80444/xv27203,54,65,46,165
"Intermountain Indian School photograph collection",uus_p0327.xml,80444/xv45184,65,55,38,158
"Teton Dam Disaster Oral History transcriptions and tapes",uus_mss058.xml,80444/xv11578,26,55,76,157
"Andrew L. Heggie and Corinne Godfrey Heggie photograph collection",uus_p0121.xml,80444/xv83343,37,74,45,156
"Claridge family photograph collection,",uus_p0143.xml,80444/xv27847,46,55,55,156
"Utah State University historical photo-board collection",uus_usupho1.xml,80444/xv76126,54,53,45,152
"Leonard J. Arrington Papers",uus_ljaha001.xml,80444/xv42800,49,18,85,152
"Utah State University. Faculty. Publications of the faculty",uus_8_8_37.xml,80444/xv51663,48,41,56,145
"C.E. Johnson photograph collection,",uus_p0011.xml,80444/xv91802,33,57,37,127
"Utah State University graduate student fieldwork collection",uus_folkcoll008grad.xml,80444/xv78375,36,48,41,125
"John Kenneth Cannon Photograph Collection",uus_p0382.xml,80444/xv34939,45,42,38,125
"Utah State University publicity portraits",uus_p0326.xml,80444/xv68896,41,51,32,124
"Edgar B. Brossard photograph collection",uus_p0111.xml,80444/xv32278,29,50,42,121
"The Crabtree Family Papers",uus_mss327.xml,80444/xv81130,34,40,46,120
"The Skaggs Foundation cowboy poetry collection : authors A-L",uus_folkcoll011_1.xml,80444/xv41781,34,38,48,120
"Frederick P. Champ papers",uus_mss050.xml,80444/xv11087,33,35,48,116
"Barre Toelken Fieldwork Image Collection",uus_folkcoll035a.xml,80444/xv44381,17,56,42,115
"San Francisco Punk Flyers collection",uus_mss523.xml,80444/xv17514,15,82,17,114
"Dee Smith Photograph Collection",uus_p0438.xml,80444/xv10403,38,29,44,111
"Swaner Family Oral History Project",uus_folkcoll0060.xml,80444/xv46444,0,65,45,110
"World War II veterans scrapbook",uus_mss183.xml,80444/xv35894,69,14,22,105
"C.R. Savage photograph collection",uus_p0038.xml,80444/xv85305,27,38,37,102
"S. George Ellsworth photograph collection",uus_p0025.xml,80444/xv10845,33,37,29,99
"Mormon immigrant portrait collection",uus_p0027.xml,80444/xv63992,34,34,29,97
"Gary Smith photograph collection",uus_p0106.xml,80444/xv43756,32,23,39,94
"The Francis Wilson Gunnell Family Record",uus_mss301.xml,80444/xv40670,22,30,39,91
"Living traditions of the Bear River Heritage Area survey",uus_folkcoll029.xml,80444/xv99685,26,36,27,89
"Utah Construction Company/Bowman photograph collection",uus_p0328.xml,80444/xv43917,30,38,21,89
"Utah State University Fife Folklore Conference student fieldwork collection",uus_folkcoll008ffc.xml,80444/xv70388,32,30,26,88
"Morrisite collection",uus_cainemss010.xml,80444/xv02597,24,26,38,88
"Agricultural College of Utah Cyanotypes,",uus_p0014.xml,80444/xv64944,18,31,35,84
"Crookston family papers",uus_mss071.xml,80444/xv03927,27,32,24,83
"Harry Reuben Reynolds photograph collection,",uus_p0004.xml,80444/xv61871,21,29,32,82
"Ridgway Family Papers",uus_cainemss008.xml,80444/xv13992,33,27,21,81
"World War II Rationing Stamps Program",uus_mss088.xml,80444/xv05780,31,29,19,79
"Topaz Internment Camp Documents",uus_mss170.xml,80444/xv89102,45,24,10,79
"Mormon Affidavits & Petitions Relating to the Missouri Persecutions",uus_cainemss019.xml,80444/xv20477,30,25,23,78
"J. Edward Decker papers",uus_mss210.xml,80444/xv47717,13,21,42,76
"Ranch Family Documentation Project",uus_folkcoll049.xml,80444/xv57559,18,31,25,74
"Lowry Nelson writings and papers",uus_mss017.xml,80444/xv58740,16,33,23,72
"The Fife Folklore Conference collection",uus_folkcoll031.xml,80444/xv88607,32,19,21,72
"The Skaggs Foundation cowboy poetry collection : authors M-Z,",uus_folkcoll011_2.xml,80444/xv27481,26,17,28,71
"Fife American Collection",uus_folkcoll004_2.xml,80444/xv14770,29,22,20,71
"Dr. William H. Hopkins Addendum Collection",uus_p0360.xml,80444/xv21139,12,42,16,70
"Brigham Young College records",uus_mss001.xml,80444/xv44787,7,38,25,70
"Daniel H. Wells Papers",uus_mss302.xml,80444/xv06524,25,25,19,69
"S. George Ellsworth papers",uus_mss228.xml,80444/xv97897,20,32,16,68
"Cache Valley Refugee Oral History Project",uus_folkcoll0058.xml,80444/xv67608,13,40,15,68
"Fife Mormon collection",uus_folkcoll004_1.xml,80444/xv34716,24,23,21,68
"Gary B. Hansen papers",uus_mss319.xml,80444/xv99734,12,26,28,66
"The Dolph Andrus photograph collection",uus_p0542.xml,80444/xv26892,8,42,16,66
"F. Ross Peterson Papers",uus_mss252.xml,80444/xv34832,11,30,24,65
"Joel E. Ricks Cache Valley history collection",uus_mss046.xml,80444/xv93618,10,33,20,63
"Peter Maughan papers",uus_mss037.xml,80444/xv93002,11,23,28,62
"Smithfield diaries",uus_mss034.xml,80444/xv24880,16,27,19,62
"Lundstrom Furniture Company records",uus_mss138.xml,80444/xv53833,21,25,16,62
"William Alexander Carter, account ledger",uus_mss168.xml,80444/xv36462,21,15,25,61
"Teton Dam disaster collection",uus_folkcoll027.xml,80444/xv94137,11,19,30,60
"USU student folklore genre collection of supernatural nonreligious legends",uus_folkcoll008a_7supernaturalnonreligious.xml,80444/xv63192,17,20,23,60
"Gary Smith Papers",uus_mss132.xml,80444/xv17303,22,20,17,59
"19th Century Western Stereo-views Collection",uus_p0349.xml,80444/xv28820,22,19,18,59
"William Neff Photograph Collection",uus_p0334.xml,80444/xv22091,27,22,10,59
"The Latino/Latina Voices Project",uus_folkcoll038.xml,80444/xv83200,18,22,19,59
"Whitney Smith photograph collection",uus_p0034.xml,80444/xv25277,22,20,16,58
"USU student folklore genre collection of tales and jokes",uus_folkcoll008a_4.xml,80444/xv83386,15,22,21,58
"Utah Wilderness Association records",uus_mss200.xml,80444/xv75259,37,13,7,57
"Postcard collection",uus_p0031.xml,80444/xv12420,9,24,24,57
"William Henry Jackson Hayden survey albertypes",uus_p0345.xml,80444/xv96304,16,14,27,57
"Mormons for ERA",uus_mss225.xml,80444/xv98071,22,20,15,57
"Retired originals collection",uus_p0329.xml,80444/xv34088,16,19,21,56
"Bullen Family Photographs,",uus_p0018.xml,80444/xv44619,23,22,11,56
"Utah Grazing Notes",uus_mss009.xml,80444/xv20513,25,18,12,55
"Helen Mar Kimball Whitney Papers",uus_mss179.xml,80444/xv92462,16,24,15,55
"Daryl Chase Photograph Collection",uus_p0131.xml,80444/xv01119,20,16,19,55
"Wheeler's geographical survey stereoscopic views",uus_p0325.xml,80444/xv05364,20,20,15,55
"USU student folklore genre collection of belief",uus_folkcoll008a_2.xml,80444/xv36322,18,16,20,54
"Raymond C. Somers photograph collection",uus_p0324.xml,80444/xv34503,18,25,11,54
"Kenneth Wayne Brewer Papers",uus_mss275.xml,80444/xv39746,17,21,16,54
"William S. Wilson Iwo Jima photographs",uus_p0342.xml,80444/xv62976,14,25,15,54
"Baker and Johnston photograph collection",uus_p0474.xml,80444/xv65188,19,19,16,54
"Simmonds family photograph collection",uus_p0105.xml,80444/xv05914,15,20,18,53
"The North Cache High School Papers",uus_mss136.xml,80444/xv58230,13,31,9,53
"Charles Potts papers",uus_mss486.xml,80444/xv37246,22,12,18,52
"James O. Martin Civil War Collection",uus_mss285.xml,80444/xv97573,18,22,12,52
"Gustav Lorenz Becker Photograph Collection",uus_p0361.xml,80444/xv44802,18,14,19,51
"Ariel Benson photograph collection.",uus_p0471.xml,80444/xv25061,15,16,19,50
"Fife Folklore Archives student media collection",uus_folkcoll008b.xml,80444/xv44580,11,27,12,50
"Utah State University ROTC Photographs",uus_p0350.xml,80444/xv98254,24,15,11,50
"Papers of General John Kenneth Cannon",uus_mss041.xml,80444/xv25619,39,4,7,50
"The Papers of Congressman James V. Hansen",uus_mss351.xml,80444/xv82138,13,32,5,50
"Orson F. Whitney Diaries",uus_mss188.xml,80444/xv04257,9,23,17,49
"Logan Temple collection",uus_mss112.xml,80444/xv26461,11,16,22,49
"Nelson B. Wadsworth papers",uus_mss458.xml,80444/xv03884,14,21,13,48
"John William Fitzgerald papers",uus_mss102.xml,80444/xv47512,22,14,11,47
"Range management collection",uus_bookcoll17.xml,80444/xv44946,25,9,13,47
"William Alexander and Mary E. Carter papers",uus_cainemss029.xml,80444/xv50091,17,19,11,47
"Folklore in the news collection",uus_folkcoll032.xml,80444/xv04849,13,28,6,47
"The Grouse Creek (Utah) Cultural Survey collection",uus_folkcoll021.xml,80444/xv88137,9,9,29,47
"USU student folklore genre collection of customs",uus_folkcoll008a_1.xml,80444/xv09976,13,21,12,46
"Walter H. Gardner collection",uus_mss057.xml,80444/xv54290,39,2,5,46
"James Foster Scott Papers",uus_mss180.xml,80444/xv36776,7,20,19,46
"Gunn McKay Papers",uus_mss086.xml,80444/xv30389,9,23,13,45
"Utah/Idaho High Altitude Aerial Photograph Collection",uus_p0330.xml,80444/xv47143,11,27,6,44
"Charles Ramsden Bailey papers",uus_mss053.xml,80444/xv05551,13,17,14,44
"Ann Nolan Clark drafts",uus_mss023.xml,80444/xv44924,7,23,13,43
"Roskelley Family Photograph Collection,",uus_p0013.xml,80444/xv34295,17,13,13,43
"Austin E. and Alta S. Fife papers",uus_mss281.xml,80444/xv36505,14,6,23,43
"Ranch Family Documentation Project photograph collection",uus_p0467.xml,80444/xv34738,19,9,15,43
"The National Press Photographers Association Clip Contest collection",uus_p0136.xml,80444/xv25057,35,2,5,42
"Callister Family Papers",uus_mss335.xml,80444/xv71298,6,30,6,42
"Alonzo George Barber : papers",uus_mss079.xml,80444/xv87774,10,17,15,42
"Briant H. Stringham photograph collection",uus_p0365.xml,80444/xv96948,16,13,13,42
"Alfred Gordon Erickson Photograph Collection",uus_p0479.xml,80444/xv14440,12,18,12,42
"The Jensen Historical Farm Research Collection",uus_mss236.xml,80444/xv57568,10,11,21,42
"John Wilford Carlson papers",uus_mss027.xml,80444/xv19607,17,16,9,42
"Dee Glen Smith Oral Histories",uus_mss273.xml,80444/xv77270,14,16,11,41
"The Marie Fuhriman Olsen Oral History Collection",uus_folkcoll050.xml,80444/xv03970,12,21,8,41
"Samuel Roskelley papers",uus_mss065.xml,80444/xv00094,10,24,7,41
"Leonard J. Arrington photograph collection",uus_p0316.xml,80444/xv38223,15,14,12,41
"May Swenson addendum",uus_mss485.xml,80444/xv85885,29,7,4,40
"H. Baxter Liebler papers",uus_cainemss011.xml,80444/xv38824,11,11,18,40
"Nibley family photographs",uus_p0315.xml,80444/xv53207,12,11,17,40
"Utah State University student fieldwork collection",uus_folkcoll008fieldwork.xml,80444/xv77713,2,28,10,40
"James E. Sisson III Papers",uus_mss290.xml,80444/xv96170,2,32,6,40
"Fife Folklore Archives Oral History collection",uus_folkcoll037.xml,80444/xv89437,12,20,7,39
"Goodwin family photograph collection",uus_p0032.xml,80444/xv07397,11,19,9,39
"Valeen T. Avery Papers",uus_mss316.xml,80444/xv30181,15,14,10,39
"Public Folklore Collection",uus_folkcoll45.xml,80444/xv08578,6,12,21,39
"Design Workshop, Inc.",uus_mss347.xml,80444/xv17855,9,24,5,38
"Brigham Young College photograph and memorabilia collection,",uus_p0008.xml,80444/xv65588,7,17,14,38
"Idaho 2nd Infantry Expedition to Mexico",uus_p0030.xml,80444/xv05407,17,12,9,38
"Joseph Jeppe Larsen photograph collection",uus_p0372.xml,80444/xv79644,10,21,7,38
"Hector Lee field recording collection",uus_folkcoll006.xml,80444/xv47738,10,13,14,37
"Virginia Hanson papers",uus_mss217.xml,80444/xv27334,15,18,4,37
"Jefferson Middle School time capsule photograph collection",uus_p0145.xml,80444/xv04681,13,15,8,36
"Heber Cyrus Snell papers",uus_mss032.xml,80444/xv09158,21,5,10,36
"Robert Rust photograph collection",uus_p0317.xml,80444/xv05786,13,8,15,36
"Susan Sunada papers",uus_mss059.xml,80444/xv04827,11,12,13,36
"Larsen Family Photograph Collection,",uus_p0006.xml,80444/xv12289,19,11,5,35
"Orson Winso Israelsen irrigation photographs",uus_p0358.xml,80444/xv03680,17,13,5,35
"Moses Thatcher Sr. papers",uus_mss022.xml,80444/xv45404,15,14,6,35
"Sierra Club, Utah Chapter archives",uus_mss148.xml,80444/xv03390,10,17,8,35
"Montpelier Historical Society archives",uus_mss197.xml,80444/xv95745,11,9,15,35
"Oliver A. Jenson photograph collection",uus_p0357.xml,80444/xv48406,16,14,5,35
"Heber H. Thomas Photograph Collection",uus_p0466.xml,80444/xv46704,6,13,16,35
"San Francisco Earthquake Snapshots",uus_p0346.xml,80444/xv10705,11,6,18,35
"Floyd T. Morgan photograph collection",uus_p0414.xml,80444/xv66604,9,13,12,34
"L.M. Winsor papers",uus_mss098.xml,80444/xv30731,0,20,14,34
"USU student folklore genre collection of contemporary legends",uus_folkcoll008a_7contemporary.xml,80444/xv15270,23,5,6,34
"J. Bracken Lee papers",uus_usuemss001.xml,80444/xv35812,16,7,11,34
"Laura R. Merrill photograph collection",uus_p0362.xml,80444/xv75607,8,17,9,34
"Susan Sunada addendum",uus_mss503.xml,80444/xv28784,0,18,15,33
"William B. Preston Papers",uus_mss268.xml,80444/xv91189,6,9,18,33
"USU Student Services photograph collection",uus_p0451.xml,80444/xv80895,14,5,14,33
"Ida Hunt Udall photograph collection",uus_p0311.xml,80444/xv47448,7,9,17,33
"Intermountain Indian School architectural drawings",uus_mss493.xml,80444/xv62988,4,4,25,33
"Cache Citizen Photograph Collection,",uus_p0379.xml,80444/xv59371,11,12,9,32
"Gisbert Bossard/Max Florence Photograph Collection,",uus_p0002.xml,80444/xv28479,13,8,11,32
"Bear River Migratory Bird Refuge photographs,",uus_p0020.xml,80444/xv89230,10,17,5,32
"Collecting Memories: Oral Histories of American Folklorists",uus_folkcoll046.xml,80444/xv25149,8,13,11,32
"May Swenson papers",uus_mss282.xml,80444/xv48208,19,9,4,32
"Cache County plat map photograph collection",uus_p0322.xml,80444/xv85202,12,10,9,31
"'Sun Pictures of Rocky Mountain Scenery' photograph collection,",uus_p0019.xml,80444/xv36932,16,8,7,31
"John Suiter photography collection",uus_p0375.xml,80444/xv61560,12,14,5,31
"Nat Stein Papers",uus_msscaine027.xml,80444/xv15707,6,7,18,31
"Serge N. Benson Papers,",uus_mss323.xml,80444/xv01089,16,11,3,30
"Westminster College Student Folklore Collection",uus_folkcoll043.xml,80444/xv19088,10,11,9,30
"Herschel Bullen, Jr. papers",uus_mss178.xml,80444/xv78393,8,13,9,30
"Deseret String Band Collection",uus_folkcoll52.xml,80444/xv67947,10,13,7,30
"Italian-Americans in the West : Utah section collection",uus_folkcoll033.xml,80444/xv04876,7,11,12,30
"Edgar Bernard Brossard papers",uus_mss004.xml,80444/xv14538,16,8,6,30
"Orson Winso Israelsen papers",uus_mss031.xml,80444/xv95730,9,19,2,30
"Wayland D. Hand folklore papers",uus_mss297.xml,80444/xv71936,12,8,10,30
"George Washington Thatcher family papers",uus_mss047.xml,80444/xv79324,6,16,7,29
"Austin Fife photograph collection,",uus_p0141.xml,80444/xv35012,3,11,15,29
"Soemu Toyoda Tribunal Transcripts",uus_mss195.xml,80444/xv58850,14,8,7,29
"Lyman S. Willardson Photograph Collection",uus_p0419.xml,80444/xv87838,7,6,16,29
"Hunter S. Thompson documentary interviews",uus_mss388.xml,80444/xv01062,12,14,2,28
"Twin Lakes Canal Company Papers",uus_mss203.xml,80444/xv50668,8,10,10,28
"Charles Batten Photograph Collection",uus_p0473.xml,80444/xv51470,13,10,5,28
"Charles Kelly photograph collection,",uus_p0003.xml,80444/xv56350,12,7,9,28
"Milton Merrill papers",uus_mss080.xml,80444/xv48666,6,15,7,28
"Carlton Culmsee papers",uus_mss221.xml,80444/xv21850,14,6,8,28
"Millville History Collection, <emph render="italic">Millville Memories</emph> Papers,",uus_mss161.xml,80444/xv77334,11,8,9,28
"Samuel P. Cowley papers",uus_mss156.xml,80444/xv35003,13,10,5,28
"Dewitt/Palmer family photograph collection",uus_p0124.xml,80444/xv30398,11,9,8,28
"Charles H. Bridges, Jr., missionary diaries and correspondence",uus_mss308.xml,80444/xv54483,8,9,11,28
"Thatcher Opera House photograph collection",uus_p0399.xml,80444/xv10479,9,11,7,27
"Charles Gilbert Wood Papers",uus_mss191.xml,80444/xv62713,13,7,7,27
"Richard Welling Roskelley Papers",uus_mss284.xml,80444/xv37164,7,13,7,27
"Central Utah Project: Capturing Utah's share of the Colorado River",uus_folkcoll056.xml,80444/xv59140,9,12,6,27
"G. Malcolm Laws, Jr. papers",uus_mss232.xml,80444/xv03576,12,4,11,27
"Lincoln Ellison Papers",uus_mss317.xml,80444/xv03265,11,11,4,26
"The William Budge Missionary Journal",uus_mss356.xml,80444/xv46035,9,10,7,26
"Lisa Godfrey thesis papers",uus_mss276.xml,80444/xv19744,5,7,14,26
"Western Literature Association Conferences Papers",uus_mss068.xml,80444/xv19796,11,8,7,26
"Cache Community Connections Oral History Project",uus_folkcoll047.xml,80444/xv38369,5,13,8,26
"Norman V. Hancock papers",uus_mss489.xml,80444/xv97512,6,18,2,26
"Nathaniel Vary Jones papers",uus_mss158.xml,80444/xv93057,6,16,4,26
"John M. Cannon papers",uus_mss270.xml,80444/xv74929,3,11,12,26
"Jan Roush Student Folklore Writing Collection",uus_mss259.xml,80444/xv58419,5,8,13,26
"Logan City School District",uus_mss237.xml,80444/xv59082,14,4,8,26
"Herschel Bullen, Sr. papers",uus_mss182.xml,80444/xv92745,3,13,10,26
"Allen W. Stokes Papers",uus_mss215.xml,80444/xv30462,12,2,11,25
"Utah State University Logan Canyon Land Use Management Oral History Collection",uus_folkcoll042.xml,80444/xv87823,4,12,9,25
"Ted W. Daniel Photograph Collection",uus_p0373.xml,80444/xv25793,6,9,10,25
"John Henry Humphrey Barker papers",uus_mss025.xml,80444/xv44860,7,13,5,25
"Tomáš G. Masaryk Papers",uus_mss233.xml,80444/xv40643,11,1,13,25
"Ed Decker photograph collection",uus_p0344.xml,80444/xv14385,7,10,8,25
"Addison Pratt family papers",uus_mss228b.xml,80444/xv39932,10,5,10,25
"Brigham Young University student fieldwork collection",uus_folkcoll007.xml,80444/xv47683,5,9,11,25
"Utah Cooperative Association",uus_mss129.xml,80444/xv28604,11,7,7,25
"George Thomas papers",uus_mss116.xml,80444/xv77001,1,11,12,24
"Sonne, Conway B",uus_p0118.xml,80444/xv30316,3,14,7,24
"The LaGrande Peterson family photograph collection",uus_p0110.xml,80444/xv61688,10,10,4,24
"Bullen Family Papers",uus_mss378.xml,80444/xv06408,12,5,7,24
"Bishop and Peterson Professional Engineers papers",uus_mss045.xml,80444/xv70272,4,17,2,23
"September 11, 2001 USU student documentary collection",uus_folkcoll026.xml,80444/xv87231,2,13,8,23
"Smithfield Oral History Project",uus_folkcoll048.xml,80444/xv91705,4,11,8,23
"Ray B. West Papers",uus_mss076.xml,80444/xv74850,8,10,5,23
"Arthur D. Smith range management photograph collection",uus_p0021.xml,80444/xv28894,9,7,7,23
"USU student folklore genre collection of human condition legends",uus_folkcoll008a_7humancondition.xml,80444/xv14239,8,4,11,23
"James Crockwell photograph collection",uus_p0102.xml,80444/xv90728,6,10,7,23
"George W. Reed papers",uus_mss115.xml,80444/xv73352,9,5,9,23
"Bear River High School records",uus_mss413.xml,80444/xv26382,2,8,12,22
"Bartlie T. Cardon Photograph Collection,",uus_p0005.xml,80444/xv27099,4,11,7,22
"Anthon James Nielsen papers",uus_mss044.xml,80444/xv56246,10,7,5,22
"John August Carlson papers",uus_mss026.xml,80444/xv99398,5,10,7,22
"Franklin County Beet Growers papers",uus_mss205.xml,80444/xv81994,7,10,5,22
"Heber C. Snell photograph collection",uus_p0133.xml,80444/xv31680,3,13,6,22
"Milton Abrams papers",uus_mss471.xml,80444/xv53442,10,6,6,22
"Ida-Marie Jensen Papers",uus_mss062.xml,80444/xv39266,6,12,4,22
"Providence City Oral History Project",uus_folkcoll053.xml,80444/xv22653,7,9,6,22
"Edward A. Ferguson World War II correspondence",uus_mss303.xml,80444/xv05856,5,3,14,22
"David J. Smith photograph collection.",uus_p0478.xml,80444/xv48339,0,20,1,21
"Cache County Aerial photograph collection.",uus_p0383.xml,80444/xv84960,10,4,7,21
"Utah Farm Bureau Federation Collection",uus_mss213.xml,80444/xv52151,6,12,3,21
"Smith Brothers Lumber Company Papers",uus_mss342.xml,80444/xv19256,7,2,12,21
"John I. White photograph collection",uus_p0037.xml,80444/xv27459,3,8,10,21
"Utah Cooperative Association Photograph Collection.",uus_p0385.xml,80444/xv47692,2,18,1,21
"John S. Flannery papers",uus_mss271.xml,80444/xv61898,5,9,7,21
"International Circulation Managers Association records",uus_mss125.xml,80444/xv44067,12,5,4,21
"Gary B. Hansen Photograph Collection.",uus_p0384.xml,80444/xv40911,5,10,6,21
"Utah-Idaho Central Railroad Company, Mendon Station Papers",uus_mss60.xml,80444/xv94613,8,9,4,21
"Bound manuscripts collection",uus_mss238.xml,80444/xv65136,5,12,4,21
"LuAnn Ferrin photograph collection",uus_p0127.xml,80444/xv02816,2,14,4,20
"Sam Agins collection: fieldwork cassette tapes",uus_folkcoll030f.xml,80444/xv00045,6,10,4,20
"USU student folklore genre collection of songs",uus_folkcoll008a_5.xml,80444/xv36282,9,6,5,20
"Rocky Mountain Faculty Athletic Conference archives",uus_mss014.xml,80444/xv28643,8,5,7,20
"West Cache Irrigation Company : records",uus_mss097.xml,80444/xv95013,3,13,4,20
"Farmers Cooperative Irrigation Company papers",uus_mss110.xml,80444/xv72247,0,19,1,20
"Daryl Chase Papers",uus_3_1_10_2.xml,80444/xv29708,7,10,3,20
"Cowboy poetry poster collection",uus_folkcoll011h.xml,80444/xv07769,2,14,4,20
"Champ family papers",uus_mss130.xml,80444/xv96951,1,12,7,20
"The Willis and Wayment Family Papers",uus_mss329.xml,80444/xv00292,3,8,9,20
"L.M. Winsor photograph collection",uus_p0343.xml,80444/xv40353,7,11,2,20
"George Dewey Clyde Photograph Collection",uus_p0374.xml,80444/xv41268,7,12,1,20
"Wilford R. Gardner papers",uus_mss269.xml,80444/xv40728,3,9,8,20
"David Lane Wright addendum",uus_mss039.xml,80444/xv85739,4,6,10,20
"Stanford O. Cazier Papers",uus_3_1_12_2.xml,80444/xv80923,5,8,7,20
"Ernest Dupille travelogue and photographs",uus_p0146.xml,80444/xv52297,12,7,1,20
"Harry Reuben Reynolds papers",uus_mss106.xml,80444/xv00973,9,4,6,19
"Joseph Jeppe Larsen Papers",uus_mss312.xml,80444/xv38836,0,16,3,19
"Thatcher Brothers Banking Co. records",uus_mss003.xml,80444/xv85131,13,5,1,19
"Willard and Bessie Ballard papers",uus_mss265.xml,80444/xv86831,2,15,2,19
"Jensen Haslem Architects collection",uus_mss517.xml,80444/xv78695,11,6,2,19
"Jens and Mary Emma Jensen collection",uus_mss392.xml,80444/xv64285,11,6,2,19
"Utah-Idaho Central Railroad Company, Wellsville Station Papers",uus_mss061.xml,80444/xv28366,8,8,3,19
"Lincoln Ellison photograph collection",uus_p0556.xml,80444/xv26110,4,11,4,19
"LaGrande Peterson Family Papers",uus_mss313.xml,80444/xv51501,6,8,5,19
"King Hendricks papers",uus_mss441.xml,80444/xv02865,0,18,1,19
"USU student folklore genre collection of material culture",uus_folkcoll008a_8.xml,80444/xv71188,10,5,4,19
"Citizens for the Protection of Logan Canyon/Logan Canyon Coalition Papers",uus_mss314.xml,80444/xv63458,2,13,4,19
"Newell Hart photographs",uus_p0251.xml,80444/xv79556,4,9,5,18
"Lark, Utah, Oral Interviews",uus_mss339.xml,80444/xv15603,7,6,5,18
"Old Main Fire photograph collection",uus_p0430.xml,80444/xv92965,10,3,5,18
"Nolan James Nelson photograph collection",uus_p0388.xml,80444/xv09738,7,8,3,18
"Christian Christiansen Bindrup papers",uus_mss030.xml,80444/xv28228,7,6,5,18
"Addison Pratt Research",uus_mss228e.xml,80444/xv00946,1,14,3,18
"Palmer DeLong papers",uus_mss519.xml,80444/xv98550,5,13,0,18
"Edgar Bentley Mitchell Papers",uus_mss322.xml,80444/xv06356,6,10,2,18
"Community Improvement Through Local History Project oral histories",uus_mediacoll006.xml,80444/xv47653,0,0,18,18
"Miscellaneous Oral History Collection",uus_mss461.xml,80444/xv81146,11,7,0,18
"John W. Fitzgerald Photograph Collection.",uus_p0377.xml,80444/xv60314,6,5,7,18
"Edward P. Cliff photograph collection",uus_p0352.xml,80444/xv38281,3,3,12,18
"Forster family papers",uus_mss240.xml,80444/xv00888,5,12,1,18
"Maxwell D. Cohn photograph collection,",uus_p0007.xml,80444/xv67819,5,2,11,18
"James N. Holdaway Papers",uus_mss328.xml,80444/xv92337,2,10,6,18
"Pratt family photograph collection",uus_p0280.xml,80444/xv51733,4,5,8,17
"James Foster Scott photograph collection",uus_p0120.xml,80444/xv96627,3,5,9,17
"Ione Bennion photograph collection",uus_p0371.xml,80444/xv58987,5,4,8,17
"Anderson Photograph Studio archive",uus_p0252.xml,80444/xv94003,3,11,3,17
"Cache Valley portfolio",uus_p0122.xml,80444/xv95721,2,8,7,17
"Fred W. Hodgson Architectural Drawings",uus_mss346.xml,80444/xv54293,7,10,0,17
"Barre Toelken sound recording collection",uus_folkcoll035b.xml,80444/xv20861,1,10,6,17
"Carlisle family papers",uus_mss527.xml,80444/xv20425,0,17,0,17
"Capitol Theatre papers",uus_cainemss009.xml,80444/xv95581,8,4,5,17
"Asa Wayne Arrington photograph collection",uus_p0428.xml,80444/xv22451,5,8,4,17
"Architectural Design West PC papers",uus_archmss1.xml,80444/xv90505,8,5,4,17
"James Prestini Collection",uus_mss360.xml,80444/xv58071,5,8,4,17
"Kenneth Wayne Brewer Photographs",uus_p0381.xml,80444/xv99295,6,7,4,17
"Swett Ranch Oral Histories",uus_mss283.xml,80444/xv65576,1,5,11,17
"J.P. Smith Printing Company records",uus_mss431.xml,80444/xv99395,3,5,9,17
"Jay Anderson foodways research collection",uus_folkcoll017b.xml,80444/xv81814,3,9,5,17
"Vicky D. Burgess Papers",uus_mss321.xml,80444/xv97622,10,1,6,17
"Pleasant View, Utah, LDS Relief Society Records",uus_mss266.xml,80444/xv07159,5,6,6,17
"Cache Valley Presbyterian Church Oral History Collection",uus_folkcoll044.xml,80444/xv10546,4,5,8,17
"William H. Neff Architectural Papers",uus_mss311.xml,80444/xv86810,6,1,10,17
"Laura R. Merrill papers",uus_mss119.xml,80444/xv33587,6,6,5,17
"Cache Chamber of Commerce papers",uus_mss293.xml,80444/xv54714,7,6,4,17
"French family album,",uus_p0109.xml,80444/xv69393,4,10,3,17
"David Meltzer Papers",uus_mss526.xml,80444/xv64669,15,1,1,17
"Jeff Goldberg papers",uus_mss492.xml,80444/xv34649,9,4,4,17
"Grant Redford Papers",uus_mss245.xml,80444/xv04086,9,2,6,17
"Howell family papers",uus_cainemss005.xml,80444/xv52868,7,5,4,16
"Vanez T. Wilson Photograph Collection",uus_p0468.xml,80444/xv43038,4,7,5,16
"Betsy Jane Tenney Loose Papers",uus_mss177.xml,80444/xv02523,3,4,9,16
"Edwin L. Peterson family papers",uus_mss509.xml,80444/xv92773,10,3,3,16
"John I. White papers",uus_mss201.xml,80444/xv41470,1,11,4,16
"Joseph Smith III portrait",uus_p0331.xml,80444/xv55429,4,3,9,16
"Delmar Clive Tingey Photograph Collection,",uus_p0015.xml,80444/xv17352,6,9,1,16
"Carlton Fordis Culmsee photograph collection",uus_p0128.xml,80444/xv13189,3,10,3,16
"Folklore newsletter collection",uus_folkcoll015.xml,80444/xv59460,3,9,4,16
"Marcus de Lafayette Simpson Correspondence",uus_cainemss032.xml,80444/xv03756,2,12,2,16
"Utah State University historical materials",uus_10_2.xml,80444/xv58856,7,4,5,16
"Joel Edward Ricks Papers",uus_mss114.xml,80444/xv08605,4,10,2,16
"Napper family photograph collection",uus_p0359.xml,80444/xv34826,4,5,7,16
"Valeen T. Avery Photograph Collection",uus_p0386.xml,80444/xv08074,0,11,5,16
"David Lane Wright photograph collection",uus_p0135.xml,80444/xv40310,7,4,5,16
"Logan Boy Scout Troop 5 photograph album",uus_p0364.xml,80444/xv43746,4,7,5,16
"J. Arbon Christensen radio transcripts",uus_mss231.xml,80444/xv10571,5,8,3,16
"Sidney Stevens Implement Company papers",uus_mss007.xml,80444/xv98147,4,9,3,16
"Frankland J. Kennard Vernal CCC Camp photographs,",uus_p0108.xml,80444/xv74862,3,12,1,16
"Sorosis Society photograph collection",uus_p0139.xml,80444/xv26745,2,11,2,15
"Thatcher family photograph collection",uus_p0036.xml,80444/xv79000,4,6,5,15
"C.W. Carter Photograph Collection",uus_p0548.xml,80444/xv83151,6,4,5,15
"Orson Smith Papers",uus_mss357.xml,80444/xv11541,4,5,6,15
"Twin Lakes Canal Company photograph collection",uus_p0029.xml,80444/xv68890,7,5,3,15
"John A. and Leah D. Widtsoe photograph collection",uus_p0250.xml,80444/xv49136,2,10,3,15
"George D. Clyde speeches",uus_mss255.xml,80444/xv38351,2,9,4,15
"Henry Clark Jackson papers",uus_mss475.xml,80444/xv52612,4,5,6,15
"Henry Peterson papers",uus_mss105.xml,80444/xv01531,5,6,4,15
"Mathew M. Forster Photograph Collection,",uus_p0010.xml,80444/xv67327,1,9,5,15
"Laurence A. Stoddart Papers",uus_mss51.xml,80444/xv04498,2,10,3,15
"Shoshone Indian portrait collection",uus_p0292.xml,80444/xv63784,1,12,2,15
"Cache Valley medical literature collection",uus_mss286.xml,80444/xv23010,0,11,4,15
"Edith Tippets Hayes Papers",uus_mss333.xml,80444/xv28457,7,4,4,15
"Cardon Family Papers",uus_mss481.xml,80444/xv62405,6,7,2,15
"Utah Cooperative Extension Division Photographs,",uus_p0017.xml,80444/xv92532,5,5,5,15
"F. Ross Peterson Photograph Collection.",uus_p0391.xml,80444/xv72570,1,8,6,15
"Richmond history papers",uus_mss434.xml,80444/xv20797,2,7,6,15
"United States Bureau of Fisheries Idaho Survey Unit records",uus_mss186.xml,80444/xv60348,4,9,2,15
"Paul Swenson Papers",uus_mss476.xml,80444/xv94833,5,7,3,15
"USU Homecoming Photograph Collection",uus_p0387.xml,80444/xv67614,2,3,10,15
"The Reverend Paul Jones Photographs 1913 Collection",uus_p0564.xml,80444/xv77029,8,3,4,15
"Wasatch Research Center photograph collection",uus_p0464.xml,80444/xv09982,4,2,9,15
"Horace Hall Cummings family papers",uus_mss226.xml,80444/xv46743,3,8,4,15
"Melville Irrigation Company Papers",uus_mss140.xml,80444/xv09545,8,2,5,15
"Golden Spike Oral Histories",uus_mss291.xml,80444/xv69232,5,9,1,15
"William H. Hopkins photograph collection",uus_p0319.xml,80444/xv19689,10,1,4,15
"Floyd and Edith Morgan Papers",uus_mss222.xml,80444/xv88760,12,0,2,14
"Oliver L. Peterson : diaries",uus_mss101.xml,80444/xv49771,5,2,7,14
"USU Sorority Women's Intramurals photograph collection",uus_p0439.xml,80444/xv20159,2,11,1,14
"Edwin L. Peterson Family Photograph Collection",uus_p0393.xml,80444/xv11560,8,3,3,14
"Utah Boys' State participant records",uus_mss096.xml,80444/xv52536,10,3,1,14
"Anti-litter campaign collection",uus_mss104.xml,80444/xv89120,3,6,5,14
"Utah Wilderness Association photograph collection",uus_p0369.xml,80444/xv30990,7,6,1,14
"Thatcher family papers",uus_mss093.xml,80444/xv03115,0,7,7,14
"Tueller family photograph collection",uus_p0204.xml,80444/xv40466,2,3,9,14
"Cardon Realty Company",uus_mss173.xml,80444/xv91821,2,7,5,14
"Noble Nielsen photograph collection",uus_p0363.xml,80444/xv78729,1,8,5,14
"Melba Johnson World War II correspondence",uus_mss309.xml,80444/xv79614,8,5,1,14
"Cache County records collection",uus_countymss001.xml,80444/xv90603,8,5,1,14
"John Suiter papers",uus_mss480.xml,80444/xv25408,5,5,4,14
"USU Interfaith Initiative",uus_folkcoll0057.xml,80444/xv23181,3,6,5,14
"Cache Valley Historical Society Papers",uus_mss043.xml,80444/xv86056,2,6,6,14
"Samuel Claridge research",uus_mss228c.xml,80444/xv52444,6,3,5,14
"George Dewey Clyde papers",uus_mss176.xml,80444/xv47460,5,6,3,14
"Mormon enigma : Emma Hale Smith : manuscript",uus_mss085.xml,80444/xv04064,3,4,7,14
"Death Valley region photographs",uus_p0126.xml,80444/xv54928,2,5,7,14
"Peter Schmid photograph collection",uus_p0314.xml,80444/xv99591,4,4,5,13
"Bear River Club histories",uus_mss427.xml,80444/xv92996,5,6,2,13
"Western Society of Soil Science Records",uus_mss267.xml,80444/xv90756,6,6,1,13
"William A. Wilson slide collection",uus_folkcoll034.xml,80444/xv09179,3,7,3,13
"Blacksmith Fork Canyon photographs,",uus_p0026.xml,80444/xv08462,6,5,2,13
"Edwin L. Peterson-Eisenhower Campaign Documents",uus_mss174.xml,80444/xv41647,10,0,3,13
"B.A. Etcheverry water reclamation photograph collection",uus_p0104.xml,80444/xv93203,1,7,5,13
"Deta P. Neeley Papers",uus_mss277.xml,80444/xv77606,5,2,6,13
"Davis and Weber Counties Canal Company papers",uus_mss111.xml,80444/xv28564,5,3,5,13
"Joseph Arch Geddes papers",uus_mss075.xml,80444/xv84576,0,9,4,13
"Eva B. Israelsen Diaries",uus_mss393.xml,80444/xv58239,5,8,0,13
"Files of Planting and Seeding Western Range Lands",uus_17_21_45b.xml,80444/xv97045,5,8,0,13
"Mormons for ERA photograph collection",uus_p0144.xml,80444/xv97470,6,4,3,13
"John W. Young Papers",uus_cainemss026.xml,80444/xv58990,7,5,1,13
"Lund Utah Scrapbook photograph collection",uus_p0555.xml,80444/xv69680,5,5,3,13
"Sorensen Family Papers",uus_mss344.xml,80444/xv97113,9,2,2,13
"Glen E. Stringham Papers",uus_14_4_2_45d.xml,80444/xv52511,1,10,2,13
"Utah Weather Station Records",uus_mss470.xml,80444/xv90377,0,8,5,13
"George H. Emert Papers",uus_3_1_13_2.xml,80444/xv62786,3,6,4,13
"Charles R. Batten papers",uus_mss426.xml,80444/xv47259,3,6,4,13
"Willard Weld Clark papers",uus_mss272.xml,80444/xv89352,11,2,0,13
"William Theron Barker photograph collection",uus_p0123.xml,80444/xv60037,3,7,3,13
"USU Athletics photograph collection",uus_p0418.xml,80444/xv96463,7,3,3,13
"Logan 7th Ward Treasurer's Cash Account Ledger",uus_mss162.xml,80444/xv40505,0,12,1,13
"American Legion Women's Auxiliary Scrapbook",uus_mss416.xml,80444/xv01641,3,9,1,13
"Frank Calkins papers",uus_mss029.xml,80444/xv48287,9,1,3,13
"A. Douglas Allen Photo Collection",uus_p0476.xml,80444/xv74545,5,4,4,13
"Edwin L. Peterson World War II Propaganda",uus_mss274.xml,80444/xv38583,5,1,6,12
"Ernest Fred Johnson World War I Papers",uus_mss326.xml,80444/xv24130,0,9,3,12
"E. LaRetta Gibbons missionary diary",uus_mss288.xml,80444/xv01077,7,5,0,12
"USU student folklore genre collection of supernatural religious legends",uus_folkcoll008a_7supernaturalreligious.xml,80444/xv07513,4,3,5,12
"A. Ray Oliver photograph collection",uus_p0332.xml,80444/xv91738,2,5,5,12
"James C. Miller Papers",uus_mss35.xml,80444/xv16857,0,5,7,12
"D. Wynne Thorne Papers",uus_mss299.xml,80444/xv16235,5,7,0,12
"The May Swenson photograph collection",uus_p0437.xml,80444/xv03918,3,7,2,12
"Wayne O. Goodwin family papers",uus_mss258.xml,80444/xv76406,4,3,5,12
"Joseph Arch Geddes photograph collection",uus_p0112.xml,80444/xv92306,1,7,4,12
"Leith J. Corbridge Family Papers",uus_mss448.xml,80444/xv67562,3,9,0,12
"Ed McClanahan Papers",uus_mss394.xml,80444/xv35067,8,4,0,12
"USU student folklore genre collection of etiological legends",uus_folkcoll008a_7etiological.xml,80444/xv52661,4,3,5,12
"The Utah Beet Growers Association Papers",uus_mss204.xml,80444/xv73678,1,10,1,12
"Papers of John T. Caine",uus_cainemss33.xml,80444/xv36392,3,6,3,12
"Davis County Watershed Rehabilitation and Management Articles and Reports",uus_mss479.xml,80444/xv26565,2,3,7,12
"Western views photograph album",uus_p0205.xml,80444/xv80541,3,5,4,12
"The Logan Island Defense Committee Papers",uus_mss141.xml,80444/xv17340,9,3,0,12
"Doyle Rees photograph collection",uus_p0408.xml,80444/xv97671,6,3,3,12
"Cache Valley Cowboy Rendezvous Collection",uus_folkcoll051.xml,80444/xv57254,2,5,4,11
"USU Student Union Photograph Collection",uus_p0367.xml,80444/xv08700,5,4,2,11
"Winslow Whitney Smith Papers",uus_mss247.xml,80444/xv95111,0,10,1,11
"Maria Ellsworth papers",uus_mss229.xml,80444/xv05932,2,3,6,11
"Sevier River Land and Water Company Papers",uus_mss334.xml,80444/xv87976,3,1,7,11
"Utah Home Economics Association Papers",uus_mss095.xml,80444/xv67083,6,4,1,11
"Papers of Louis L. Madsen",uus_3_1_8_2.xml,80444/xv65524,4,5,2,11
"Orson F. Whitney Letters",uus_mss167.xml,80444/xv43170,4,6,1,11
"Diary of Mary Emma Bird",uus_mss151.xml,80444/xv41799,5,4,2,11
"Reynold Marvin Kirby papers",uus_cainemss002.xml,80444/xv31829,7,3,1,11
"International Student Council general files",uus_25_7_1_5_45.xml,80444/xv50024,3,4,4,11
"First Security Bank photograph collection",uus_p0533.xml,80444/xv44085,8,3,0,11
"Fort Washakie photograph collection",uus_p0291.xml,80444/xv07904,5,3,3,11
"Brigham Young financial records",uus_mss042.xml,80444/xv94705,0,5,6,11
"Echo Roller Mill papers",uus_mss127.xml,80444/xv96887,5,3,3,11
"Walter E. Peay Papers",uus_mss373.xml,80444/xv59350,4,7,0,11
"USU Libraries",uus_p0420.xml,80444/xv67642,6,4,1,11
"Datus M. Hammond papers",uus_mss103.xml,80444/xv66937,1,2,8,11
"Edward B. Hanson Papers",uus_mss159.xml,80444/xv27474,0,7,4,11
"Wayne D. Criddle papers",uus_mss307.xml,80444/xv73931,2,5,4,11
"Jack H. Berryman Photograph Collection",uus_p0368.xml,80444/xv99505,2,3,6,11
"Orson Gurney Smith photograph collection.",uus_p0576.xml,80444/xv97528,0,9,2,11
"Papers of Frank Boyer Salisbury",uus_14_1_9_26.xml,80444/xv65060,6,5,0,11
"Austin Douglas Allen Papers",uus_mss382.xml,80444/xv33444,4,7,0,11
"Eldon J. Gardner Photograph Collection",uus_p0390.xml,80444/xv44406,4,5,2,11
"C. W. Lauritzen papers",uus_mss024.xml,80444/xv27691,2,5,4,11
"Teton Dam reports",uus_mss469.xml,80444/xv50274,1,10,0,11
"Episcopal Church bishop portraits",uus_p0028.xml,80444/xv13500,2,5,4,11
"Utah juniper photograph collection",uus_p0366.xml,80444/xv82354,2,6,3,11
"John C. Anderson journal",uus_mss143.xml,80444/xv76892,4,4,3,11
"Alfred Hart photograph collection.",uus_p0563.xml,80444/xv16040,0,10,1,11
"International Association of Laboratory Schools Collection",uus_mss287.xml,80444/xv37561,4,4,3,11
"Heinrich Diederichsen correspondence",uus_mss033.xml,80444/xv05792,6,5,0,11
"Richard Welling Roskelley photograph collection",uus_p0429.xml,80444/xv71099,4,4,3,11
"William D. Hurst Papers",uus_mss362.xml,80444/xv73037,1,10,0,11
"Sylvan E. Needham, Sr. Photo Album",uus_p0117.xml,80444/xv64611,1,6,4,11
"First Presbyterian Church Papers",uus_mss368.xml,80444/xv35449,4,1,6,11
"USU student folklore genre collection of character legends",uus_folkcoll008a_7character.xml,80444/xv53784,6,1,4,11
"Mary Taggart papers",uus_mss406.xml,80444/xv25103,3,6,2,11
"Utah Mortgage and Loan Corporation Records",uus_mss131.xml,80444/xv90945,2,3,5,10
"World War II collection",uus_mss478.xml,80444/xv15484,4,5,1,10
"Glen Taggart photograph collection",uus_p0426.xml,80444/xv96279,3,3,4,10
"Survey notebooks and maps of Nephi and Lorenzo Anderson,",uus_mss089.xml,80444/xv79168,1,6,3,10
"Frank Kelsey papers",uus_mss467.xml,80444/xv37417,0,5,5,10
"Mae Crookston Wennegren photograph collection",uus_p0130.xml,80444/xv90267,4,2,4,10
"Singin' Sam Agins papers",uus_mss230.xml,80444/xv00067,3,6,1,10
"Sevier County Drainage District #4 Records",uus_mss235.xml,80444/xv51940,0,8,2,10
"George D. Clyde research materials",uus_mss279.xml,80444/xv05313,5,5,0,10
"Walter Hoge papers",uus_mss300.xml,80444/xv53213,3,5,2,10
"Joel E. Fletcher Photograph Collection",uus_p0380.xml,80444/xv62557,4,4,2,10
"Parley P. Black Papers",uus_mss338.xml,80444/xv53527,3,6,1,10
"<emph render="italic">One who was valiant</emph> Drafts",uus_mss021.xml,80444/xv30184,3,4,3,10
"Newton Library photograph collection.",uus_p0584.xml,80444/xv99536,3,3,4,10
"Portage, Utah Receipts from the Bishop's Storehouse",uus_mss202.xml,80444/xv52294,4,2,4,10
"Thatcher Brothers Banking Company Safety Deposit Boxes",uus_mss175.xml,80444/xv98931,4,5,1,10
"Joan Crum: Deer Lodge, Montana Genealogies",uus_mss157.xml,80444/xv02322,1,6,3,10
"First Presbyterian Church of Logan collection",uus_p0132.xml,80444/xv25958,3,4,3,10
"Amalgamated Sugar Company-Lewiston Sugar Company records",uus_mss278.xml,80444/xv78732,6,3,1,10
"McQuown - DeVoto papers",uus_mss054.xml,80444/xv46929,2,7,1,10
"Design Workshop, Inc. Photographs",uus_p0394.xml,80444/xv93600,0,9,1,10
"Conway B. Sonne Papers",uus_ljahamss008.xml,80444/xv70040,5,3,2,10
"Utah Fish and Game photograph collection",uus_p0545.xml,80444/xv89410,2,6,2,10
"USU student folklore genre collection of games and pranks",uus_folkcoll008a_6.xml,80444/xv81375,5,4,1,10
"Wilson F. McDill Papers",uus_mss122.xml,80444/xv63098,4,6,0,10
"Clyde T. Hardy photograph collection",uus_p0392.xml,80444/xv27523,3,1,6,10
"John Milton Bernhisel III missionary diaries",uus_mss292.xml,80444/xv72622,6,2,2,10
"Realia",uus_cainemss020.xml,80444/xv26596,1,4,4,9
"United States Bureau of Fisheries photographs,",uus_p0016.xml,80444/xv54602,2,3,4,9
"College of Natural Resources photograph collection",uus_p0526.xml,80444/xv55532,3,1,5,9
"Laura R. Merrill Newberry & Caldecott Book Award Winners",uus_mss090.xml,80444/xv10437,1,6,2,9
"Kootenai River Valley agricultural photographs",uus_p0125.xml,80444/xv45227,0,9,0,9
"Sam Agins collection : video and beta tapes",uus_folkcoll030c.xml,80444/xv10778,0,6,3,9
"Father Harold Baxter Liebler and Brother Juniper photograph collection,",uus_p0103.xml,80444/xv40399,5,1,3,9
"Clyde A. Milner II papers",uus_14_6_5_17e.xml,80444/xv15139,1,5,3,9
"Lynn S. Huffaker daybooks",uus_mss153.xml,80444/xv93469,6,2,1,9
"Irene Griffith Talbot correspondence",uus_mss452.xml,80444/xv02798,4,4,1,9
"The Folklore Society of Utah Collection.",uus_folkcoll028.xml,80444/xv90362,2,4,3,9
"Anderson Lumber Co. Papers",uus_mss349.xml,80444/xv40185,5,3,1,9
"Louise Degn Broadcast Archive",uus_mss437.xml,80444/xv07925,5,2,2,9
"International Programs (Global Engagement) Office Files",uus_22_45c.xml,80444/xv02169,8,1,0,9
"Utah Idaho Central Railway Providence Station Records",uus_mss163.xml,80444/xv95501,1,2,6,9
"E.B. Olesen photograph collection",uus_p0318.xml,80444/xv14859,3,3,3,9
"Bruce Anderson photograph collection",uus_p0571.xml,80444/xv91281,1,8,0,9
"Sam Agins collection : reel-to-reel tapes",uus_folkcoll030d.xml,80444/xv92489,2,4,3,9
"William F. Lye South African manuscripts",uus_mss260.xml,80444/xv89343,4,4,1,9
"W.P.A. history of grazing collection",uus_mss008.xml,80444/xv44970,0,5,4,9
"United States Geologic Survey photograph collection,",uus_p0116.xml,80444/xv26754,0,7,2,9
"Ernest C. Jeppsen papers",uus_mss435.xml,80444/xv69293,0,7,2,9
"Edward P. Cliff papers",uus_mss013.xml,80444/xv19540,5,4,0,9
"Bobbie Coray Papers",uus_mss422.xml,80444/xv16729,6,3,0,9
"Utah Wool Growers Association papers",uus_mss055.xml,80444/xv89242,0,6,3,9
"Jack London photograph collection.",uus_p0551.xml,80444/xv28634,8,1,0,9
"Martin Harris Pageant records",uus_mss243.xml,80444/xv05999,2,3,3,8
"E.G. Peterson Papers",uus_3_1_6_2.xml,80444/xv37738,0,2,6,8
"Briant H. Stringham papers",uus_mss048.xml,80444/xv12982,1,6,1,8
"Dr. George F. Knowlton photograph collection",uus_p0115.xml,80444/xv24218,1,4,3,8
"Mink Creek Stockmen’s Association records",uus_mss442.xml,80444/xv10687,3,5,0,8
"Professional Activities of Norman Keith Roberts",uus_14_2_6_45.xml,80444/xv63504,8,0,0,8
"Utah Commencement Program",uus_mss325.xml,80444/xv96365,2,5,1,8
"The Grouse Creek photograph collection",uus_p0201.xml,80444/xv48324,0,4,4,8
"Utah State Farm Bureau vs. National Farmers Union Service court documents",uus_mss495.xml,80444/xv09707,2,6,0,8
"Jerald E. Christiansen Papers",uus_mss310.xml,80444/xv54501,2,4,2,8
"Seventh Ward Irrigation Company : records",uus_mss100.xml,80444/xv59255,5,2,1,8
"David Lane Wright papers",uus_mss002.xml,80444/xv41299,1,5,2,8
"Klaus J. Hansen papers",uus_mss457.xml,80444/xv93377,1,5,2,8
"First National Bank of Logan- Credit",uus_mss171.xml,80444/xv01889,3,3,2,8
"Hezekiah Sumner Hatch family photographs",uus_p0530.xml,80444/xv24789,3,2,3,8
"The military science and tactics photograph collection",uus_p0137.xml,80444/xv66250,3,4,1,8
"Cache County (Utah) school districts papers",uus_mss040.xml,80444/xv36645,0,2,6,8
"Riter Brothers Drug Company Records",uus_mss224.xml,80444/xv59600,2,4,2,8
"Papers of Henry Aldous Dixon",uus_3_1_9_2.xml,80444/xv15014,1,4,3,8
"Provo River Division Reports",uus_mss370.xml,80444/xv92620,1,7,0,8
"USU student folklore genre collection of E-lore",uus_folkcoll008a_9.xml,80444/xv32928,2,1,5,8
"Arthur W. Hart Papers",uus_cainemss013.xml,80444/xv68853,5,2,1,8
"Charles W. Fox papers",uus_mss066.xml,80444/xv02468,6,2,0,8
"Ernest Mahan Papers",uus_mss142.xml,80444/xv75747,5,1,2,8
"Winslow Farr Smith Papers",uus_mss246.xml,80444/xv12890,3,4,1,8
"Elizabeth Pickett Tolman diary",uus_mss487.xml,80444/xv38537,1,4,3,8
"Willie Ottogary Papers",uus_mss263.xml,80444/xv27645,5,2,1,8
"Merrill family papers",uus_mss117.xml,80444/xv62222,3,4,1,8
"Heber J. Grant Presentation Book",uus_p0573.xml,80444/xv97216,0,8,0,8
"LaVell Cooley photograph collection",uus_p0101.xml,80444/xv30639,2,4,2,8
"F. Jay Haynes photograph collection",uus_p0565.xml,80444/xv47906,0,0,8,8
"Franklin County (Idaho). East Side Schools records,",uus_cainemss006.xml,80444/xv43228,2,3,3,8
"Wayne D. Criddle photograph collection",uus_p0353.xml,80444/xv38586,3,4,1,8
"Book Table Records",uus_mss242.xml,80444/xv91836,1,4,3,8
"Erwin U. Moser papers",uus_mss460.xml,80444/xv71719,3,5,0,8
"George B. Caine papers",uus_mss298.xml,80444/xv27697,4,1,3,8
"Hezekiah Sumner Hatch family papers",uus_mss305.xml,80444/xv43005,2,4,2,8
"Papers of Lyman Willardson",uus_14_4_2_45b.xml,80444/xv46841,6,1,1,8
"Logan Temple Time Books",uus_mss223.xml,80444/xv92761,4,4,0,8
"Utah State Agricultural College. College of Engineering. Office of the Dean. Dean's war production training files",uus_rg14_4_1_17a.xml,80444/xv10772,7,1,0,8
"Edgar B. Brossard addendum",uus_mss220.xml,80444/xv19741,4,3,1,8
"Carl E. Hayden National Forest collection",uus_mss015.xml,80444/xv30307,2,1,5,8
"Abby Groesbeck Jenson diaries and account books",uus_mss123.xml,80444/xv72714,3,2,2,7
"Eva Wennergren Diaries",uus_mss152.xml,80444/xv36825,1,5,1,7
"Wyoming Sheep Ranch photograph collection.",uus_p0593.xml,80444/xv14526,0,0,7,7
"Caroline Barnes Crosby family papers",uus_mss229a.xml,80444/xv40148,5,0,2,7
"Musical Heritage Studies of Southeastern Idaho: Transcripts",uus_mss064.xml,80444/xv13909,1,0,6,7
"Allan M. West : papers",uus_mss078.xml,80444/xv15527,3,4,0,7
"1890 Western Travel Album photograph collection.",uus_p0603.xml,80444/xv13040,0,7,0,7
"Utah State University Intermountain Herbarium photograph collection",uus_p0119.xml,80444/xv89471,0,4,3,7
"The Harry Simon Navy ROTC Photographs Collection",uus_p0402.xml,80444/xv35870,3,1,3,7
"Utah American Revolution Bicentennial Commission papers",uus_mss092.xml,80444/xv44110,4,0,3,7
"Utah State University student activity photographs",uus_p0312.xml,80444/xv61947,2,3,2,7
"Ronald Jensen collection",uus_mss512.xml,80444/xv90261,0,5,2,7
"Brotherhood of Railroad Trainmen Lodge #607",uus_cainemss023.xml,80444/xv14642,3,4,0,7
"LeGrande Rich Humphreys papers",uus_mss036.xml,80444/xv62307,2,0,5,7
"Trenton-Clarkston Mill and Elevator Company Records",uus_mss198.xml,80444/xv61959,5,2,0,7
"Asahel Henry Smith and Pauline Udall family papers,",uus_mss228h.xml,80444/xv05371,3,1,3,7
"American Gold Star Mothers minutes and scrapbook",uus_mss049.xml,80444/xv82891,2,2,3,7
"Corinne Business Letters",uus_mss241.xml,80444/xv47247,2,3,2,7
"Hatch correspondence",uus_mss070.xml,80444/xv56259,1,5,1,7
"Cache Chamber of Commerce Photographs and Films.",uus_p0404.xml,80444/xv52014,3,2,2,7
"American Falls Canal and Power Company papers",uus_mss109.xml,80444/xv07412,2,5,0,7
"Bridger Folk Music Society papers",uus_mss507.xml,80444/xv30703,1,6,0,7
"Anne M. Butler papers",uus_14_6_5_17c.xml,80444/xv07171,7,0,0,7
"B. G. Olesen Western Manuscript Collection",uus_mssolesen1.xml,80444/xv39083,5,0,2,7
"William Preston Thomas papers",uus_14_1_4_26.xml,80444/xv07077,7,0,0,7
"People for Wise Water Planning Papers",uus_mss304.xml,80444/xv72805,4,3,0,7
"League of Women Voters of Cache County papers",uus_mss155.xml,80444/xv03283,0,1,6,7
"Franklin S. Harris Papers",uus_3_1_7_2.xml,80444/xv56906,0,2,5,7
"Papers of the Hyde Park Ladies Literary Club",uus_cainemss021.xml,80444/xv31750,2,2,3,7
"Harold G. Wood papers",uus_mss012.xml,80444/xv97253,5,2,0,7
"Scrapbook of Liquor Related Articles from Rigby, Idaho",uus_mss193.xml,80444/xv04626,4,2,1,7
"David E. Tanner Papers",uus_mss345.xml,80444/xv50579,1,4,2,7
"John P. Taggart papers",uus_mss520.xml,80444/xv49676,7,0,0,7
"Idaho State and Savings Bank",uus_cainemss007.xml,80444/xv65838,1,1,4,6
"Correspondence concerning Jim Bridger and Louis Vasquez",uus_cainemss028.xml,80444/xv26705,2,1,3,6
"Cache County Sheriff's Office correspondence",uus_mss262.xml,80444/xv33114,3,1,2,6
"R.A. Bacon Manuscript",uus_cainemss012.xml,80444/xv59411,3,2,1,6
"Miscellaneous snapshots collection",uus_p0113.xml,80444/xv24743,2,3,1,6
"Louisa Barnes Pratt research",uus_mss228f.xml,80444/xv47644,1,5,0,6
"Delta Elementary School yearbook photograph collection",uus_p0140.xml,80444/xv50350,2,3,1,6
"Whitney and Alice Smith Collection",uus_mss379.xml,80444/xv50393,4,2,0,6
"Alfred H. Caine papers",uus_cainemss016.xml,80444/xv01837,3,0,3,6
"Rich County Aerial photograph collection",uus_p0470.xml,80444/xv09118,5,0,1,6
"International Cooperation Association general files",uus_23_14_1.xml,80444/xv24124,4,0,2,6
"Ed McClanahan photograph collection",uus_p0569.xml,80444/xv79187,0,6,0,6
"Axel Johnson papers,",uus_cainemss004.xml,80444/xv46261,1,3,2,6
"Mary M. Marks photograph collection.",uus_p0597.xml,80444/xv51721,1,3,2,6
"George H. Robinson photograph collection",uus_p0272.xml,80444/xv10635,1,2,3,6
"Frank Kelsey photograph collection",uus_p0537.xml,80444/xv68539,2,4,0,6
"George C. Jensen : papers",uus_mss073.xml,80444/xv89889,0,5,1,6
"Frank Calkins Papers Addendum",uus_mss091.xml,80444/xv84765,0,5,1,6
"Caine Archive of Intermountain Americana Miscellanea",uus_cainemss001.xml,80444/xv92218,2,2,2,6
"The Yellowstone Fires of 1988 Thesis Research Materials",uus_mss330.xml,80444/xv22000,4,2,0,6
"William Miller and William Patterson Union Pacific Railroad Correspondence",uus_mss374.xml,80444/xv21060,3,0,3,6
"Singin' Sam Agins photograph collection",uus_p0134.xml,80444/xv30285,0,3,3,6
"Frank Godfrey letters",uus_mss524.xml,80444/xv20935,3,3,0,6
"Vardis Fisher Papers",uus_mss350.xml,80444/xv58721,0,5,1,6
"Alunite LDS Branch Records",uus_mss207.xml,80444/xv07473,1,1,4,6
"John F. Blauer World War I photograph collection",uus_p0502.xml,80444/xv15933,0,3,3,6
"Utah National Register of Historic Places",uus_mss165.xml,80444/xv02627,0,2,4,6
"Clair Smith Papers",uus_mss248.xml,80444/xv97775,1,4,1,6
"Box Elder County Aerial Photograph Collection",uus_p0472.xml,80444/xv26766,5,0,1,6
"USU Student Entertainment photograph collection",uus_p0434.xml,80444/xv82965,3,1,2,6
"Bruce Anderson papers",uus_mss424.xml,80444/xv04830,2,1,3,6
"John Duncan Brite papers",uus_mss005.xml,80444/xv38748,0,5,1,6
"Raymond and Samuel Taylor Correspondence",uus_mss145.xml,80444/xv46853,4,2,0,6
"Charles W. Nibley Family Papers",uus_mss256.xml,80444/xv09713,2,1,3,6
"Charles Edwin Loose Political Correspondence",uus_mss172.xml,80444/xv98025,4,0,2,6
"Cardon Family photgraph collection",uus_p0541.xml,80444/xv83740,3,2,1,6
"Thomas Family Letters",uus_mss337.xml,80444/xv12951,5,0,1,6
"Rodello Hunter papers",uus_mss028.xml,80444/xv89083,2,3,1,6
"Bernard Alfred Etcheverry specifications",uus_mss219.xml,80444/xv68081,0,2,3,5
"USU Irrigation Engineering Photograph Collection.",uus_p0389.xml,80444/xv37344,0,2,3,5
"E. M. Brown Store Records",uus_mss395.xml,80444/xv35195,3,0,2,5
"The children sang : the life and music of Evan Stephens with the Mormon Tabernacle Choir",uus_mss169.xml,80444/xv09060,0,2,3,5
"Reid W. Wangsgaard Papers",uus_mss295.xml,80444/xv99102,0,5,0,5
"Veneta Nielsen Papers",uus_mss315.xml,80444/xv63449,4,0,1,5
"Proposal for Change in Cache County Government Structure Papers",uus_mss318.xml,80444/xv83984,2,2,1,5
"Utah capitol competition : project of Cannon, Fetzer and Ramm Hansen Architects",uus_p0107.xml,80444/xv06521,1,3,1,5
"Vegetation restudy, Great Rift, Southeastern Idaho, Records",uus_14_7_3_76b.xml,80444/xv81195,0,5,0,5
"The Utah Education Association Papers",uus_mss063.xml,80444/xv97463,0,1,4,5
"Aaron Parley Christiansen daybooks",uus_mss094.xml,80444/xv02026,1,2,2,5
"Logan Artists Group papers",uus_mss126.xml,80444/xv06213,4,1,0,5
"Samaria, Idaho, history records",uus_mss446.xml,80444/xv03030,1,4,0,5
"Charlotte Wright Papers",uus_mss387.xml,80444/xv88998,4,1,0,5
"David King and Ida F. Hunt Udall family papers,",uus_mss229b.xml,80444/xv02365,0,2,3,5
"The American Association of University Women",uus_mss124.xml,80444/xv52825,2,2,1,5
""Logan Past, Present, Future" Papers",uus_mss208.xml,80444/xv28375,3,2,0,5
"Jack H. Berryman papers",uus_mss289.xml,80444/xv29833,1,1,3,5
"Frederick P. Champ photograph collection",uus_p0354.xml,80444/xv67022,0,4,1,5
"Jenny M. Smith's Indian Student Placement Program oral histories",uus_mss294.xml,80444/xv48199,0,4,1,5
"American Civil Liberties Union, Logan Chapter records",uus_mss261.xml,80444/xv18704,2,2,1,5
"Hal Glicksman Address Book",uus_mss466.xml,80444/xv04406,0,5,0,5
"The Salt Lake Opera Company Records",uus_cainemss30.xml,80444/xv66668,4,0,1,5
"Papers of Glen Taggart while at Michigan State University",uus_mss083.xml,80444/xv28161,5,0,0,5
"Ronald Jensen photograph collection.",uus_p0572.xml,80444/xv65039,1,2,2,5
"Walter H. Gardner photograph collection",uus_p0370.xml,80444/xv53100,2,1,2,5
"Rhett James collection",uus_mss456.xml,80444/xv40319,3,1,1,5
"<emph render="italic">A Literary History of the American West</emph> Drafts",uus_mss147.xml,80444/xv49090,3,0,2,5
"<emph render="italic">Kingdom Come</emph> Drafts",uus_mss020.xml,80444/xv19381,0,5,0,5
"John N. Downing family business records",uus_mss264.xml,80444/xv51113,0,5,0,5
"John H. Roskelley Mission Diaries",uus_mss359.xml,80444/xv80081,5,0,0,5
"Unknown",uus_p0560.xml,80444/xv28033,3,0,2,5
"College of Agriculture photograph collection.",uus_p0624.xml,80444/xv21826,0,0,5,5
"James H. Crockwell papers",uus_mss250.xml,80444/xv61935,4,1,0,5
"Sid Perkes Theater Set Designs",uus_mss380.xml,80444/xv90145,0,0,5,5
"B.L.F.E. Re-Echo Lodge #195 Records, Montpelier, Idaho",uus_cainemss022.xml,80444/xv49111,5,0,0,5
"The Co-op Service",uus_mss343.xml,80444/xv00363,0,5,0,5
"Papers of James P. Shaver",uus_17_17_17.xml,80444/xv27380,3,0,2,5
"Franklin County, Idaho Post Office Location Records",uus_mss38.xml,80444/xv79919,1,3,1,5
"Camp Downey oral histories",uus_mss468.xml,80444/xv21667,2,2,1,5
"Henry Milton Reeves papers",uus_mss499.xml,80444/xv48889,2,0,2,4
"Logan City Light And Power Plant Papers",uus_mss072.xml,80444/xv18679,3,1,0,4
"Pond Brothers Store papers",uus_mss107.xml,80444/xv11791,1,2,1,4
"Franklin H. Wyatt papers",uus_mss113.xml,80444/xv04672,0,1,3,4
"Robert W. McDill papers",uus_mss121.xml,80444/xv17129,3,0,1,4
"Glen Taggart Speeches",uus_3_1_11_4.xml,80444/xv86663,4,0,0,4
"Ernest C. Jeppsen photograph collection.",uus_p0575.xml,80444/xv77050,0,2,2,4
"The Hortense McEwen Letters",uus_mss296.xml,80444/xv77130,0,1,3,4
"Izatt Service Records",uus_mss389.xml,80444/xv87716,0,3,1,4
"Federal Resettlement Project Oral Histories",uus_mss401.xml,80444/xv72448,1,0,3,4
"Papers of Glen L. Taggart, addendum 1",uus_3_1_11_3.xml,80444/xv61730,0,4,0,4
"Fife Mormon Collection",uus_mss211.xml,80444/xv63653,3,0,1,4
"Tueller Family Papers",uus_mss377.xml,80444/xv60043,0,3,1,4
"Knights of Phythias. Resolute Lodge No. 16 (Mercur, Utah) ledger",uus_cainemss025.xml,80444/xv18304,3,1,0,4
"Cache County politics : notes and papers",uus_mss069.xml,80444/xv29101,0,1,3,4
"Cache Valley Home & Garden Club Records",uus_mss336.xml,80444/xv06576,2,0,2,4
"Amy Madsen Beecher scrapbook",uus_mss417.xml,80444/xv45315,3,1,0,4
"Papers of Glen L. Taggart, addendum 2",uus_3_1_11_5.xml,80444/xv92987,4,0,0,4
"Northern Utah Association of Calligraphers papers",uus_mss463.xml,80444/xv15380,0,3,1,4
"Earl Madsen Papers",uus_mss187.xml,80444/xv88558,3,1,0,4
"Business and Professional Women's Club, Logan chapter papers",uus_mss120.xml,80444/xv30813,0,3,1,4
"Utah Resettlement Project Papers",uus_mss146.xml,80444/xv53985,3,0,1,4
"Logan Rotary Club papers",uus_mss234.xml,80444/xv38391,2,1,1,4
"Western travel album photograph collection",uus_p0129.xml,80444/xv50326,1,2,1,4
"Women's Literary Club Papers (Logan, Utah),",uus_mss254.xml,80444/xv44360,2,1,1,4
"Galand Neild Papers",uus_mss280.xml,80444/xv47650,0,3,1,4
"Reorganized Church of Jesus Christ of Latter Day Saints Collection",uus_mss369.xml,80444/xv14956,1,0,3,4
"US Forest Service Photograph Collection.",uus_p0378.xml,80444/xv38040,0,3,1,4
"West Cache Irrigation Company Secretary's Papers,",uus_mss199.xml,80444/xv60845,3,1,0,4
"Francis R. Martin Papers",uus_mss353.xml,80444/xv37200,3,1,0,4
"Western States Folklore Society Papers",uus_mss465.xml,80444/xv36437,4,0,0,4
"American Civil Liberties Union versus the Logan School District collection",uus_mss056.xml,80444/xv33258,4,0,0,4
"John L. Smith Papers",uus_mss473.xml,80444/xv51538,4,0,0,4
"American Society of Range Management, Utah Section : records",uus_mss081.xml,80444/xv96017,2,2,0,4
"The Newton, Utah Historical Documents Collection",uus_mss306.xml,80444/xv64221,4,0,0,4
"Jack and Hildreth Webb papers",uus_mss510.xml,80444/xv33914,1,3,0,4
"Emily H. Richardson papers",uus_mss403.xml,80444/xv26074,0,3,1,4
"James Bradley papers",uus_mss455.xml,80444/xv36358,0,1,3,4
"George Washington Thatcher Papers",uus_mss135.xml,80444/xv70529,1,1,2,4
"Newton Literary Club Records&gt;",uus_mss249.xml,80444/xv83520,1,1,1,3
"Mary Lucetta Shumway Thompson Diaries",uus_mss052.xml,80444/xv31256,1,1,1,3
"Thurlow Smith and Mary LaRene Butler Smith Diaries",uus_mss483.xml,80444/xv62030,3,0,0,3
"Heber L. Olson Papers",uus_mss348.xml,80444/xv77685,0,0,3,3
"J. Cecil Alter Radio Show Transcripts",uus_mss440.xml,80444/xv37789,2,0,1,3
"Virginia Parker Papers",uus_mss396.xml,80444/xv46151,1,2,0,3
"Colorado and Washington Grazing Interview Transcripts",uus_mss016.xml,80444/xv65484,1,2,0,3
"Presidential Papers of Glen L. Taggart",uus_3_1_11_2.xml,80444/xv47567,3,0,0,3
"The Papers of Alison Comish Thorne",uus_mss216.xml,80444/xv46170,0,2,1,3
"Broberg Family photograph collection",uus_p0422.xml,80444/xv46154,1,0,2,3
"Booklore Club scrapbooks",uus_mss423.xml,80444/xv60614,3,0,0,3
"Files of USDA/ARS Crops Research Lab",uus_17_21_45.xml,80444/xv20040,2,0,1,3
"Nelson Wadsworth photograph collection",uus_p0585.xml,80444/xv85424,1,1,1,3
"Parkinson Family letters",uus_mss521.xml,80444/xv05084,0,0,3,3
"Fielding Social Development Club records",uus_cainemss014.xml,80444/xv14685,3,0,0,3
"Topons Canal Company documents",uus_mss108.xml,80444/xv96429,1,1,1,3
"Ray B. West Drafts of <emph render="italic">Kingdom Come</emph>",uus_mss011.xml,80444/xv69253,0,2,1,3
"Mendon, Utah Records",uus_mss257.xml,80444/xv56555,3,0,0,3
"International Programs (Global Engagement), Office Files",uus_22_45b.xml,80444/xv66262,1,1,1,3
"USU International Student Assosiation Collection Addendum.",uus_p0581.xml,80444/xv70278,1,2,0,3
"Jack Croft papers",uus_mss453.xml,80444/xv83477,1,2,0,3
"Erastus G. Farmer papers",uus_mss251.xml,80444/xv28805,1,1,1,3
"R. Gilbert Moore photograph collection.",uus_p0552.xml,80444/xv10253,1,1,1,3
"William I. Palmer Papers",uus_mss331.xml,80444/xv96362,2,0,1,3
"Jack G. Webb photograph collection.",uus_p0586.xml,80444/xv09475,1,2,0,3
"Franklin City, Idaho, minutes",uus_mss474.xml,80444/xv70330,1,0,2,3
"American Association of Familly and Consumer Sciences papers",uus_mss415.xml,80444/xv84747,3,0,0,3
"Logan Society of Friends Records",uus_mss196.xml,80444/xv48641,1,1,1,3
"Signal Service Corps Ledgers",uus_mss341.xml,80444/xv98074,1,2,0,3
"Wayne Estes interviews",uus_mss494.xml,80444/xv53674,0,3,0,3
"A.A.U.W. Junior Program Committee Collection",uus_mss340.xml,80444/xv91140,2,0,1,3
"Patience Thatcher diaries and papers",uus_mss405.xml,80444/xv32418,0,1,2,3
"Barre Toelken Papers",uus_15_2_12_26.xml,80444/xv94607,0,2,1,3
"University of California at Berkeley photograph album",uus_p0035.xml,80444/xv95510,1,1,1,3
"Logan Branch of the National League of American Pen Women Papers",uus_mss352.xml,80444/xv36328,0,2,1,3
"Ralph A. Busco's Research on German and Italian P.O.W.s in Utah and Idaho",uus_mss134.xml,80444/xv28619,0,1,2,3
"Berten Wendell Allred",uus_mss118.xml,80444/xv88146,2,1,0,3
"Brant C. Short Sagebrush Rebellion Papers",uus_mss391.xml,80444/xv20138,3,0,0,3
"Union & Jordan Irrigation Company Papers",uus_mss253.xml,80444/xv06646,3,0,0,3
"Logan Chapter of the Mormon Battalion Association Historical Record",uus_mss364.xml,80444/xv21356,1,2,0,3
"Golden Hour Club records",uus_cainemss015.xml,80444/xv03103,3,0,0,3
"<emph render="italic">Utah's heritage</emph> research",uus_mss228d.xml,80444/xv43801,1,2,0,3
"Reynold Noble papers",uus_mss459.xml,80444/xv97363,2,0,1,3
"High Uintas Preservation Council Records",uus_mss390.xml,80444/xv29177,0,0,3,3
"Bryan Fetzer Carr diaries",uus_mss425.xml,80444/xv35595,1,0,1,2
"Howard L. Cox papers",uus_mss006.xml,80444/xv19439,0,2,0,2
"Fife Family Missionary Diaries",uus_mss355.xml,80444/xv30725,0,2,0,2
"Petra Horn-Marsh oral history collection",uus_mss444.xml,80444/xv48461,0,1,1,2
"Austin Family Documents",uus_mss139.xml,80444/xv26739,0,1,1,2
"Ann Godfrey Hansen literary manuscript",uus_mss420.xml,80444/xv79171,0,2,0,2
"Papers of S. George Ellsworth",uus_14_6_5_1_26.xml,80444/xv19396,1,1,0,2
"Norbert DeByle Watershed Records",uus_mss376.xml,80444/xv86642,0,0,2,2
"Rudy Lukez Wilderness Conservation Papers",uus_mss324.xml,80444/xv85186,0,2,0,2
"Association of Newspaper Classified Advertising Managers (ANCAM) records",uus_mss418.xml,80444/xv78689,2,0,0,2
"Water in the West",uus_bookcoll38.xml,80444/xv84716,2,0,0,2
"Ora Hoskins papers",uus_mss371.xml,80444/xv45330,2,0,0,2
"Utah State Power Plant : papers",uus_mss074.xml,80444/xv29144,2,0,0,2
"<emph render="italic">Uranium fever, or, No talk under 1 million</emph>",uus_mss194.xml,80444/xv20883,2,0,0,2
"College of HASS Deans Files",uus_14_6_1_17.xml,80444/xv97158,0,0,2,2
"James Clarence Ellsworth family papers",uus_mss228a.xml,80444/xv39297,1,1,0,2
"William E. Wood Family papers",uus_mss450.xml,80444/xv29022,0,2,0,2
"Cache Valley Medical Association papers",uus_mss209.xml,80444/xv32012,1,1,0,2
"John A. Widtsoe Papers",uus_3_1_5_2.xml,80444/xv27871,2,0,0,2
"Willard Peterson photograph collection",uus_p0469.xml,80444/xv62277,1,0,1,2
"Andrew L. Heggie Papers",uus_mss383.xml,80444/xv73843,0,1,1,2
"Junior Miller Oral History Interviews",uus_mss397.xml,80444/xv18994,0,0,2,2
"Utah Governor's Committee on Public Welfare and Emergency Relief : papers",uus_mss099.xml,80444/xv06716,2,0,0,2
"Samuel E. Clark Papers",uus_mss366.xml,80444/xv65689,2,0,0,2
"Reece and Bonnie Nielsen Papers",uus_mss384.xml,80444/xv12576,2,0,0,2
"Mutual Improvement Association manuscript newsletters of Hyrum, Utah",uus_mss067.xml,80444/xv55374,2,0,0,2
"Merl LaVoy photograph collection.",uus_p0601.xml,80444/xv56622,0,0,2,2
"Bishop Bruce Collection",uus_14_4_1_17d.xml,80444/xv23660,1,1,0,2
"Utah State Agricultural College. School of Engineering. Office of the Dean files",uus_rg14_4_1_17.xml,80444/xv83767,2,0,0,2
"Alene Petty Papers",uus_mss354.xml,80444/xv92593,0,0,2,2
"William Hampton Marshall papers",uus_mss445.xml,80444/xv92294,0,0,2,2
"Willis Dial Thesis Materials",uus_mss367.xml,80444/xv39877,2,0,0,2
"Ladies Auxiliary of the B.L.F.E. Liberty Lodge #397 Montpelier, Idaho",uus_cainemss024.xml,80444/xv44021,2,0,0,2
"International Programs (Global Engagement), Office Files",uus_22_45a.xml,80444/xv26654,2,0,0,2
"Fife Americana Collection",uus_mss212.xml,80444/xv49829,2,0,0,2
"Robert James Evans Papers",uus_14_1_7_1_26.xml,80444/xv16561,0,0,2,2
"Andy Gibbons scrapbooks",uus_mss419.xml,80444/xv53393,1,0,1,2
"Charles Bullen papers",uus_mss428.xml,80444/xv53048,2,0,0,2
"Kenneth Godfrey Papers",uus_mss399.xml,80444/xv71551,1,0,1,2
"Albert G. Peyton diary",uus_mss525.xml,80444/xv22647,0,1,0,1
"Vernon J. Larsen papers",uus_mss449.xml,80444/xv99276,0,1,0,1
"Garth Jones collection",uus_mss477.xml,80444/xv67883,0,1,0,1
"Cache County American Legion Obituaries",uus_mss192.xml,80444/xv04495,1,0,0,1
"Senator John P. Holmgren papers",uus_mss133.xml,80444/xv07669,1,0,0,1
"Western Sustainable Agricultural Research and Education (SARE)",uus_17_41_58.xml,80444/xv02770,0,1,0,1
"Papers of Don Jensen",uus_14_1_7_3_26.xml,80444/xv52957,0,1,0,1
"Kappa Chapter of Phi Upsilon Omicron papers",uus_25_8_1_9_45.xml,80444/xv99444,0,0,1,1
"Preston School District Time Capsule",uus_mss239.xml,80444/xv66238,0,1,0,1
"Leon C. Gaylord papers",uus_mss150.xml,80444/xv20632,0,1,0,1
"Gary Horlacher surveys",uus_mss462.xml,80444/xv29376,1,0,0,1
"Franklin Davis Thatcher photograph collection",uus_p0554.xml,80444/xv47982,1,0,0,1
"Emma Eccles Jones papers",uus_mss410.xml,80444/xv99426,0,1,0,1
"The Fair Store Records",uus_mss402.xml,80444/xv57971,1,0,0,1
"Stoddard Family Papers",uus_mss137.xml,80444/xv64852,0,0,1,1
"Utah Education Association Addendum",uus_mss63ii.xml,80444/xv52694,1,0,0,1
"Friends of Bear River Collection",uus_mss332.xml,80444/xv65820,0,0,1,1
"Joseph H. Wilde Missionary Diaries",uus_mss358.xml,80444/xv54669,0,1,0,1
"North Logan Telephone and Electric Company records",uus_mss407.xml,80444/xv09094,0,1,0,1
"Gunnar Rasmuson papers",uus_mss508.xml,80444/xv25350,1,0,0,1
"Hyrum Larsen journals",uus_cainemss017.xml,80444/xv22528,1,0,0,1
"Mike Johnson Papers",uus_mss372.xml,80444/xv19821,0,1,0,1
"The Papers of Kermit Hall",uus_3_1_14_2.xml,80444/xv44030,1,0,0,1
"Delmar C. Tingey Papers",uus_18_12_13_17.xml,80444/xv49658,1,0,0,1
"Utah Water Research Laboratory general files",uus_17_9_2.xml,80444/xv19058,0,1,0,1
"West Cache Irrigation Company Papers",uus_mss361.xml,80444/xv75216,1,0,0,1
"Asa Wayne Arrington papers",uus_mss409.xml,80444/xv94149,1,0,0,1
"Conover Wright papers",uus_mss464.xml,80444/xv60473,1,0,0,1
"Alice Lindahl papers",uus_mss414.xml,80444/xv74343,1,0,0,1
"Gaylen Ashcroft Photograph Collection",uus_p0550.xml,80444/xv05661,1,0,0,1
"Sunshine Terrace Foundation Records",uus_mss381.xml,80444/xv23007,1,0,0,1
"Mendon Historical Documents",uus_mss166.xml,80444/xv18576,1,0,0,1
"St. John's Episcopal Church : records",uus_mss077.xml,80444/xv54885,0,1,0,1
"Manti Waterworks Construction Papers",uus_mss144.xml,80444/xv79544,1,0,0,1
"Donald A. Drage papers",uus_mss385.xml,80444/xv91180,0,0,0,0
"USU Student Folklore Genre Collection of Riddles",uus_folkcoll008a_10.xml,80444/xv28958,0,0,0,0
"Chris Cokinos book drafts",uus_mss429.xml,80444/xv94439,0,0,0,0
"Snyder Sisters Travel Album photograph collection.",uus_p0566.xml,80444/xv02191,0,0,0,0
"Larry Elsner sketchbooks",uus_mss511.xml,80444/xv80178,0,0,0,0
"William I. Bunker papers",uus_mss454.xml,80444/xv22979,0,0,0,0
"Utah Wool Growers Association Addendum",uus_mss218.xml,80444/xv69567,0,0,0,0
"Cache County Library Study material",uus_mss386.xml,80444/xv26269,0,0,0,0
"Thirkell Family letters",uus_mss398.xml,80444/xv17617,0,0,0,0
"Royce S. Bringhurst Papers",uus_mss515.xml,80444/xv47241,0,0,0,0
"Edith Nyman Gunnell Valentines",uus_mss438.xml,80444/xv31594,0,0,0,0
"Kowallis Implement Company records",uus_mss436.xml,80444/xv40301,0,0,0,0
"Eldon J. Gardner papers",uus_mss472.xml,80444/xv87509,0,0,0,0
"Woodland family papers",uus_mss490.xml,80444/xv47372,0,0,0,0
"Darrin Smith photograph collection.",uus_p0351_darrinsmith.xml,80444/xv78707,0,0,0,0
"Girard H. Rapp papers",uus_mss430.xml,80444/xv39120,0,0,0,0
"Wade H. Andrews papers",uus_17_16_17.xml,80444/xv64688,0,0,0,0
"Avard T. Fairbanks collection",uus_mss421.xml,80444/xv24505,0,0,0,0
"Allen Ginsberg photograph collection.",uus_p0591.xml,80444/xv21716,0,0,0,0
"Unknown",uus_14_7_18.xml,80444/xv99600,0,0,0,0
"Oral History Association records",uus_mss228g.xml,80444/xv77328,0,0,0,0
"Crops Research Lab Arid Pasture and Range&gt;",uus_17_21_45c.xml,80444/xv12963,0,0,0,0
"Thomas E. Lloyd journal",uus_mss400.xml,80444/xv04766,0,0,0,0
"Samuel Taylor legislative papers",uus_mss412.xml,80444/xv22732,0,0,0,0
"Frederick Kowallis papers",uus_mss451.xml,80444/xv67877,0,0,0,0
"Get-Away-Special (GAS) Program",uus_14_8_6_55.xml,80444/xv93258,0,0,0,0
"Preston Family Photograph Collection",uus_p0247.xml,80444/xv84365,0,0,0,0
"Ernesto Edwards photograph collection",uus_p0588.xml,80444/xv23736,0,0,0,0
"Sarah Patience Paskett autograph books",uus_mss488.xml,80444/xv66110,0,0,0,0
"Ione Bennion Papers",uus_mss320.xml,80444/xv99368,0,0,0,0
"D.E. Burley telegrams",uus_mss522.xml,80444/xv85437,0,0,0,0
"Jed Wasden papers",uus_mss432.xml,80444/xv93295,0,0,0,0
"Gäbler family papers",uus_mss513.xml,80444/xv58404,0,0,0,0
"Wade Andrews photograph collection",uus_p0443.xml,80444/xv36593,0,0,0,0
"William E. Bell papers",uus_mss411.xml,80444/xv49798,0,0,0,0
"Logan Second Ward records",uus_mss447.xml,80444/xv85757,0,0,0,0
"Robert B. Day papers",uus_mss404.xml,80444/xv74395,0,0,0,0
"Noble Nielsen Papers",uus_mss375.xml,80444/xv61026,0,0,0,0
"Vanez T. Wilson Papers",uus_mss363.xml,80444/xv93643,0,0,0,0
"Mountain States Athletic Conference papers",uus_mss433.xml,80444/xv13128,0,0,0,0
"The Mound Fort Ward, Ogden Eighth Ward Papers",uus_mss128.xml,80444/xv97497,0,0,0,0
"Farmers Grain Cooperative Business Papers",uus_mss365.xml,80444/xv12182,0,0,0,0
"Virginia Stacey papers",uus_mss408.xml,80444/xv47689,0,0,0,0
"Carol O'Connor papers",uus_14_6_5_17d.xml,80444/xv14773,0,0,0,0
"R. Gilbert Moore papers",uus_mss514.xml,80444/xv44082,0,0,0,0
,,Totals,8020,9560,7894,25474
