Title,Document Name,Ark Identifier,July,August,September,Total
"Historical Menu Collection",waumenuphcoll617.xml,80444/xv16082,635,668,717,2020
"Unknown",wauaflciowashingtonstatelaborcouncil0450.xml,80444/xv94338,166,123,715,1004
"Unknown",waumeanyedmonds0106.xml,80444/xv24644,179,189,428,796
"Unknown",waupnwscrapbooks5902.xml,80444/xv25836,429,157,192,778
"Adams (Brock) Papers",wauadamsbrock1096.xml,80444/xv30459,134,126,465,725
"Hamilton (Leslie) Collection of Seattle Photographs",wauhamiltoncollectionphcoll541.xml,80444/xv56787,76,88,539,703
"University of Washington President Records",wauuwresource00095.xml,80444/xv67050,71,82,446,599
"Unknown",waubullittdorothystimson5269.xml,80444/xv26691,169,134,284,587
"Ballinger (Richard Achilles) Papers",wauballingerricharda0015.xml,80444/xv17117,101,129,349,579
"Unknown",wauamericancivillibertiesunionofwashington1177.xml,80444/xv75164,95,156,302,553
"Unknown",wauua19_26_1693jacobsmelville.xml,80444/xv95437,131,132,263,526
"Unknown",wauburkethomas1483.xml,80444/xv77651,141,113,261,515
"Unknown",waubensonnaomiachenbach0204.xml,80444/xv64997,61,49,404,514
"Unknown",waujoneswesleylivsey0157.xml,80444/xv39005,142,113,198,453
"Poindexter (Miles) Papers",waupoindextermiles3828.xml,80444/xv57473,111,103,233,447
"Unknown",wauscandinavianamericansphcoll51.xml,80444/xv76957,129,163,148,440
"Cooper and Levy Families Photograph Collection",waucooperlevyphcoll722.xml,80444/xv68420,146,115,149,410
"University of Washington Board of Regents Records",wauuwresource00094.xml,80444/xv16885,47,49,301,397
"Henry Art Gallery Records",wauuwresource00328.xml,80444/xv23272,55,69,264,388
"Architecture Student Drawings from the University of Washington",wauuwarchitecturestudentdrawingsphcoll740.xml,80444/xv17657,104,128,142,374
"19th Century Actors Carte de Visite Collection",wau19thcenturyactorsphcoll75.xml,80444/xv10269,113,108,136,357
"Jackson (Henry M.) Papers",waujacksonhenry3560.xml,80444/xv91324,105,167,75,347
"Unknown",wauua19_26_0614gunthererna.xml,80444/xv16091,96,95,149,340
"Unknown",waumerrillringlumbercompany0726_0965.xml,80444/xv04806,92,64,182,338
"Unknown",waunewenglandfishcompany3996.xml,80444/xv47549,90,120,126,336
"Unknown",waubagleyclarence0036.xml,80444/xv62261,83,110,135,328
"United Food and Commercial Workers, Local 81 Records",wauufcwunionseattle5694.xml,80444/xv41351,103,113,112,328
"Unknown",wauchurchcouncilgreaterseattle1358.xml,80444/xv50291,87,105,132,324
"Unknown",wauseattleurbanleague0607.xml,80444/xv26011,55,51,206,312
"Unknown",waustpaultacomalumbercompany0315_0547.xml,80444/xv60895,92,94,123,309
"Unknown",wauroethketheodore0418_0653_1484_1624_1922_1923.xml,80444/xv82097,48,44,215,307
"Gould Family Papers",waugouldfamily3516.xml,80444/xv58490,57,110,137,304
"Unknown",wauhansenjuliabutler1501.xml,80444/xv93724,51,78,174,303
"University of Washington Department of Intercollegiate Athletics Records",wauuwresource00146.xml,80444/xv44760,43,98,148,289
"Unknown",wauamesedwingardner0446_3820.xml,80444/xv27033,65,69,155,289
"Gairola (C. Krishna) Indian and Asian Art and Architecture Slides",waugairolaslidesphcoll744.xml,80444/xv11547,103,94,87,284
"Unknown",wauholmanfranke0948.xml,80444/xv50292,106,57,120,283
"Donaldson (Lauren R.) Papers",wauua37_06_2932donaldsonlauren.xml,80444/xv64657,64,54,162,280
"King County Labor Council Records",wauaflciokingcolabor1940.xml,80444/xv93032,51,98,126,275
"Unknown",wauinlandboatmensunionpacific1574_1615_1752_1761_2044.xml,80444/xv13021,83,74,117,274
"Hitchman (Robert) Papers",wauhitchmanrobert5538.xml,80444/xv48284,37,52,182,271
"Terry (Roland) Architectural Drawings",wauterryrolandphcoll743.xml,80444/xv89816,94,108,69,271
"Unknown",wauua37_00_1852chapmanwilbertmcleod.xml,80444/xv73548,68,64,139,271
"Evans (Brock) Papers",wauevansbrock1776.xml,80444/xv17799,75,66,127,268
"Unknown",waumagnusonwarrengrant3181.xml,80444/xv31138,52,52,160,264
"Strong (Anna Louise) Papers",waustrongannalouise1309_1444.xml,80444/xv20539,92,80,92,264
"Dearborn (Phyllis) and Massar (Robert) Photographs",waudearbornmassarphcoll251.xml,80444/xv45845,68,86,101,255
"Unknown",wauallenedwardweber0129.xml,80444/xv09932,45,90,117,252
"Amalgamated Transit Union, Local 587 records",wauamalgamatedtransitunionlocal587seattle5680.xml,80444/xv29092,72,86,83,241
"Conway (John Ashby) Papers",wauua19_18_2454conwayjohn.xml,80444/xv74568,48,103,89,240
"Unknown",wauholbrookstewarthall0701_0961_1272.xml,80444/xv40714,61,42,137,240
"Costigan (Giovanni and Amne) Papers",waucostigangiovanniua4338.xml,80444/xv30112,39,76,119,234
"Unknown",waubulosancarlos0581.xml,80444/xv17805,54,69,110,233
"Unknown",wauindustrialconferenceboardtacomawash0467.xml,80444/xv77667,70,61,98,229
"Adams (Brock) Photograph Collection",wauadamsbrockphcoll622.xml,80444/xv75937,41,83,105,229
"Unknown",wauscandinavianarchivesuwlibraries0356.xml,80444/xv76736,33,33,161,227
"Seattle Municipal Street Railway Photograph Collection",wauseattlemunicipalrailwayphcoll266.xml,80444/xv91323,64,59,103,226
"Cotterill (George F.) Papers",waucotterillgeorgef38-1_38-2.xml,80444/xv54385,38,89,96,223
"Unknown",waumillerfamily3912.xml,80444/xv98512,61,56,105,222
"Bloedel (Prentice) Photograph Collection",waubloedelprenticephcoll531.xml,80444/xv60110,76,69,77,222
"Unknown",wauua01_01_0048suzzallohenry.xml,80444/xv34900,47,39,136,222
"Babb (Albert L.) Papers",waubabbalbertua2510.xml,80444/xv51531,28,59,133,220
"Bodemer (Charles W.) Papers",wauua27_45_3379bodemercharles.xml,80444/xv30448,34,74,108,216
"Bullitt (Katharine) Papers",waubullittkatharine5101.xml,80444/xv12321,31,72,112,215
"Unknown",waupaulwilliamlewis1885.xml,80444/xv32848,29,92,92,213
"Unknown",waualiesanjody2272.xml,80444/xv69784,16,61,131,208
"Yukon Gold Dredging Photographs",wauyukongolddredgingphcoll662.xml,80444/xv31820,58,101,48,207
"Portraits Collection",wauportraitsphcoll563.xml,80444/xv74191,33,110,62,205
"Forsyth Family Papers",wauforsythjamesw5541.xml,80444/xv24118,38,79,88,205
"Sayre (J. Willis) Collection of Theatrical Photographs",wausayrejwillisphcoll200.xml,80444/xv08822,97,98,10,205
"Smith (Palmer) Papers",wausmithpalmer4512.xml,80444/xv66024,31,75,97,203
"Graphic Communications International Union, Local 767M records",waugraphiccommunicationsinternationalunionlocal767m5644.xml,80444/xv09039,37,65,99,201
"Unknown",waumagdenronald5185.xml,80444/xv25738,39,79,82,200
"Swan (James Gilchrist) Papers",wauswanjames1703.xml,80444/xv77646,47,67,81,195
"Unknown",wautypographicalunioninternationallocal99northwest3178.xml,80444/xv63897,36,43,116,195
"American Lung Association of Washington Photograph and Architectural Drawing Collection",wauamericanlungassociationwaphcoll670.xml,80444/xv90902,58,61,75,194
"Unknown",wauclarkdonaldhathaway0735.xml,80444/xv96803,38,47,109,194
"Bufvers (John) Papers",waubufversjohn1981_1989.xml,80444/xv15744,25,70,99,194
"Unknown",waushipscalersdrydockandboatyardworkersunion4571.xml,80444/xv73187,70,66,56,192
"Denny (Brewster)",waudennybrewstercua3313.xml,80444/xv62658,101,15,72,188
"Unknown",waumarplefamily5174.xml,80444/xv93722,21,67,97,185
"Ansell (Julian) Papers",wauua27_08_3380anselljulian.xml,80444/xv71151,25,70,88,183
"Unknown",waucarmackgeorge5176.xml,80444/xv05480,29,88,66,183
"Unknown",wauseattlefirstbaptistchurch5410.xml,80444/xv23327,39,66,77,182
"Unknown",wauibewlocal46_5739.xml,80444/xv59677,29,59,94,182
"Beals (Walter) Nuremberg Trials Photograph Collection",waubealsnurembergtrialsphcoll1150.xml,80444/xv25759,14,121,45,180
"Varsity Boat Club Photograph Collection",wauvarsityboatclubphcoll621.xml,80444/xv48617,26,87,63,176
"Unknown",waun3c1732.xml,80444/xv68751,29,52,93,174
"Unknown",waualpinelakesprotectionsocietywash1740.xml,80444/xv10273,43,67,63,173
"Birnbaum (Zygmund William) Papers",wauua19_14_5266birnbaumzygmunt.xml,80444/xv09585,30,70,73,173
"Alaska Engineering Commission Photograph Collection",waualaskarailroadcommissionphcoll495.xml,80444/xv84439,76,54,41,171
"Unknown",wauburkeroberte2874_4128.xml,80444/xv96527,25,60,83,168
"Unknown",waualliedartsofseattleinc1482_0737.xml,80444/xv83460,32,59,74,165
"Unknown",wauwashingtonstatefederationoflabor0301.xml,80444/xv95516,62,42,56,160
"Unknown",waucanneryworkersandfarmlaborersunionlocal7seattlewash3927.xml,80444/xv82650,42,50,68,160
"Savage (George Milton) Family Papers",wausavagegeorgemiltonfamily5400.xml,80444/xv67735,28,62,69,159
"Washington State Jewish Archives Photograph Collections",waujewishhistoryphcoll650.xml,80444/xv00311,32,63,62,157
"Bullitt (Stimson) Papers",waubullittstimson5297.xml,80444/xv48956,22,70,65,157
"Bestor (Arthur)",waubestorarthureugeneua2720.xml,80444/xv11779,8,64,85,157
"Kinnear Family Photographs of the",waukinnearfamilyphcoll635.xml,80444/xv95779,46,70,41,157
"Ellis (Clifford B.) Photographs",wauelliscliffordbphcoll530.xml,80444/xv66888,52,68,36,156
"Hessey (Charles and Marion) Films",wauhesseycharlesandmarionfilmsphcoll1050.xml,80444/xv37585,67,59,30,156
"Mountaineers Photograph Album Collection",waumountaineersphcoll341.xml,80444/xv45962,48,54,54,156
"Unknown",waucornishschoolofalliedartsseattlewash2654.xml,80444/xv93389,33,31,87,151
"Domingo (Cindy) Papers",waudomingocindy5651.xml,80444/xv09942,39,41,71,151
"Unknown",waualdwellthomast4082.xml,80444/xv68072,29,65,57,151
"Unknown",wauoffenbachereric3898.xml,80444/xv77014,32,64,54,150
"Unknown",wauafl-cioregion9_5189.xml,80444/xv62756,15,39,94,148
"Unknown",wauamericanchemicalsocietypugetsoundsection1947.xml,80444/xv39865,14,59,73,146
"Amalgamated Transit Union, Local 587 photograph collection",wauamalgamatedtransitunionlocal587_phcoll1095.xml,80444/xv41949,14,61,70,145
"Lomen Bros. Photographs",waulomenbrothersphcoll328.xml,80444/xv94976,65,39,40,144
"Unknown",wauamericaninstituteofarchitectsseattlechapter1334.xml,80444/xv79620,25,69,50,144
"Unknown",wauaultharryeb0213_0562.xml,80444/xv62599,22,56,66,144
"Bagley, Jenner, and Mercer Families Papers",waubagleyjennermercerfamily5532.xml,80444/xv20587,35,26,83,144
"Unknown",wauhirabayashigordonk3159.xml,80444/xv58822,43,35,64,142
"Unknown",wauayeredwinfamily2020.xml,80444/xv84030,8,9,124,141
"Unknown",waubealswalterb0126.xml,80444/xv47470,23,62,56,141
"Unknown",waudabneyfamily4210.xml,80444/xv61231,36,44,61,141
"Stevens (Isaac I.) Papers",waustevensisaaci111.xml,80444/xv04454,34,46,60,140
"Padelford (Frederick)",waupadelfordfrederickmorganua0400_2098.xml,80444/xv94543,11,62,67,140
"Unknown",wauandersonwanamakerfamily4524.xml,80444/xv87921,33,69,38,140
"Unknown",waurobinsonearl4240.xml,80444/xv46911,39,24,77,140
"Unknown",wauhaigemilyh1898.xml,80444/xv87225,65,36,39,140
"Unknown",waugriffithsaustine3119.xml,80444/xv58496,37,35,67,139
"Unknown",wauua37_00_1595cobbjohnn.xml,80444/xv19167,20,49,69,138
"Association for Women in Communications records",wauassociationforwomenincommunications4521.xml,80444/xv44717,18,71,48,137
"Payne (Blanche)",waupayneblanchephcoll380.xml,80444/xv54055,75,43,19,137
"Unknown",waujamesfamily3575.xml,80444/xv53366,13,50,73,136
"Unknown",wausquirewatson4004.xml,80444/xv51995,33,33,68,134
"Helmi Juvonen Papers",waujuvonenhelmi2731.xml,80444/xv25660,33,36,64,133
"Hauberg (John H.) Papers",wauhaubergjohn2850_7.xml,80444/xv26342,23,44,66,133
"Unknown",wauadattoalbert1640.xml,80444/xv11001,29,42,62,133
"Unknown",waupattersonhiram3147.xml,80444/xv29544,20,64,48,132
"Banks (Virginia) Papers",waubanksvirginia2602.xml,80444/xv85170,15,44,71,130
"Guillen (Rosalinda)",wauguillen_moore5799.xml,80444/xv78210,29,57,44,130
"French (David H. and Kathrine S.) Papers",waufrenchdavidhkathrines5496.xml,80444/xv30429,44,17,69,130
"Leschi Ferry Photograph Album",wauleschiferryphcoll606.xml,80444/xv31130,23,24,80,127
"Unknown",waubassettsamuelb1792.xml,80444/xv63375,40,40,47,127
"Ground Zero Center for Nonviolent Action Records",waugroundzero5336.xml,80444/xv83804,33,31,62,126
"Industrial Workers of the World Photograph Collection",wauiwwphcoll922.xml,80444/xv46710,27,55,44,126
"Unknown",wauhallergranvilleo3437.xml,80444/xv66583,14,65,46,125
"Unknown",wauua19_16_0929martincharlese.xml,80444/xv68762,18,17,90,125
"Meeker (Ezra) Photographs of",waumeekerezraphcoll596.xml,80444/xv50624,35,43,47,125
"Burnett (Charles "Tiny") Photograph Collection",wauburnettcharlestinyphcoll569.xml,80444/xv79656,35,31,59,125
"United States War Relocation Authority Central Utah Project Records",wauuswarrelocationauthorityutah56.xml,80444/xv35234,45,37,40,122
"Bowen (Betty) Papers",waubowenbetty2441.xml,80444/xv62252,35,21,66,122
"Jue (Willard G.) Papers",waujuewillard5191_1.xml,80444/xv71144,48,30,44,122
"Sand Point Naval Air Station Photograph Collection",wausandpointphcoll765.xml,80444/xv37866,36,45,41,122
"American Lung Association of Washington records",wauamerlungassocofwa5271.xml,80444/xv13015,25,22,75,122
"Cobb (John N.) Photographs",waucobbjohnnphcoll418.xml,80444/xv21023,54,29,38,121
"Unknown",waulucecharlesf0781.xml,80444/xv84719,11,58,52,121
"Unknown",waustevensjames2008.xml,80444/xv59183,40,40,40,120
"Unknown",waucongressofracialequalityseattlechapter1563.xml,80444/xv53708,37,18,65,120
"Kinscella (Hazel Gertrude) Papers",waukinscellahazelua5406.xml,80444/xv02966,12,58,50,120
"Unknown",waugearhartlucy0558.xml,80444/xv28400,15,58,47,120
"Unknown",wauchambersandrewjacksonfamily0939.xml,80444/xv42010,19,47,53,119
"Edmondson (W.T.) Papers",wauedmondsonwtua2024.xml,80444/xv11047,10,9,100,119
"Unknown",wauproschthomaswickham0042.xml,80444/xv14669,10,53,55,118
"Young Women's Christian Association (University of Washington) Records",wauywca1930.xml,80444/xv26006,47,23,48,118
"Drinnon (Richard) papers",waudrinnonrichard5779.xml,80444/xv49356,28,19,71,118
"Unknown",waumitchellhughb0281.xml,80444/xv06173,34,30,54,118
"Tolmie (William Fraser) Papers",wautolmiewilliam4577_1.xml,80444/xv77643,40,35,42,117
"Unknown",wauvanolindaoliverphcoll376.xml,80444/xv52338,59,33,24,116
"Unknown",wauandersoncharlesmack0676.xml,80444/xv24487,19,62,34,115
"Unknown",wauua19_34_2593ullmanedwardlouis.xml,80444/xv01385,28,33,54,115
"Willis (Elizabeth Bayley) Papers",wauwilliselizabethbayley2583.xml,80444/xv99530,38,35,41,114
"Unknown",waumeadfamily1222.xml,80444/xv07464,17,67,29,113
"University of Washington, Office of Sponsored Programs records",wauuwresource00182.xml,80444/xv33740,31,32,49,112
"Unknown",waueverettprisonersdefensecommittee0796.xml,80444/xv23434,29,41,41,111
"Unknown",wauua31_00_4119briarscott.xml,80444/xv88247,31,22,58,111
"Blair (Stephen R.) Papers",waublairstephenr5172.xml,80444/xv58838,37,25,49,111
"Unknown",waubeckerdorothy2512.xml,80444/xv16293,30,22,57,109
"Unknown",waugreengardbernicedegginger2403.xml,80444/xv05657,14,55,40,109
"Gates (Charles M.) Papers",wauua19_19_0364gatescharles.xml,80444/xv05481,32,18,59,109
"American Educational Research Association",wauamericaneducationalresearchassociation1084.xml,80444/xv48831,15,33,60,108
"Carbonado, Washington Photograph Collection",waucarbonadophcoll818.xml,80444/xv06375,38,30,40,108
"Unknown",wauua19_26_2027garfieldviolaedmundson.xml,80444/xv83468,20,38,50,108
"Civil War Portraits Photograph Collection",waucivilwarportraitsphcoll654.xml,80444/xv16768,24,41,42,107
"Farm Home of Rasmus Petersen, Redmond, Oregon, Photograph Album",waupetersenrasmusphcoll652.xml,80444/xv84140,33,38,35,106
"Unknown",wauadlummerledaniel2050.xml,80444/xv04092,27,19,60,106
"Civic Unity Committee Records",waucivicunitycommittee0479_0580_1002_1350.xml,80444/xv28060,37,21,48,106
"Nelson (Ove M.) Papers",waunelsonovem5598.xml,80444/xv67999,6,35,65,106
"Alaska Steamship Company Photograph Collection",waualaskasteamshipcompanyphcoll483.xml,80444/xv17565,29,26,50,105
"Unknown",wauuwarboretumua93_153.xml,80444/xv27370,39,35,30,104
"Beck (Broussais C.) Papers",waubeckbroussais155.xml,80444/xv70119,31,28,45,104
"Boeing Airplane Company Photograph Collection",wauboeingairplanecophcoll594.xml,80444/xv35918,37,35,32,104
"Maloney (Shaun) Papers",waumaloneyshaun5255_1.xml,80444/xv03772,31,38,34,103
"Bodybuilding Photograph Collection",waubodybuildingphcoll454.xml,80444/xv46411,22,43,38,103
"Osseward (John) Papers",wauossewardjohn3818.xml,80444/xv40708,32,28,43,103
"Unknown",wauamericanfederationteacherslocal200_1909.xml,80444/xv11962,18,22,63,103
"Curtis (Edward S.) Papers",waucurtisedward0847.xml,80444/xv68065,22,30,51,103
"Unknown",waukatzsolomonua2325.xml,80444/xv82586,29,20,53,102
"Brotman (Daryl M.) Political Portraits Photograph Collection",waubrotmandarylmphcoll015.xml,80444/xv73486,30,35,37,102
"Unknown",waubloedelprentice5044.xml,80444/xv09173,25,19,58,102
"Taylor (George Edward) Papers",wauua19_12_1695taylorgeorge.xml,80444/xv59521,40,22,40,102
"Unknown",wauvirginiastatelibrary3155.xml,80444/xv31857,19,62,21,102
"Unknown",waustrongfamily0958.xml,80444/xv06265,14,59,29,102
"Early Photographic Media Collection",wauphotographicmediaphcoll500.xml,80444/xv78646,8,52,41,101
"Unknown",waustiefelfamily2994.xml,80444/xv28091,19,60,22,101
"Unknown",wauecksteinjoanna2460.xml,80444/xv04400,8,48,43,99
"Gardner (Grace Christianson) papers",waugardnergracechristianson5749.xml,80444/xv30767,14,44,40,98
"Unknown",wauvanlydegrafclayton1341.xml,80444/xv46075,28,24,46,98
"Unknown",wauseattlefuneralhomes5522_5529.xml,80444/xv72671,18,32,48,98
"Alaska Steamship Company Photographs of Docks and Harbors",waualaskasteamshipcompanyphcoll646.xml,80444/xv85850,30,31,37,98
"Andrews (Emery E.) Papers",wauandrewsemery1908_1_1908_3.xml,80444/xv99872,22,23,52,97
"Fukuda (Frank) Photograph and Ephemera Collection",waufukudafrankphcoll128.xml,80444/xv31814,36,25,36,97
"Curtis (Asahel) Papers",waucurtisasahel4058-3_4058-4.xml,80444/xv83799,27,33,37,97
"Payne (Blanche) Papers",wauua19_63_1918payneblanche.xml,80444/xv22589,38,27,32,97
"Heilman (Robert Bechtold) Papers",wauua19_13_1000heilmanrobert.xml,80444/xv76958,27,21,49,97
"Unknown",waucarolineklinegallandhomefortheagedseattlewash2288.xml,80444/xv57238,11,52,34,97
"Hegg (Eric A.) Copper River Railway Photograph Album",wauheggcopperriverphcoll375.xml,80444/xv84824,32,38,26,96
"Unknown",wauuwmtsthelens5874.xml,80444/xv71539,19,29,48,96
"Unknown",waupricefamily1425.xml,80444/xv04592,8,67,21,96
"Olson (David) Papers",wauolsondavidjua5672.xml,80444/xv99932,34,32,29,95
"Kangas (Matthew) Papers",waukangasmatthew3058.xml,80444/xv49263,41,26,28,95
"Haley (Frederick T.) Papers",wauhaleyfrederick1988.xml,80444/xv86199,23,13,58,94
"Ancient Order of United Workmen.",wauancientorderofunitedworkmen1434_1441_1460.xml,80444/xv72351,6,26,62,94
"Unknown",wauhoagwendell5078.xml,80444/xv67230,4,46,44,94
"Birnbaum (Zygmund William) Photograph Collection",waubirnbaumzwphcoll679.xml,80444/xv77644,31,25,38,94
"Baltic Community Photograph Project",waubalticcommunityphotoprojectphcoll780.xml,80444/xv25201,32,14,47,93
"Fuller (Eugenia May) Papers",wauua18_00_3348fullereugeniamay.xml,80444/xv07190,42,28,23,93
"Alaska Postcard Collection",waualaskapostcardphcoll800.xml,80444/xv57141,16,55,21,92
"Misch (Peter H.) Papers",wauua19_20_3370mischpeter.xml,80444/xv16613,35,32,25,92
"Princess Angeline Photograph and Postcard Collection",wauangelinephcoll844.xml,80444/xv41122,28,23,41,92
"Unknown",waumanningharvey2097.xml,80444/xv75091,30,35,27,92
"Unknown",wauua19_33_2702bensonhenry.xml,80444/xv04112,32,24,36,92
"Haldane (Bernard) Papers",wauhaldanebernard5428.xml,80444/xv90646,23,16,52,91
"Unknown",wauhoughtoncluckcoughlinandschubat0384.xml,80444/xv37636,38,25,28,91
"Corr (William and Cecilia) papers",waucorrcecilia5501.xml,80444/xv28872,24,13,54,91
"Lutey (William Glen) Photograph Collection",wauluteywilliamglenphcoll496.xml,80444/xv12664,30,31,30,91
"Danz Family Photograph Collection",waudanzfamilyphcoll696.xml,80444/xv66016,27,33,31,91
"Cushman Dam Photograph Collection",waucushmandamphcoll637.xml,80444/xv88928,26,36,28,90
"Unknown",waubareralanl4408.xml,80444/xv60516,29,29,32,90
"Unknown",waumillerdavidhunter4822.xml,80444/xv80313,16,57,17,90
"Alaska Highway Construction Photograph Collection",waualaskahighwayconstructionphcoll651.xml,80444/xv73881,26,30,33,89
"Boetzkes (Ottilie)",wauboetzkesottiliegua2918.xml,80444/xv24050,5,36,48,89
"Corbitt (Marsh Morgan) photograph albums",waucorbittphcoll540.xml,80444/xv46728,31,29,29,89
"Unknown",wauandersonthomasmcarthur1973.xml,80444/xv69815,13,54,22,89
"Buschmann family",waubuschmannfamily5812.xml,80444/xv40142,12,55,22,89
"Unknown",wauwto1999seattleprotest5177.xml,80444/xv08728,19,32,38,89
"Unknown",waumolenaardee4578.xml,80444/xv62176,28,29,32,89
"Unknown",wauunitedbrotherhoodcarpentersjoinersamerica1228.xml,80444/xv66036,30,30,29,89
"Unknown",wauua18_10_3252steinbrueckvictor.xml,80444/xv62947,33,23,32,88
"Sakamoto (James Y.) Papers",wausakamotojames1609.xml,80444/xv03087,24,26,38,88
"Meed (William E.) Photograph Collection",waumeedwilliamphcoll246.xml,80444/xv25659,53,25,10,88
"Unknown",waucentralseattlecommunitycouncilfederationseattlewash1801.xml,80444/xv95435,35,23,30,88
"Gould Family Photograph Collection",waugouldfamilyph2005_049.xml,80444/xv25009,8,52,28,88
"Unknown",waulelliphil5536.xml,80444/xv28463,22,26,40,88
"Unknown",waugoldfarbsamuele2784.xml,80444/xv69441,21,22,44,87
"Bernardi (Susan R.) Photos of Eskimo at Kingegan, Cape Prince of Wales, Alaska",waueskimokingeganphcoll49.xml,80444/xv80036,31,30,26,87
"Unknown",waudelacyhugh3915.xml,80444/xv83805,33,23,31,87
"Unknown",wauua20_01_2857monsenrjoseph.xml,80444/xv19163,20,30,37,87
"Unknown",wauebyedwinharoldua0934.xml,80444/xv07995,16,50,21,87
"Hirabayashi (Gordon) Photograph Collection",wauhirabayashigordonphcoll1314.xml,80444/xv29849,24,18,44,86
"Unknown",wauforcemf4235.xml,80444/xv84832,10,7,69,86
"Unknown",waumckayleahmiller1266.xml,80444/xv12768,21,18,46,85
"Unknown",waumatthewsmarka0097_2757.xml,80444/xv18828,23,20,42,85
"Unknown",wauhechtirenewd2783.xml,80444/xv22967,13,55,16,84
"Semple (Eugene) Papers",wausempleeugene0532.xml,80444/xv28059,35,19,30,84
"Unknown",waupacificcoastcompany2241.xml,80444/xv74139,37,26,21,84
"Unknown",waubackusmansonfranklin0221.xml,80444/xv39590,18,15,51,84
"Kincaid (Trevor) Papers",wauua19_38_1560kincaidtrevor.xml,80444/xv55081,28,21,35,84
"Unknown",wauseattleartmuseum2636.xml,80444/xv43222,25,31,27,83
"Seattle Women Act for Peace Records",wauswap4073_1_4073_2.xml,80444/xv49597,22,24,37,83
"Unknown",wauinternationallongshoremensandwarehousemensunionlocal4307.xml,80444/xv28402,25,33,25,83
"Prior and Norris Photograph and Ephemera Collection",waupriorandnorrisphcoll583.xml,80444/xv50796,25,28,30,83
"Brand Responsibility Project Records",waubrandresponsiblityproject5683.xml,80444/xv62799,29,29,25,83
"2009 Ocean to Ocean Endurance Contest",waubernhardtpeter5663.xml,80444/xv52636,22,24,36,82
"Kinkade (M. Dale) Papers",waukinkademdale5108.xml,80444/xv65277,35,24,23,82
"Ybarra-Frausto (Tomás) Papers",wauua19_25_4339ybarra-fraustotomas.xml,80444/xv66363,29,18,35,82
"University of Washington Libraries Office of the Director Records",wauuwresource09019.xml,80444/xv59262,6,48,28,82
"Paulson (Don) and Skippy LaRue Photograph Collection",waupaulsondonskippylaruephcoll673.xml,80444/xv08840,17,19,45,81
"Unknown",wautriemeve1959.xml,80444/xv87910,28,21,31,80
"Elliott (John) drawing and photograph collection",wauelliottjohnwphcoll1184.xml,80444/xv94070,20,20,40,80
"Unknown",wautobeymark3593.xml,80444/xv34619,15,26,39,80
"Unknown",waujewishfamilyserviceseattlewash2003.xml,80444/xv03097,12,41,27,80
"Unknown",wauthomsonreginaldheber1602.xml,80444/xv96350,27,26,27,80
"American Institute of Architects Photograph Collection",wauamericaninstituteofarchitectsphcoll191.xml,80444/xv03820,24,19,37,80
"Lucas (Henry)",waulucashenry4681.xml,80444/xv95294,10,51,18,79
"Unknown",waukaplanseymourh2197.xml,80444/xv27426,30,17,32,79
"Unknown",waulagenwilliams2292.xml,80444/xv63974,21,11,47,79
"McGilvra (John J.) Papers",waumcgilvrajohn4806.xml,80444/xv74223,14,12,53,79
"Unknown",wausilvershirtlegionofamericawashingtonstatedivision3242.xml,80444/xv38671,34,22,23,79
"Caughlan (John) Papers",waucaughlanjohn0704.xml,80444/xv87319,28,19,32,79
"Hughes (Glenn) Papers",wauhughesglenn4124.xml,80444/xv79440,24,30,25,79
"Unknown",waudingwallewenc0420.xml,80444/xv83309,22,21,36,79
"Hegg (Peter L. ) Equality Colony Photographs",wauheggpeterlequalitycolonyphcoll728.xml,80444/xv25327,25,27,26,78
"Unknown",wauabramsmariafrank2556.xml,80444/xv23651,23,20,35,78
"Asberry (Nettie J.) Papers",wauasberrynettie1081.xml,80444/xv71830,27,24,27,78
"Unknown",waumizrachiwomensorganizationofamericaavivahchapterseattlewash2014.xml,80444/xv55673,26,26,26,78
"Broderick (Henry) Photograph Collection",waubroderickhenryphcoll685.xml,80444/xv44128,28,20,30,78
"Unknown",waupugetsoundpowerlight2068_2250_5689.xml,80444/xv05960,24,20,34,78
"Unknown",wausemplefamily4220.xml,80444/xv61477,16,32,29,77
"Unknown",wauinternationalbrotherhoodofteamsterschauffeurswarehousemenandhelpersofamerica3235.xml,80444/xv30999,31,25,21,77
"Hester (Wilhelm) Photographs",wauhesterwilhelmphcoll318.xml,80444/xv80111,23,30,24,77
"Costume and Textile Photograph Collection",waucostumeandtextilephcoll177.xml,80444/xv63330,6,53,18,77
"Mayhew (Tim) Collection on Gay Rights",waumayhewtim4440.xml,80444/xv79011,19,25,33,77
"Unknown",waudisquebricep0316.xml,80444/xv72520,18,28,31,77
"Nobles (Orre) Photograph Collection",waunoblesorrephcoll586.xml,80444/xv72169,27,34,16,77
"Schroeter (Leonard) Papers",wauschroeterleonard5036.xml,80444/xv20874,22,20,35,77
"Unknown",waupelleywilliamdudley4841.xml,80444/xv31988,20,23,33,76
"Cooper and Levy Families Papers",waucooperlevyfamily2366.xml,80444/xv22245,28,12,36,76
"Sierra Club Cascade Chapter National Forests Committee",wausierraclubcascadechapternationalforestscommittee5956.xml,80444/xv34899,29,22,25,76
"Wu (Xianzi) Papers",wauwuxianzi5979.xml,80444/xv08758,16,22,38,76
"Alaska Steamship Co.",waualaskasteamshipco1566_1585.xml,80444/xv48574,12,30,34,76
"Unknown",waualicebtheatre4199.xml,80444/xv37939,19,14,43,76
"Bayley (Christopher T.) Papers",waubayleychristopher3070.xml,80444/xv77645,22,8,45,75
"Unknown",waurojotrinidad3586.xml,80444/xv15371,25,22,28,75
"Unknown",wauastleyted5077.xml,80444/xv99535,26,12,37,75
"Unknown",wauandeshenry5371.xml,80444/xv81729,24,32,19,75
"Unknown",waukingcountywashcommissioner0062.xml,80444/xv69125,9,8,58,75
"Unknown",waubarryjneilson4186.xml,80444/xv72073,5,54,15,74
"Alaska Marine Resources and Pribilof Islands Photograph Collection",waualaskanmarineresourcesandpribiloffislandsphcoll595.xml,80444/xv68752,26,25,23,74
"Mighty Man Garden Tractor Photograph and Advertisement Collection",waumightymanphcoll641.xml,80444/xv54386,38,24,12,74
"Starr (Frederick) Collection",waustarrfrederickph2005_069.xml,80444/xv55010,22,17,35,74
"Home Colony Photograph Collection",wauhomecolonyphcoll853.xml,80444/xv99569,11,10,53,74
"Arctic Oceanography film collection",wauarcticoceanographyphcoll984.xml,80444/xv27011,22,24,28,74
"Albers Bros. Milling Co. Photograph Collection",waualbersbrosphcoll610.xml,80444/xv62593,29,22,23,74
"Pacific Aerial Surveys Photograph Collection",waupacificaerialsurveysphcoll616.xml,80444/xv26343,29,21,24,74
"Photographers Reference File",wauphotographersreferencefilephcoll1306.xml,80444/xv07971,16,20,38,74
"Unknown",waugibsonmary0526_0953.xml,80444/xv69079,25,29,19,73
"Unknown",waurennargeorge0636_1656.xml,80444/xv72973,25,22,26,73
"LGBT Northwest Serials and Related Ephemera Collection",waulgbtnorthwestserials5792.xml,80444/xv57742,17,24,32,73
"Paulson (Don) Papers",waupaulsondon5354.xml,80444/xv02062,24,23,26,73
"Chandless (Robert Henry) Photograph Collection",wauchandlessroberthenryphcoll214.xml,80444/xv59024,32,21,20,73
"Goff (O.S.) Photographs",waugoffosphcoll1024.xml,80444/xv75265,26,19,28,73
"Unknown",wauluarkmichaelfleenen0309.xml,80444/xv43679,29,16,28,73
"Bystrom (Arne) Architectural Drawings and Photographs",waubystromarnearchitectph2005_045.xml,80444/xv57083,25,25,23,73
"Unknown",wauseattlerepertorytheatre1481.xml,80444/xv13010,14,27,32,73
"Unknown",waustevenshazard4909.xml,80444/xv40161,33,17,22,72
"Dobbs (Beverly B.) Alaska Photograph Album",waudobbsbeverlybalaskaalbumphcoll788.xml,80444/xv59896,32,29,11,72
"Unknown",wauericksonselmai2347.xml,80444/xv93280,9,52,11,72
"Kistler (Elmer Charles) Papers",waukistlerelmer5347.xml,80444/xv61575,13,24,35,72
"Bentley (Nelson) papers",wauua19_13_5475bentleynelson.xml,80444/xv59408,22,13,37,72
"Unknown",waugraymaxinecushing2682.xml,80444/xv38937,28,17,27,72
"Harbaugh (Charles J.) Papers",wauharbaughcharles4590.xml,80444/xv10268,12,17,42,71
"Rainier National Park Mountain-Glacier Wonderland Photograph Album",wauranaparstudiorainieralbumphcoll52.xml,80444/xv09584,18,23,30,71
"Unknown",waushapirobaruch2633.xml,80444/xv01870,21,19,31,71
"Johnson (C. Montgomery) Papers",waujohnsoncmontgomery5146_1.xml,80444/xv72854,23,12,36,71
"DeShaw (William) Papers",waudeshawwilliam383_920.xml,80444/xv87218,39,12,20,71
"Unknown",wauibewlocal77_5569.xml,80444/xv05703,21,22,28,71
"Unknown",waubrownandcaldwell3061.xml,80444/xv51364,28,24,19,71
"Ebey (Winfield Scott) Papers",wauebeywinfield0127.xml,80444/xv24826,15,18,38,71
"Werner (August) Papers",wauua19_15_2923werneraugust.xml,80444/xv07194,22,17,32,71
"Honey (Michael K.) Papers",wauua36_05_5294honeymichael.xml,80444/xv28737,25,18,28,71
"Unknown",waufarmeralberth3641.xml,80444/xv09934,21,23,27,71
"Unknown",wauindustrialworkersworldseattlejointbranches0544.xml,80444/xv42333,28,23,19,70
"Unknown",waubarnettarthurg1598.xml,80444/xv53866,16,12,42,70
"Rogers (A.D.) Photographs",waurogersadphcoll591.xml,80444/xv37628,22,24,24,70
"Unknown",waubooksmercazseattlewash3817.xml,80444/xv98779,22,24,24,70
"Unknown",wauua19_19_0776holtwstull.xml,80444/xv70468,22,14,34,70
"Unknown",wauindustrialworkersworldcaliforniaoffice4762.xml,80444/xv65579,24,28,18,70
"Kinsey (Darius) Photographs",waukinseydariusphcoll126.xml,80444/xv63858,16,23,31,70
"Dobbs (Beverly B.) Photographs",waudobbsbeverlybphcoll323.xml,80444/xv87903,19,32,19,70
"Unknown",wauwashingtonstatefederationwomensclubs3463.xml,80444/xv73159,31,17,22,70
"Nineteenth Century Actors and Entertainers Cabinet Card Collection",waucabinetcardsphcoll059.xml,80444/xv70867,18,22,30,70
"Farber (Arthur S.) Papers",wauua19_24_4394farberarthur4394.xml,80444/xv82439,24,19,26,69
"Sarvant (Henry M.) Photograph Collection",wausarvanthenrymphcoll35.xml,80444/xv86535,18,29,22,69
"Brown and Caldwell Metro Sewage Disposal Photograph Collection",waubrowncaldwellphcoll151.xml,80444/xv63277,21,23,25,69
"Henry (Stan) Papers",wauhenrystan5558.xml,80444/xv26623,18,18,33,69
"Unknown",waubarneswaltero0253.xml,80444/xv99078,25,20,23,68
"Unknown",waucontemporarytheatreseattlewash2118.xml,80444/xv00912,23,19,26,68
"Seattle Center Grounds Photograph Collection",wauseattlecentergroundsphcoll403.xml,80444/xv53702,27,22,19,68
"Unknown",waurobbinsfamily0447.xml,80444/xv31106,20,19,29,68
"Unknown",wauhartsuckannsconner0394.xml,80444/xv26190,19,18,31,68
"Unknown",wauinternationalwoodworkersamerica4000.xml,80444/xv87374,20,28,20,68
"Unknown",wautollefsonthorc0508.xml,80444/xv64654,29,17,22,68
"Huggins (Edward) Papers",wauhugginsedward4760_1.xml,80444/xv75932,22,22,24,68
"Unknown",waumountainrescueassociation5559.xml,80444/xv09283,10,25,33,68
"Unknown",wauandersonguy2444.xml,80444/xv66876,23,20,25,68
"Alaska-Yukon-Pacific Exposition Postcard Collection",wauaypepostcardphcoll777.xml,80444/xv90991,17,25,26,68
"Unknown",wauhirakawakihachi2418.xml,80444/xv52008,29,18,21,68
"Unknown",wauhalpernmorris2756.xml,80444/xv00341,25,22,21,68
"Nath (R) photographs of Indian architecture",waunathrindianarchitecturephcoll1111.xml,80444/xv27282,30,26,12,68
"Gundlach (Ralph H.) Papers",waugundlachralphua0686.xml,80444/xv11935,20,34,14,68
"Unknown",wauamericanjewishcommitteeseattlechapter2788.xml,80444/xv29379,16,18,34,68
"Unknown",waucostiganhoward4262.xml,80444/xv26351,23,22,23,68
"Morse (Samuel Gay) Native American Photographs",waumorsesamuelgayphcoll480.xml,80444/xv76687,24,19,25,68
"Unknown",waugaylesbianissues4511.xml,80444/xv24932,17,20,31,68
"Clarke (Henry Leland) Letters",wauua19_15_5124clarkehenryleland.xml,80444/xv91328,27,16,25,68
"Unknown",waualhadeffcharles3290.xml,80444/xv45593,24,20,24,68
"Carkeek (Vivian M.) Papers",wauua26_01_2944carkeekvivianm.xml,80444/xv32156,27,15,25,67
"Unknown",wauadamsmuriel2840.xml,80444/xv05197,19,21,27,67
"Great Northern Railway Photograph Album",waugreatnorthernrailwayphcoll383.xml,80444/xv17678,32,19,16,67
"Minidoka Relocation Camp Photograph Collection",wauminidokareloccampphcoll384.xml,80444/xv17450,15,16,36,67
"Unknown",wauferryfamily3126.xml,80444/xv45413,6,9,52,67
"University of Washington College of Forest Resources Records",wauuwresource00340.xml,80444/xv71728,21,14,32,67
"Barb Wiley papers",wauwileybarbara5682.xml,80444/xv74890,27,19,21,67
"Bone (Homer Truett) Papers",waubonehomer3456.xml,80444/xv90298,24,17,26,67
"Unknown",wauadamsrobertsimeon4502.xml,80444/xv62237,18,22,27,67
"American Institute of Architects Seattle Chapter Honor Award Winners Photograph Collection",wauamericaninstitutearchitectsseattlechapterphcoll175.xml,80444/xv60549,19,18,30,67
"Unknown",wauannenha2286.xml,80444/xv15756,18,22,27,67
"Unknown",waushafferfamily3408.xml,80444/xv25448,25,18,24,67
"Baar (Edward) Papers",waubaaredwardj5628.xml,80444/xv22714,22,21,23,66
"Berns (John Emmett) Collection of "Packer Jack" Newman Photographs",waubernsjohnphcoll504.xml,80444/xv44127,13,29,24,66
"United Food and Commercial Workers Local 81 photograph collection",wauufcwlocal81phcoll1176.xml,80444/xv03225,26,22,18,66
"Haynes (Frank Jay) Photographs",wauhaynesfrankjphcoll320.xml,80444/xv59527,14,26,26,66
"Unknown",wauaagaardann5318.xml,80444/xv04321,19,20,27,66
"Unknown",wauwheelonmeachamfamilies3954.xml,80444/xv83407,27,20,19,66
"Unknown",waujacobovitzarthura3786.xml,80444/xv88757,21,28,17,66
"Unknown",wausiegalarthur3865.xml,80444/xv93359,25,18,23,66
"Souvenir of the Harriman Alaska Expedition",wauharrimanalaskaphcoll333.xml,80444/xv20530,22,25,19,66
"Unknown",waumillerjl2240.xml,80444/xv75308,29,23,14,66
"Verrall (John W.) Papers",wauua19_15_5280verralljohn.xml,80444/xv41736,26,20,20,66
"Unknown",wausigmaxiuwchapter5425.xml,80444/xv04129,27,17,22,66
"Unknown",wauherzlnertamidconservativecongregationmercerislandwash2102.xml,80444/xv89028,19,10,37,66
"Jacobsen, Pat crate label collection",waujacobsenpatphcoll1100.xml,80444/xv82202,26,24,16,66
"Barker (George H.) Collection of Dam Construction Photographs and Ephemera",waubarkergeorgephcoll102.xml,80444/xv66356,21,21,23,65
"Calvo Family Photograph Collection",waucalvofamilyphcoll694.xml,80444/xv33183,32,16,17,65
"Chen (Stanford) photographs",wauchenstanfordphcoll1174.xml,80444/xv21740,22,21,22,65
"Willis (Elizabeth Bayley) Northeast India Photograph Collection",wauwilliselizabethbayleynortheastindiaphcoll690.xml,80444/xv13265,23,11,31,65
"Unknown",waudeleongordon3268.xml,80444/xv84176,17,19,29,65
"Thompson (John W.) Photographs",wauthompsonjwphcoll002.xml,80444/xv32144,17,25,23,65
"Farquharson (Frederick Burt) Papers",waufarquharsonfrederickburtua3395.xml,80444/xv12792,19,21,25,65
"Huntoon (Bert W.) Photographs",wauhuntoonbertphcoll289.xml,80444/xv88245,15,21,29,65
"Unknown",wauwsauaplumberspipefitters5800.xml,80444/xv17755,35,14,16,65
"Unknown",wauinternationalbrotherhoodofboilermakersironshipbuildersandhelpersofamericalocalseattlewash1409.xml,80444/xv88249,14,28,23,65
"European Engraved Portraits Collection",waueuropeanengravingsphcoll270.xml,80444/xv59201,4,50,11,65
"Unknown",waupacificnorthwestlaborhistoryassociation4552.xml,80444/xv33273,18,25,22,65
"Allen (Edward Weber) Photograph Collection",wauallenedwardweberphcoll023.xml,80444/xv85144,21,20,24,65
"Blair (Stephen) Photograph Collection",waublairstephenph2004_083.xml,80444/xv25177,26,9,30,65
"Hahn (August) Collection of Eric A. Hegg Photographs",wauhahnaugustphcoll557.xml,80444/xv40706,27,18,20,65
"Unknown",wauforwardthrustseattlewash1707.xml,80444/xv52255,22,21,22,65
"University of Washington Press Records",wauuwresource00349.xml,80444/xv09938,17,15,32,64
"Unknown",waukirkpaulhayden3667.xml,80444/xv34591,14,21,29,64
"Unknown",wauepiscopalchurchdioceseofolympiawash1321.xml,80444/xv85467,23,14,27,64
"Unknown",wauchancewilliamw1405.xml,80444/xv51052,19,23,22,64
"Unknown",wausephardicculturalcommittee2800.xml,80444/xv77047,30,17,17,64
"Cotterill Family Photograph Collection",waucotterillfamilyphcoll211.xml,80444/xv13552,19,18,27,64
"Unknown",waufriedheimrobertl0094.xml,80444/xv30935,23,20,21,64
"Unknown",wauhubbellcs4496.xml,80444/xv87515,21,22,21,64
"Harper (Edward)",wauharperedwardbua4178.xml,80444/xv10720,10,34,20,64
"Barley (H.C.) Photographs",waubarleyharrycphcoll296.xml,80444/xv54392,15,32,17,64
"Holbrook (Stewart H.) Mr. Otis Paintings Collection",waumrotisphcoll425.xml,80444/xv86773,27,16,21,64
"Jacobs Research Funds.",waujacobsresearchfunds2695.xml,80444/xv89465,16,24,24,64
"Jacobs (Sue-Ellen) Papers",waujacobssueellenua5313.xml,80444/xv36126,10,6,48,64
"Unknown",wauintlunionminemillsmelterworkers_local25_1608.xml,80444/xv43472,13,16,35,64
"Unknown",waulamarfreda4289.xml,80444/xv35507,27,19,18,64
"Goetzman (H.J.) Klondike Gold Rush Photographs",waugoetzmanhjphcoll305.xml,80444/xv81878,16,22,26,64
"White (Harry) Photograph Collection",wauwhiteharryphcoll461.xml,80444/xv14372,24,25,14,63
"La Roche (Frank) Photographs",waularochefrankphcoll283.xml,80444/xv93585,19,24,20,63
"Unknown",wauua27_24_2925masudaminoru.xml,80444/xv88251,28,18,17,63
"Unknown",wauworkmenscirclearbeterringbranchno304seattlewash1859.xml,80444/xv97540,15,21,27,63
"Seattle Tent & Awning photograph collection",wauseattletentawningphcoll1151.xml,80444/xv23382,17,13,33,63
"Unknown",wausaundersrobert4880.xml,80444/xv82577,21,19,23,63
"Unknown",waubroetjearthurf0836.xml,80444/xv40176,17,22,24,63
"Unknown",waupacificcountypublicutilitydistrictno2wash0456.xml,80444/xv69039,24,19,20,63
"Unknown",wauappelgersion2905.xml,80444/xv26651,27,18,18,63
"Kilgren (Minnie) Photograph Collection",waukilgrenminniephcoll669.xml,80444/xv15802,21,21,21,63
"Alden (Richard)",waualdenrichardstockholmua4174.xml,80444/xv39901,19,17,27,63
"Grieco (Vic) photographs",waugriecovitoaph2011-012.xml,80444/xv81100,24,16,23,63
"Seattle Hardware Company, Photographs of the",wauseattlehardwarecompanyphcoll698.xml,80444/xv49200,16,22,25,63
"Unknown",wauhugorichard3655.xml,80444/xv86200,27,19,17,63
"Unknown",waucallahankenneth2638.xml,80444/xv24063,19,18,25,62
"Lewis and Clark Centennial Exposition Photograph Album",waulewisandclarkexpositionphcoll105.xml,80444/xv41567,26,22,14,62
"Unknown",waualmskaarhuldad2396.xml,80444/xv28836,19,18,25,62
"Engravings Collection",wauengravingsphcoll210.xml,80444/xv64999,21,17,24,62
"Unknown",waupugetsoundagriculturalcompany5033.xml,80444/xv54788,18,17,27,62
"Unknown",wauburkeassociates4474.xml,80444/xv55401,21,19,22,62
"Alyeska Photograph Collection",waualyeskaphcoll244.xml,80444/xv04174,21,21,20,62
"Unknown",wauneylanmickey4518.xml,80444/xv76446,21,19,22,62
"Unknown",wauarnoldgwright2816.xml,80444/xv60699,19,16,27,62
"Cartoon Drawings of Grant and Selma Donaldson",waudonaldsoncartoonsph2009_004.xml,80444/xv89178,22,18,22,62
"Meany (Edmond S.) Photograph Collection",waumeanyedmondsphcoll132.xml,80444/xv08990,22,21,19,62
"Unknown",waufreemanmiller1038_1092.xml,80444/xv08163,22,24,16,62
"Nowell (Frank H.) Alaska-Yukon-Pacific Exposition Photographs",waualaskayukonpacificexpositionphcoll727.xml,80444/xv53894,26,19,17,62
"Burke (Caroline)",wauburkecarolinemcgilvra3869_4697.xml,80444/xv19219,18,12,32,62
"Sato (Eddie) Camp Harmony Sketchbook and Drawings",wausatoeddiephcoll664.xml,80444/xv13690,26,12,24,62
"Johnston (Norman J.) Photograph Collection",waujohnstonnormanphcoll254.xml,80444/xv43280,25,17,20,62
"Hoffman Family Photograph Collection",wauhoffmanfamilyphcoll752.xml,80444/xv91448,23,25,14,62
"Unknown",waustruveallenhughesmcmicken4200.xml,80444/xv56192,11,16,35,62
"Unknown",waufitzroyedm4730.xml,80444/xv91708,17,22,23,62
"Unknown",waulitchmanmarkm0165.xml,80444/xv03338,20,15,27,62
"Burke Associates Photograph Collection",wauburkeassociatesphcoll410.xml,80444/xv33340,18,19,24,61
"Unknown",waudouglasjames4719.xml,80444/xv79452,21,20,20,61
"Unknown",waufoxjay2135.xml,80444/xv65972,23,21,17,61
"Unknown",waubruckerthomashs4072.xml,80444/xv65447,20,18,23,61
"Anderson (Thomas McArthur) Philippines Photograph Collection",wauandersonthomasmcarthurphcoll144.xml,80444/xv56107,22,18,21,61
"Unknown",waunordlundcharles2147.xml,80444/xv42196,23,18,20,61
"Unknown",wauedsonjohnm3657.xml,80444/xv06729,20,17,24,61
"Temple De Hirsch Sinai Records",wautempledehirschsinai2370.xml,80444/xv96794,26,11,24,61
"Base Hospital Photograph Collection",waubasehospitalphcoll387.xml,80444/xv62203,15,26,20,61
"Matsushita (Iwao) Papers",waumatsushitaiwaoua2718.xml,80444/xv58172,20,14,27,61
"Unknown",waubutlerolga4526.xml,80444/xv14761,20,18,23,61
"Ford (J.F.) Photograph Collection",waufordjfphcoll701.xml,80444/xv31893,22,23,16,61
"Postcard Collection",waupostcardphcoll008.xml,80444/xv56304,20,26,15,61
"Unknown",waugoldbergeva3777.xml,80444/xv28018,20,17,24,61
"Unknown",waubroderickhenry2350.xml,80444/xv44885,22,15,24,61
"Unknown",waucarlsonedwarde1614.xml,80444/xv00527,18,16,27,61
"Unknown",waudeleonstella3406.xml,80444/xv08715,19,20,21,60
"Krenmayr (Janice) Family Papers",waukrenmayrjanice5656.xml,80444/xv52761,18,16,26,60
"Unknown",waubenderclarae3801.xml,80444/xv95379,17,16,27,60
"Drumheller (Joseph) Photograph Collection",waudrumhellerjosephphcoll686.xml,80444/xv58161,21,12,27,60
"Unknown",waupellythomasm1310_1900.xml,80444/xv35926,17,21,22,60
"Cannery Workers and Farm Laborers Union, Local 7 photograph collection",waucanneryworkersunionlocal7phcoll1044.xml,80444/xv33776,26,9,25,60
"Unknown",wauhazlehurstcharles2265.xml,80444/xv76486,23,15,22,60
"Unknown",waufittsfrank0964.xml,80444/xv00781,20,23,17,60
"Richardson Highway, Alaska, Photograph Collection",waurichardsonhighwayphcoll693.xml,80444/xv55414,20,17,23,60
"Unknown",waubethsholomrichlandwash3739.xml,80444/xv60559,25,20,15,60
"Curtis (Edward) Photographs of Mr. and Mrs. Edwin G. Ames",wauamesedwingardneriiphcoll507.xml,80444/xv91986,28,20,12,60
"Unknown",waubouckwilliammorley0655.xml,80444/xv46115,22,19,19,60
"Unknown",wauhillnathanield3888.xml,80444/xv86929,19,20,21,60
"Unknown",waubrownfamily0195.xml,80444/xv43368,19,15,26,60
"Conover (C.T.) Photograph Collection",wauconoverctphcoll503.xml,80444/xv10954,19,16,25,60
"University of Washington Department of Philosophy Records",wauuwresource00299.xml,80444/xv51997,20,17,23,60
"Unknown",wauamericanlegiondeptofwashington2261.xml,80444/xv82360,22,20,18,60
"Unknown",waucitizenstoxicscleanupcampaign4066.xml,80444/xv30340,20,19,21,60
"Unknown",waukinneargeorge0103.xml,80444/xv89791,24,20,16,60
"Expositions Photograph Collection",wauexpositionsphcoll390.xml,80444/xv22778,17,19,24,60
"Unknown",wauarmstrongcalvin4691.xml,80444/xv00509,22,17,21,60
"Unknown",wausmithharoldh0240.xml,80444/xv79220,22,17,20,59
"United Workers Union-Independent records",wauunitedworkersunionindependent5690.xml,80444/xv85589,26,20,13,59
"Unknown",wauarborfund4572.xml,80444/xv59207,17,19,23,59
"Unknown",waudrumhellerjoseph1753.xml,80444/xv95220,22,18,19,59
"Unknown",waumcmickenfamilyphcoll498.xml,80444/xv45494,21,24,14,59
"Garfield (Viola) Photograph Collection",waugarfieldviolaphcoll130.xml,80444/xv47503,13,19,27,59
"Indian Architecture Photograph Collection",wauindianarchitecturephcoll674.xml,80444/xv45836,21,17,21,59
"University of Washington, Office of News and Information records",wauuwresource00205.xml,80444/xv77276,18,14,27,59
"Unknown",waucommunistpartyusawashingtonstate4901.xml,80444/xv94784,15,14,30,59
"Unknown",wauemptyspacetheatre4481.xml,80444/xv02981,5,21,33,59
"Unknown",waufrommerudol1999.xml,80444/xv82568,17,16,26,59
"Unknown",waupiersonemily4180.xml,80444/xv26162,20,20,19,59
"Daily (University of Washington) Photograph Collection",waudailyuwph2008_044.xml,80444/xv65600,18,21,20,59
"Anderson (Clarence Louis) Papers",wauandersonclarence0621.xml,80444/xv22584,9,8,42,59
"Heath (A.E.) Alaska Photograph Collection",wauheathaephcoll327.xml,80444/xv28625,20,18,21,59
"Contemporary QuiltArt Association Records",waucontemporaryquiltartassociation5539.xml,80444/xv14514,21,19,19,59
"Unknown",waubrusethnels0228.xml,80444/xv12869,11,17,31,59
"Rosenblum (Jonathan) Papers",waurosenblumjonathand5719.xml,80444/xv11788,30,17,12,59
"Unknown",wauarensbergrose2122.xml,80444/xv49612,17,17,25,59
"Unknown",waustastnyfelix2437.xml,80444/xv12524,21,18,20,59
"Coe (Fannie) Photograph Collection",waucoefanniephcoll1062.xml,80444/xv53311,6,8,45,59
"Unknown",waufisherannereeploeg1818.xml,80444/xv76110,20,18,21,59
"Unknown",waufitefbartow0694.xml,80444/xv28616,26,16,17,59
"Unknown",wauwashingtonstatemedicalassociation4576.xml,80444/xv90948,18,19,22,59
"Baker (Charles H.) Snoqualmie Falls in Harness: Souvenir of the Visit of the Commercial Club of Chicago",waubakercharleshsnoqualmiefallsinharnessphcoll649.xml,80444/xv51308,9,19,31,59
"Unknown",waugholsonrichardd0074.xml,80444/xv67059,16,22,20,58
"Graham (Guy V.) Photograph Collection",waugrahamguyvphcoll1033.xml,80444/xv72525,16,27,15,58
"Unknown",wauasiasamuelb1926.xml,80444/xv13760,16,21,21,58
"Alice M. Siegal Oral History",wausiegalalice5704.xml,80444/xv81570,18,16,24,58
"Correll (Richard) Papers",waucorrellrichard5855.xml,80444/xv58673,27,18,13,58
"Berg (Walter L.) Papers",waubergwalterlua5681.xml,80444/xv31600,18,17,23,58
"Unknown",waumcguffeyreaderssocietyofseattlewash5136.xml,80444/xv09106,22,15,21,58
"Unknown",waucalifornia4704.xml,80444/xv15264,19,19,20,58
"Unknown",wauunitedbrotherhoodofcarpentersandjoinersofamericadistrictcouncilseattlewash1851.xml,80444/xv90502,25,11,22,58
"Unknown",wauseattlepublicschools2153.xml,80444/xv00033,17,20,21,58
"Unknown",wauchadwickstephenj0071.xml,80444/xv18140,16,20,22,58
"Lien (Carsten) Papers",wauliencarsten5527.xml,80444/xv41308,22,23,13,58
"Unknown",waueveretteducationassociation3849.xml,80444/xv00750,24,14,20,58
"Black Heritage Society oral history project",waublackheritagesocietywashingtonstate5686.xml,80444/xv09606,24,17,17,58
"Unknown",wauanchesreyna3889.xml,80444/xv35156,18,17,23,58
"Unknown",wausmithcj4014.xml,80444/xv81420,18,20,20,58
"Unknown",wauflahertybenjaminguy5094.xml,80444/xv61148,17,18,23,58
"Unknown",waunarodickblancheg5025.xml,80444/xv85086,20,15,23,58
"Unknown",waualohalumbercorporation1089.xml,80444/xv72817,17,20,21,58
"Unknown",wauhildrethedwardtheodore0881.xml,80444/xv32949,18,19,21,58
"Brotman (Jeffrey) Oral History",waubrotmanjeffrey5668.xml,80444/xv26928,22,18,18,58
"Unknown",waugarfieldeselucius4735.xml,80444/xv89868,16,18,24,58
"Family Outings in the Pacific Northwest Photograph Collection",waufamilyoutingsph2009_048.xml,80444/xv81201,21,18,19,58
"Unknown",wauangellydia1565.xml,80444/xv02243,20,18,20,58
"Laperouse Invoice for stores consumed on the Amazone, signed by Lapérouse, and portraits of Lapérouse",waulaperousejeanfrancois5586.xml,80444/xv58889,23,19,16,58
"Albee (Wayne) Photographs",waualbeewaynephcoll737.xml,80444/xv14486,22,19,17,58
"Unknown",waunationalcouncilofjewishwomenseattlesection2089.xml,80444/xv38174,16,9,33,58
"Bicycle Trips Photograph Album",waubicycletripsphcoll258.xml,80444/xv52059,24,18,16,58
"Unknown",wauasiatradingcompany1587.xml,80444/xv76177,19,19,19,57
"Aleutian Islands in World War II Aerial Photograph Collection",waualeutianswwiiaerialph2009_023.xml,80444/xv17224,20,18,19,57
"Unknown",waupolackmorris3879.xml,80444/xv68316,25,17,15,57
"Olmsted Brothers Records",wauolmstedbrothers170.xml,80444/xv35917,20,17,20,57
"Unknown",wauasianandpacificwomenscaucus5366.xml,80444/xv88858,22,20,15,57
"Emerson (Richard) Papers",wauua19_24_4786emersonrichard.xml,80444/xv22244,17,13,27,57
"Unknown",waubulosanaurelio2329.xml,80444/xv48920,24,14,19,57
"Alps (Glen E.)",waualpsglenua5152.xml,80444/xv50494,17,14,26,57
"Unknown",wauamericanchemicalsocietynorthwestregionalmeeting3260.xml,80444/xv51211,22,16,19,57
"Eckstein (Joanna) Photograph Collection",wauecksteinjoannaphcoll476.xml,80444/xv19409,19,20,18,57
"Unknown",wausonsofnorway5408.xml,80444/xv20410,17,20,20,57
"Crawford (S.L.) Washington State Photograph Album",waucrawfordslphcoll063.xml,80444/xv01397,15,20,22,57
"Unknown",waubellaldond4573.xml,80444/xv62182,16,17,24,57
"Dechmann (Louis) Qui Si Sana, Lake Crescent, Olympic Mountains, Washington",waudechmannlouisphcoll169.xml,80444/xv96110,27,17,13,57
"Kinne (Albert B.) Photographs",waukinnealbertphcoll314.xml,80444/xv22238,16,20,21,57
"Galloway (Brent Douglas) Papers",waugallowaybrentdouglas5545.xml,80444/xv94824,15,14,28,57
"Barnett (Arthur G.) Photograph Collection",waubarnettarthurph2004_081.xml,80444/xv64447,18,20,19,57
"Adams Family Photograph Collection",wauadamsfamilyph2005_026.xml,80444/xv05978,14,14,29,57
"Unknown",wauhorowitzcharles2876.xml,80444/xv34994,19,20,18,57
"Unknown",waukellerabrahamc4012.xml,80444/xv67874,22,19,16,57
"Unknown",waubarnumwilliammilo0451.xml,80444/xv80642,22,17,18,57
"Unknown",wauwardlouisevandoren1854.xml,80444/xv93212,16,20,21,57
"Unknown",waucooperfelixb1249.xml,80444/xv96881,21,20,16,57
"Unknown",waubagleydaniel4602.xml,80444/xv22587,16,18,23,57
"Jessett (Thomas E.) Papers",waujessettthomas1832.xml,80444/xv36949,30,13,14,57
"Unknown",waustimsonmillcompany0050_2397.xml,80444/xv31036,24,17,16,57
"Unknown",wausidelldavid2996.xml,80444/xv88946,15,15,27,57
"Christian Friends for Racial Equality Records",wauchristianfriendsracialequality4040_3.xml,80444/xv18134,19,20,18,57
"Lowry (Mike) Congressional Papers",waulowrymike3993.xml,80444/xv07878,15,16,26,57
"Levy (Rene H.) Oral History",waulevyreneh5621.xml,80444/xv43273,17,17,23,57
"Unknown",waukaplanann2484.xml,80444/xv12799,22,17,18,57
"Blaine High School Photograph Collection",waublainehighphcoll467.xml,80444/xv86536,23,18,16,57
"Collins (Joyce) Friday Harbor Photographs",waucollinsjoycephcoll714.xml,80444/xv31604,21,20,15,56
"Reno (Joseph,)",waurenojoseph3281.xml,80444/xv01965,16,23,17,56
"Lingafelter (Edward C.) Papers",wauua19_33_5291lingafelteredwardc.xml,80444/xv36944,21,18,17,56
"Unknown",waukruegerjohnrichard2893.xml,80444/xv64553,24,18,14,56
"Holmes (J. Lister) Photograph Collection",wauholmesjlisterphcoll338.xml,80444/xv05715,16,20,20,56
"Unknown",waumcelroyfamily0027.xml,80444/xv15829,21,18,17,56
"Unknown",wauzelikovskyabe3057.xml,80444/xv27056,18,19,19,56
"Wakamatsu Scrapbooks",wauwakamatsuscrapbooks5645.xml,80444/xv10464,20,20,16,56
"Herrick (H. Burt) Photographs",wauherrickhburtph2008_043.xml,80444/xv38201,17,19,20,56
"Unknown",waupadelfordphilips1823.xml,80444/xv61184,18,16,22,56
"Unknown",waumahaffayroberte0769.xml,80444/xv10144,16,23,17,56
"Unknown",waucoonsehenry4709.xml,80444/xv13607,18,20,18,56
"Unknown",waufayrobertc5300.xml,80444/xv35958,19,19,18,56
"Unknown",waubernsteinstevenj5244.xml,80444/xv91781,23,14,19,56
"Unknown",waubeamgeorgewesley2409.xml,80444/xv38644,21,19,16,56
"Unknown",waulokkenharolde5264.xml,80444/xv47329,24,16,16,56
"Becker (Robert and Nancy) AYPE Postcard Collection",waubeckeraypepostcardphcoll78.xml,80444/xv48995,23,11,22,56
"Photographs of Work on Nome Harbor During Break-Up Album",waunomebreakupphcoll607.xml,80444/xv63964,27,14,15,56
"Iron Goat Trail Video Collection",wauirongoattrailphcoll836.xml,80444/xv50625,20,21,15,56
"Unknown",waufrancomarco4549.xml,80444/xv22125,16,16,24,56
"Unknown",waudrumhellerjesse0087.xml,80444/xv69219,21,17,18,56
"Unknown",waublainefamily4611.xml,80444/xv01748,21,15,20,56
"Ahrens (Richard) Photograph Collection",wauahrensrichardphcoll468.xml,80444/xv27142,15,21,20,56
"Stern (Bernice F.) Papers",wausternbernice1936.xml,80444/xv11392,24,16,16,56
"Unknown",wauhillcyrild4256.xml,80444/xv04949,17,21,18,56
"Unknown",wauberchlaura2092.xml,80444/xv30233,12,12,32,56
"Burke (Thomas) Photograph Collection",wauburkethomasphcoll486.xml,80444/xv70684,18,16,22,56
"Attebery (E. Raymond) Papers",wauatteberyeraymond3176.xml,80444/xv24633,22,13,21,56
"Unknown",waudeleonjosephj3903.xml,80444/xv36987,18,16,22,56
"Moisio (Wayne) Photograph Collection",waumoisiowaynephcoll1204.xml,80444/xv01504,27,14,15,56
"Palka (John) Papers",waupalkajohnua5524.xml,80444/xv90847,22,17,17,56
"Stern (Susan) Papers",wausternsusan5441.xml,80444/xv51659,16,24,16,56
"Unknown",waupluckerstevecharles4181.xml,80444/xv79843,23,17,16,56
"Unknown",waumilroyroberthoustonfamily0869.xml,80444/xv54428,18,18,20,56
"Unknown",waubaesbernard0135.xml,80444/xv65478,16,17,23,56
"Unknown",waupottsralphbushnell0932.xml,80444/xv76492,21,18,17,56
"Penington (Ruth) Photograph Collection and Artwork",waupeningtonruthphcoll681.xml,80444/xv48989,26,15,15,56
"Unknown",waucoalitionforopengovernmentwash3262.xml,80444/xv61346,14,21,21,56
"Unknown",wauallencompanyhonoluluhawaii4689.xml,80444/xv86593,19,18,18,55
"Brooks (Zola) Photograph Albums",waubrookszolaphcoll216.xml,80444/xv02264,17,20,18,55
"Unknown",waukreielsheimerfoundation5429.xml,80444/xv84494,26,12,17,55
"Unknown",waucitizenscommitteepreservationpayrolls1955_1983.xml,80444/xv50079,23,15,17,55
"Unknown",waustantonmichaela3978.xml,80444/xv06655,19,14,22,55
"University of Washington Theater History Exhibit Photograph Collection",wauuniversitytheaterhistoryexhibitphcoll234.xml,80444/xv62069,21,17,17,55
"Unknown",wauchavelleedwardh4146.xml,80444/xv40786,22,17,16,55
"Unknown",wauhartmannjennieb1933.xml,80444/xv64868,17,18,20,55
"Unknown",waueaglesonjamesm5268.xml,80444/xv27685,18,18,19,55
"Unknown",wauwoolfejoel2110.xml,80444/xv50607,21,17,17,55
"Unknown",wauapelgertrudel4350.xml,80444/xv80789,18,16,21,55
"Dean (Arthur) University of Washington Photograph Album",waudeanarthurphcoll903.xml,80444/xv04006,18,15,22,55
"Unknown",waudahlquistpaul2680.xml,80444/xv52075,19,20,16,55
"Unknown",waukayefriedahandin4399.xml,80444/xv49313,17,18,20,55
"Barton (James B.) Photographs",waubartonjamesbph2007_038.xml,80444/xv95410,11,17,27,55
"Wolfe (Myer)",wauwolfemyerrua3390.xml,80444/xv66598,11,19,25,55
"Unknown",wauwashingtonstatesportsmenscouncil2580.xml,80444/xv58801,23,12,20,55
"Unknown",waubarrmark3555.xml,80444/xv39370,21,19,15,55
"Michael (Franz H.) Papers",wauua19_10_2940michaelfranzh.xml,80444/xv63972,18,15,22,55
"Unknown",wauwoodrobertl1991.xml,80444/xv89962,16,16,23,55
"Unknown",wauansleyhelengreen2821.xml,80444/xv60449,22,16,17,55
"Corn (M. Lynne) Papers",waucornmlynne3825.xml,80444/xv23949,19,14,22,55
"Unknown",wauautiorudy3441.xml,80444/xv40802,16,19,20,55
"Unknown",waupriceandrew0497.xml,80444/xv53063,17,17,21,55
"Unknown",waumauermanngordon3772.xml,80444/xv28573,16,18,21,55
"Unknown",wauclaytonjosephe1305.xml,80444/xv20486,19,20,16,55
"Unknown",waubeaudryroy3584.xml,80444/xv32525,17,16,22,55
"Latimer (William Guthrie) Diary",waulatimerwilliamguthrie5687.xml,80444/xv34506,18,16,21,55
"Hardy (Martha) Papers",wauhardymartha0146.xml,80444/xv51138,20,22,13,55
"Unknown",wauamericaninstituteofplannerswashingtonchapter3020.xml,80444/xv67153,18,18,19,55
"Unknown",waubourgindg3678.xml,80444/xv24771,16,16,23,55
"Unknown",waubarrettgordons2401.xml,80444/xv13473,20,15,20,55
"Salsman (Joel) Collection on Pacific Northwest Composers",wausalsmanjoel5591.xml,80444/xv44390,19,18,18,55
"Unknown",wauactionconferenceonnationalpriorities3265.xml,80444/xv93020,18,18,19,55
"Peterson Brothers Photographs",waupetersonbrothersphcoll284.xml,80444/xv06723,19,20,16,55
"Unknown",waumatsenival2609.xml,80444/xv72219,24,17,14,55
"Unknown",wauhumphryderek4448.xml,80444/xv14471,17,19,19,55
"Bogardus (Helen) Scrapbook",waubogardushelenphcoll524.xml,80444/xv22055,20,18,17,55
"Unknown",wauclisefamily3964.xml,80444/xv65353,16,16,23,55
"Unknown",waubaronskymendel3905.xml,80444/xv77093,16,18,21,55
"Davis (Aubrey) papers",waudavisaubrey5548.xml,80444/xv98599,17,8,30,55
"Unknown",waupoulsenfamily0255.xml,80444/xv76293,22,14,18,54
"Shaw (Spencer G.) Papers",wauua23_00_5306shawspencer.xml,80444/xv00693,24,16,14,54
"Unknown",waukizerbenjaminh0449.xml,80444/xv15383,21,18,15,54
"Unknown",waumenziesarchibald4816.xml,80444/xv88201,17,18,19,54
"Unknown",waukahanisidore3019.xml,80444/xv48690,17,15,22,54
"Unknown",waucalofmaier2781.xml,80444/xv24102,15,17,22,54
"Unknown",wauevansevanidris4446.xml,80444/xv50784,14,20,20,54
"American Authors Photograph Collection",wauamericanauthorsphcoll242.xml,80444/xv92395,17,17,20,54
"Unknown",wauamericaninstituteofarchitectswashingtoncouncil3868.xml,80444/xv21594,18,17,19,54
"Quinn (Helen, Koleman) Photograph Collection",wauquinnhelenkolemanphcoll910.xml,80444/xv57968,18,17,19,54
"Unknown",waulofgrensvante3995.xml,80444/xv95489,17,16,21,54
"Guide to the American Federation of Teachers, Seattle, Washington Photograph Collection",wauamericanfederationteachersphcoll707.xml,80444/xv65457,20,23,11,54
"Unknown",wauegesdalstevenm3245.xml,80444/xv49880,19,15,20,54
"Unknown",waucharlesrmccormicklumberco4286.xml,80444/xv90136,17,21,16,54
"Unknown",waurosenthalroyg2352.xml,80444/xv49948,23,15,16,54
"Unknown",wauuzielperlabensal2191.xml,80444/xv91168,22,13,19,54
"Dina Ryz Oral History",wauryzdina5706.xml,80444/xv75256,25,16,13,54
"Meuse (Ray) Photographs of Kenneth Callahan Murals",waumeuserayphcoll423.xml,80444/xv62338,18,19,17,54
"Building and Construction Trades Council Records",waubuildingandconstruction2299.xml,80444/xv63963,27,11,16,54
"Unknown",waucapelutoemily3412.xml,80444/xv85754,16,17,21,54
"Unknown",waukempsterarthurl0565.xml,80444/xv97784,19,17,18,54
"Unknown",wauholmesedithanneallen3063.xml,80444/xv61108,17,16,21,54
"Victorian Theater Celebrities Woodburytype Album",wauvictoriancelebritiesphcoll98.xml,80444/xv34439,15,24,15,54
"Keller (Harold) Eastern Washington Onion Farm Photographs",waukellerharoldphcoll796.xml,80444/xv10910,20,17,17,54
"Unknown",wauinternationallongshoremensandwarehousemensunionfishermenandalliedworkersdivisionlocal3seattlewash3466.xml,80444/xv08712,15,25,14,54
"Boschok (Jackie) Papers",wauboschokjackie5688.xml,80444/xv95590,15,12,27,54
"Unknown",waubrainerderastus4624.xml,80444/xv72784,19,16,19,54
"Lindsay Photographs",waulindsayphcoll364.xml,80444/xv83471,18,15,21,54
"Unknown",waufriedmanlouisa2809.xml,80444/xv76861,19,17,18,54
"Unknown",waubornsteinfamily3066.xml,80444/xv28594,19,15,20,54
"Unknown",wauwestbergalfredj2476.xml,80444/xv32238,23,13,18,54
"Unknown",wausmithjeanne1102.xml,80444/xv31668,18,17,19,54
"Unknown",waumayhewlewis2742.xml,80444/xv84222,15,17,22,54
"Alaska, Washington and Canada Trip Photograph Album",waualaskawashingtoncanadaphcoll203.xml,80444/xv48736,21,18,15,54
"Latham (Edward H.) Photographs",waulathamedwardhphcoll409.xml,80444/xv28341,18,20,16,54
"Unknown",waualaskacoalitionnorthwestoffice3706.xml,80444/xv51980,17,18,19,54
"Unknown",waupocockfrancesm4159.xml,80444/xv16940,18,19,17,54
"Ishihara (George) Photograph Collection",wauishiharageorgephcoll129.xml,80444/xv64697,18,15,21,54
"Clark (L. Wilson) Photographs",waulwilsonclarkphcoll.278.xml,80444/xv33525,18,16,20,54
"Association for the Advancement of Baltic Studies Records",wauassociationfortheadvancementofbalticstudies5572.xml,80444/xv91748,16,13,24,53
"Britain (Lillian) Lantern Slide Collection",waubritainphcoll408.xml,80444/xv82760,19,15,19,53
"Unknown",waumaslanbenjamina2617.xml,80444/xv71691,19,15,19,53
"Thomas (Harlan) Architectural Work Photograph Collection",wauthomasharlanphcoll394.xml,80444/xv00924,20,22,11,53
"Unknown",waujenseneverettj4080.xml,80444/xv01736,19,17,17,53
"Unknown",waucomfortarthurb0705.xml,80444/xv41262,16,19,18,53
"Henry Family Photograph Collection",wauhenryfamilyphcoll381.xml,80444/xv93948,20,17,16,53
"Department Store Santa Portraits Photograph Collection",waudepartmentstoresantasphcoll658.xml,80444/xv48232,17,17,19,53
"Unknown",wauoregonimprovementcompany0249.xml,80444/xv02697,20,12,21,53
"Unknown",wauscheffervictorb4537.xml,80444/xv56497,15,17,21,53
"Unknown",waubrantirving1903.xml,80444/xv53738,15,20,18,53
"Unknown",wauduttonorisonmarshall3145.xml,80444/xv48526,17,18,18,53
"Unknown",waufriendsofthemarketseattlewash1985.xml,80444/xv10427,14,16,23,53
"Unknown",waubucknerharrys2200.xml,80444/xv63485,21,16,16,53
"Unknown",wauhallgeorgehacket0611.xml,80444/xv49887,17,17,19,53
"Kirsten (Frederick Kurt) papers",waukirstenfrederickkurtua3378.xml,80444/xv80654,18,11,24,53
"Unknown",wauspearlilliansylten0381.xml,80444/xv62600,12,7,34,53
"Unknown",waulitchmanclaire3872.xml,80444/xv16314,19,15,19,53
"Unknown",waujohnsonleroyv4084.xml,80444/xv47332,16,19,18,53
"Unknown",wausummersthane4473.xml,80444/xv07635,18,20,15,53
"Unknown",waubakerwp3894.xml,80444/xv86856,18,17,18,53
"Prosch (Thomas) Seattle Views Photograph Albums",wauproschseattleviewsphcoll027.xml,80444/xv95394,19,14,20,53
"Pike Place Market Photograph Collection",waumarketphcoll395.xml,80444/xv99661,16,16,21,53
"Jaffe (Leah) Oral History",waujaffeleslielucrisia5657.xml,80444/xv53713,17,19,17,53
"Unknown",waukobelternest2178.xml,80444/xv34252,21,19,13,53
"Unknown",waubatchellerwillistryon2497.xml,80444/xv25833,18,16,19,53
"Unknown",wausilverstonerachel3653.xml,80444/xv64837,17,17,19,53
"Unknown",waumeyerrichardd5000.xml,80444/xv72036,17,17,19,53
"Colpitts (Marjorie Mary (Grant)) Papers",waucolpittsmarjoriemarygrantua5590.xml,80444/xv43579,19,16,18,53
"Unknown",waumcleodevelynslater3099.xml,80444/xv69750,17,19,17,53
"Unknown",waubeckrobertw0981.xml,80444/xv02224,18,15,20,53
"Unknown",waubernhardminnie2055.xml,80444/xv65228,20,15,18,53
"Unknown",waucohentina3604.xml,80444/xv30346,18,17,18,53
"Unknown",waudoylehenry0861.xml,80444/xv78790,18,16,19,53
"Unknown",wauwestandwheelerassociatesseattlewash2777.xml,80444/xv95135,16,24,13,53
"Unknown",waubermanhowardr4365.xml,80444/xv31869,17,15,21,53
"Unknown",waumarshallgeorge2982.xml,80444/xv89038,22,16,15,53
"Federation of Western Outdoor Clubs Photograph Collection",waufederationwesternoutdoorclubsphcoll666.xml,80444/xv79352,20,17,16,53
"Walkinshaw (Jean) papers",wauwalkinshawjean5340.xml,80444/xv60021,22,13,18,53
"Unknown",wauchristofidesconstantine4320.xml,80444/xv25939,18,20,15,53
"Unknown",waubryanjameswesley0222.xml,80444/xv49197,17,17,19,53
"Unknown",wauevansgeowatkin4647.xml,80444/xv17712,17,18,18,53
"Unknown",wauwashingtonterritory4284.xml,80444/xv50633,15,14,24,53
"University of Washington Campus Postcard Collection",wauuniversityofwashingtonpostcardphcoll803.xml,80444/xv56594,17,16,20,53
"Unknown",wauschoenfeldfamily3228.xml,80444/xv75408,16,18,19,53
"Fleming (Richard H.) Papers",wauua37_02_4110flemingrichardh.xml,80444/xv52002,14,7,32,53
"Unknown",waumactavishdugald4812.xml,80444/xv16543,19,18,15,52
"Unknown",waugreenesamuel4741.xml,80444/xv98483,16,14,22,52
"Unknown",waubashfordherbert2182.xml,80444/xv98049,17,14,21,52
"Unknown",waubutcherjeffreylee5181.xml,80444/xv14218,15,18,19,52
"Unknown",wauspaethpatricia4064.xml,80444/xv13601,16,18,18,52
"Congregation Bikur Cholim (Seattle, Wash.).",waucongregationbikurcholim2450.xml,80444/xv69970,8,11,33,52
"Edmundson (Hec) Collection",wauedmundsonhecphcoll158.xml,80444/xv45892,17,18,17,52
"Harry Truman's Mt. St. Helens Lodge Photograph Collection",wauspiritlakelodgephcoll634.xml,80444/xv14373,23,19,10,52
"Brown (Harold E.D.) Photograph Collection",waubrownharoldedphcoll083.xml,80444/xv47497,20,18,14,52
"Unknown",wauberryfredj2168.xml,80444/xv03445,17,19,16,52
"Unknown",waucoalitionforsafeenergywash3096.xml,80444/xv12139,17,17,18,52
"Aradia Women's Clinic Papers",wauaradiaclinic5601.xml,80444/xv00839,18,19,15,52
"Unknown",waumerrilleulalee4424.xml,80444/xv65533,17,17,18,52
"University of Washington Faculty Auxiliary Records",wauua32_00_2951uwfacultyauxiliary.xml,80444/xv63278,17,15,20,52
"Day (Kenneth) Photographs",waudaykennethphcoll550.xml,80444/xv64550,7,11,34,52
"Unknown",waubeckersol2511.xml,80444/xv99316,17,20,15,52
"Unknown",wauoseranmelville4371.xml,80444/xv26138,19,16,17,52
"Unknown",waulandmortgagebankofnorthwesternamerica2748.xml,80444/xv83230,19,18,15,52
"Aliesan (Jody) Photograph Collection",waualiesanjodyph2015_027.xml,80444/xv21237,15,8,29,52
"Jacobs (Frank A.) Photographs",waujacobsfrankaphcoll137.xml,80444/xv64647,7,30,15,52
"Subject Postcards Collection",wausubjectpostcardsphcoll804.xml,80444/xv31835,17,16,19,52
"Pioneer Minced Sea Clams Album",waupioneermincedseaclamsalbumphcoll721.xml,80444/xv95199,18,16,18,52
"Unknown",wauaroninzerline3186.xml,80444/xv94122,20,17,15,52
"Unknown",waucoterie4250.xml,80444/xv03009,20,17,15,52
"Unknown",wauandersonbern4020.xml,80444/xv21618,17,17,18,52
"King (W. Ivan) Northwest Black Heritage Collection",waukingwivan5506.xml,80444/xv95980,14,7,31,52
"Choose an Effective City Council records",wauchecc4326_1.xml,80444/xv80721,15,21,16,52
"Unknown",wauhashitanihenryk1591.xml,80444/xv02941,17,16,19,52
"Unknown",waufederaltheatreprojectseattlewash5287.xml,80444/xv28906,17,15,20,52
"Unknown",waumunrosanfordsterling4531.xml,80444/xv43353,16,16,20,52
"Farquharson (Mary) Papers Relating to the Incarceration of Japanese American during World War II",waufarquharsonmary397_5.xml,80444/xv85510,21,17,14,52
"Unknown",wauhallidaywilliamr5031.xml,80444/xv52206,16,25,11,52
"Unknown",wauweinerelsiedeutsch3192.xml,80444/xv24722,18,16,18,52
"Unknown",wauhorrocksjohnirwin3434.xml,80444/xv16287,15,20,17,52
"Unknown",waufrancewilliamh1021.xml,80444/xv89007,19,17,16,52
"Gates (Charles M.) Fort Simcoe Photographs",waufortsimcoephcoll457.xml,80444/xv76229,21,20,11,52
"Unknown",wauamideiterry5082.xml,80444/xv24078,19,16,17,52
"Unknown",wauinternationalwoodworkersamericaeverettwash3120.xml,80444/xv48974,16,21,15,52
"Crystal Mountain Skiers Records",waucrystalmountainskiers5630.xml,80444/xv95495,19,16,17,52
"Crosby (Richard M.) Photograph Collection",waucrosbyrichardphcoll871.xml,80444/xv99240,17,15,20,52
"Unknown",wauenglehelen5200.xml,80444/xv41320,18,18,16,52
"Werner (August) Photograph Collection",wauwerneraugustphcoll708.xml,80444/xv70483,23,11,18,52
"Unknown",waubrownharolded3522.xml,80444/xv89044,21,13,18,52
"Unknown",wauallenplinyl3295.xml,80444/xv94885,18,15,19,52
"Unknown",wausmithclarencea3893.xml,80444/xv24703,18,17,17,52
"Jewish Federation and Council of Greater Seattle Photograph Collection",waujewishfederationphcoll93.xml,80444/xv08902,18,18,16,52
"Bone (Homer Truett) Photograph Collection",waubonehomerph2004_080.xml,80444/xv96640,17,17,17,51
"Unknown",wauua21_01_0194boltonfrederickelmer.xml,80444/xv55080,23,11,17,51
"Hoggson (Noble F.) Photograph Collection",wauhoggsonnoblephcoll352.xml,80444/xv20584,19,18,14,51
"Unknown",wausvihlaruthdowell2590.xml,80444/xv18389,16,17,18,51
"Unknown",waupritchettharold1475_1749.xml,80444/xv85046,17,15,19,51
"Unknown",wauspaethjohnd3028.xml,80444/xv56399,15,16,20,51
"Unknown",waulehmannthelma2554.xml,80444/xv28164,20,15,16,51
"Unknown",waurhoadesjohn0277.xml,80444/xv80807,24,15,12,51
"Unknown",waubansmergustav5116.xml,80444/xv10244,14,17,20,51
"Parry (Will) Papers",wauparrywill5316.xml,80444/xv28743,15,15,21,51
"Blatt (Evelyn Eastern) photograph collection",waublattevelynphcoll1158.xml,80444/xv43594,17,16,18,51
"Solberg (S. E.) Papers",wausolbergseua1679.xml,80444/xv77172,16,9,26,51
"Unknown",wauscotttyree5245.xml,80444/xv00358,19,15,17,51
"Unknown",waufriendsoftheearth2548.xml,80444/xv45841,11,11,29,51
"Unknown",waufergusonemorycanda4726.xml,80444/xv75149,18,16,17,51
"Unknown",waumcclellangeorgebrinton4685.xml,80444/xv78350,18,15,18,51
"Unknown",waufusonmorris3538.xml,80444/xv86352,16,18,17,51
"Kenyon (E.W.) Lake Washington Shipyard photograph collection",waulakewashingtonshipyardphcoll1153.xml,80444/xv46029,15,18,18,51
"Unknown",waufoleyrella2698.xml,80444/xv25488,21,15,15,51
"Hancy (Arthur and Freda) Photograph Collection",wauhancyphcoll704.xml,80444/xv63287,29,10,12,51
"Allied Arts of Seattle Photograph Collection",waualliedartsofseattlephcoll389.xml,80444/xv15176,19,17,15,51
"Unknown",waudixonwilliamh0793.xml,80444/xv84362,17,16,18,51
"Unknown",waurothlottieroeder2959.xml,80444/xv90905,15,18,18,51
"Unknown",waumoseleyspencer4175.xml,80444/xv16250,20,17,14,51
"Unknown",waubringloefrances2643.xml,80444/xv93493,16,22,13,51
"Historic American Engineering Record no. WA-24 (Skagit River and Newhalem Creek Hydroelectric Projects) photograph collection",wauskagitnewhalemphcoll627.xml,80444/xv37292,17,21,13,51
"Zalesky (Philip H.) Papers",wauzaleskyphilip3773.xml,80444/xv18827,11,10,30,51
"Amundsen (Roald) Photographs of",wauamundsenroaldphcoll505.xml,80444/xv89425,16,16,19,51
"Unknown",wauzioncheckmariona3169_1308.xml,80444/xv93038,17,17,17,51
"Unknown",wauranckglennn0513.xml,80444/xv82550,18,17,16,51
"Unknown",wauinternationalorderofgoodtemplarsgrandlodgeofwashingtonlodgenoseattlewash3250.xml,80444/xv98297,16,18,17,51
"Unknown",waupollockdavid4849.xml,80444/xv93676,13,21,17,51
"Unknown",waucrystaldiana5390.xml,80444/xv17568,17,21,13,51
"Chambers (Andrew Jackson) Photograph Album",wauchambersandrewjacksonphcoll012.xml,80444/xv86984,17,15,19,51
"Bridge (Bobbe) Oral History",waubridgebobbe5610.xml,80444/xv04098,18,16,17,51
"Unknown",wauamericancetaceansocietypugetsoundchapter4022.xml,80444/xv15341,18,16,17,51
"Ivey (Edwin) Photograph Collection",wauiveyedwinphcoll335.xml,80444/xv98324,19,18,14,51
"Unknown",waumetzonruth5111.xml,80444/xv41464,14,17,20,51
"Unknown",waumyersharrym0100.xml,80444/xv09219,17,17,17,51
"Unknown",wauwashingtonpublicpowersupplysystem1894.xml,80444/xv11837,17,17,17,51
"Eberle (Winfield R.) Papers",waueberlewinfieldrua5585.xml,80444/xv17874,19,16,16,51
"Curtis (Asahel) Seattle Photograph Album",waucurtisandmillerphcoll481.xml,80444/xv55288,14,22,15,51
"Unknown",waucarneyruthjohnson4195.xml,80444/xv18930,24,16,11,51
"Unknown",wauhachnosasorchimofseattle4089.xml,80444/xv70578,16,17,18,51
"Unknown",wausaintpetersepiscopalchurchseattlewash1536.xml,80444/xv21136,18,18,15,51
"Unknown",wauclintongordons0452.xml,80444/xv06283,15,18,17,50
"Unknown",wauhonejosephm0007.xml,80444/xv27435,17,17,16,50
"Unknown",waupeninsularlandcompany4238.xml,80444/xv57397,18,19,13,50
"Unknown",waujacobsonnormanf1136.xml,80444/xv67398,17,22,11,50
"Unknown",waupochetclub3747.xml,80444/xv36901,16,17,17,50
"Unknown",waumarkeldaniel4491.xml,80444/xv28088,17,18,15,50
"Unknown",wauhewitttheodorer3433.xml,80444/xv90780,17,14,19,50
"Rose (H. David) Oral History",waurosehdavid5661.xml,80444/xv63391,17,16,17,50
"Unknown",waunetererjeremiah1487.xml,80444/xv44561,19,18,13,50
"Unknown",wauhoytjohnp2248.xml,80444/xv63916,17,17,16,50
"Unknown",wauweeksharold0821.xml,80444/xv06530,15,16,19,50
"Bagley (Clarence B.) Photograph Collection",waubagleyclarencebphcoll160.xml,80444/xv82104,17,16,17,50
"37th Dogras Northwest Frontier Colonial India Photograph Album",wau37thdograsasiaalbumphcoll346.xml,80444/xv53701,11,13,26,50
"Unknown",wauiversonpeter0218.xml,80444/xv98568,17,17,16,50
"Thomas (Abram J.) Photographs",wauthomasabramjphcoll152.xml,80444/xv59783,17,16,17,50
"Irvin (Karen)",wauirvinhartmanfilmcollectionphcoll1342.xml,80444/xv59710,13,14,23,50
"Unknown",waualbertsonabrahamhorace0516.xml,80444/xv14636,7,11,32,50
"Unknown",wausaveallethiopianjews4532.xml,80444/xv94410,22,13,15,50
"Unknown",wauinternationalorganizationofmastersmatesandpilotslocal6_1874.xml,80444/xv90060,29,7,14,50
"Farquharson (Wallace R.) Photographs",waufarquharsonwallacerphcoll443.xml,80444/xv72290,15,15,20,50
"Unknown",waucoefannie2988.xml,80444/xv02593,19,18,13,50
"Unknown",wauwallacewh1157.xml,80444/xv68170,17,18,15,50
"Unknown",waudillinggeorgew1032.xml,80444/xv91497,15,19,16,50
"Sammis (E.M.) Photographs",wausammisemphcoll24.xml,80444/xv92691,12,13,25,50
"Unknown",wauvanolindaoliver4353.xml,80444/xv86198,21,20,9,50
"Unknown",wauazosejack2795.xml,80444/xv12628,17,18,15,50
"Unknown",wauwillatsenandrew2626.xml,80444/xv51101,12,19,19,50
"Unknown",waumorganhenryvictor0167.xml,80444/xv28286,16,18,16,50
"Cascade Neighborhood Council Records",waucascadeneighborhoodcouncil5679.xml,80444/xv72680,21,17,12,50
"Unknown",waucallbreathgrantandcook4497.xml,80444/xv43939,23,16,11,50
"Unknown",wauhenryga3765.xml,80444/xv60427,15,13,22,50
"Setsuda (Kiichi) Photograph Collection",wausetsudakiishiphcoll642.xml,80444/xv87219,20,15,15,50
"Unknown",waualawiabdallah5051.xml,80444/xv31521,18,18,14,50
"Unknown",waustiefelernestr3410.xml,80444/xv09722,17,13,20,50
"Unknown",waumcleodjamesrichard1386.xml,80444/xv17065,17,17,16,50
"University of Washington Miller Hall Façade Sculptures Photograph Collection",waumillerhallgargoylesphcoll612.xml,80444/xv95427,11,14,25,50
"Unknown",waucasadaylaurenwilde3916.xml,80444/xv19723,17,18,15,50
"Unknown",wausocietyofamericanforesterswashingtonstatesocietysouthpugetsoundchapter3562.xml,80444/xv79476,17,20,13,50
"Unknown",waupolackannie3248.xml,80444/xv53244,16,15,19,50
"Unknown",waumorganruthduprayfamily0899.xml,80444/xv25460,15,18,17,50
"Unknown",wauchurchofthepeopleseattlewash1206.xml,80444/xv29663,19,16,15,50
"University of Washington. Bureau of International Relations.",wauuniversityofwashingtonbureauofinternationalrelations4789.xml,80444/xv43383,26,3,20,49
"Unknown",waulewisraymond0950.xml,80444/xv90325,19,15,15,49
"Unknown",waucleinlillian3144.xml,80444/xv01452,17,15,17,49
"Unknown",wausocialistlaborpartywashseattlesection3180.xml,80444/xv47555,14,19,16,49
"Brooks (Terrence A.) papers",waubrooksterrenceaua5707.xml,80444/xv14584,17,17,15,49
"Unknown",waulearyelizaferry4673.xml,80444/xv49621,21,15,13,49
"Unknown",wauparentsofnorthamericanisraeliswashchap5396.xml,80444/xv01477,15,17,17,49
"Unknown",waubalmerthomas0159.xml,80444/xv07711,16,15,18,49
"Unknown",waubebbcharlesh2998.xml,80444/xv68188,17,18,14,49
"FitzGerald (James) and Tomkins (Margaret) Papers",waufitzgeraldjames2848.xml,80444/xv33810,11,10,28,49
"Unknown",wauyamadekeitarod3877.xml,80444/xv06726,17,17,15,49
"Unknown",waujohansonperryb3914.xml,80444/xv91729,18,19,12,49
"Unknown",waucoalitionagainstdiscrimination5073.xml,80444/xv09970,19,16,14,49
"Unknown",wauschultheiswc4883.xml,80444/xv95574,19,15,15,49
"Carter (Dudley) Totem Pole Carving for Sand Point Naval Air Station Photograph Collection",waucarterdudleytotempolephcoll795.xml,80444/xv74026,20,14,15,49
"Unknown",waujacobsfamily4794.xml,80444/xv89129,13,17,19,49
"Unknown",wauschwarzleah3168.xml,80444/xv41543,16,17,16,49
"Unknown",wauseattlepediatricsociety3918.xml,80444/xv65872,17,15,17,49
"Unknown",waupetersenolgae2607.xml,80444/xv42761,19,18,12,49
"Unknown",waumeltzerleoa3537.xml,80444/xv16336,17,17,15,49
"Unknown",wauua19_24_2381lundberggeorgeandrew.xml,80444/xv92015,19,16,14,49
"Unknown",waumillerjohn2899.xml,80444/xv82733,17,16,16,49
"Unknown",wauwaltersfrankl1465.xml,80444/xv13409,16,17,16,49
"Unknown",waukoikekyo1374.xml,80444/xv10595,22,14,13,49
"Farner (Donald Sankey) Papers",waufarnerdonaldsua3381.xml,80444/xv25723,20,16,13,49
"Unknown",waucitizensplanningcouncilseattlewash4543.xml,80444/xv48443,18,15,16,49
"Unknown",wauangelltony2557.xml,80444/xv32629,18,17,14,49
"Grunbaum Family Photograph Collection",waugrunbaumfamilyphcoll170.xml,80444/xv11474,21,12,16,49
"Unknown",waugrayhenryl2141.xml,80444/xv98043,17,17,15,49
"Ogawa (Elmer) Papers",wauogawaelmer1383.xml,80444/xv03779,20,8,21,49
"Ahlquist (John) and Margaret Levi Research Materials",wauahlquist_levi5798.xml,80444/xv64431,12,20,17,49
"Shaw (William T.) Photographs",waushawwilliamphcoll587.xml,80444/xv17794,16,15,18,49
"Lien (Carsten) Olympic National Park Photograph Collection",wauliencarstenphcoll711.xml,80444/xv18484,16,11,22,49
"Unknown",waujohnsonjasperw4997.xml,80444/xv59115,17,15,17,49
"Unknown",wauhomeofpeacecemeteryassociationtacomawash4570.xml,80444/xv15560,17,15,17,49
"Bridal Veil Lumbering Company, Souvenir of",waubridalveillumbercophcoll398.xml,80444/xv58047,18,14,17,49
"Unknown",waucrosbyandloweolympiawash0600.xml,80444/xv86029,16,15,18,49
"Unknown",waucongregationalchurchwash4707.xml,80444/xv06488,17,16,16,49
"Unknown",wauburkemillworkcompanyseattlewash2342.xml,80444/xv51223,17,15,17,49
"Unknown",wauhenrymjacksonfoundation3881.xml,80444/xv77560,15,18,16,49
"Unknown",waufogartyfamily4467.xml,80444/xv07495,16,17,16,49
"Unknown",waustromsam2108.xml,80444/xv14938,17,16,16,49
"Adams (Edward C.) Photographs",wauadamsedwardcphcoll295.xml,80444/xv50290,20,9,20,49
"Unknown",wauhadassahthewomenszionistorganizationofamericaseattlechapter2565.xml,80444/xv18002,19,9,21,49
"Streatfield (David C.) papers",waustreatfielddavidcua5804.xml,80444/xv55178,25,8,16,49
"Unknown",waukleinbergfamily3062.xml,80444/xv06036,17,17,15,49
"Unknown",wauseattletalmudtorahhebrewschool1892.xml,80444/xv96841,15,13,21,49
"Unknown",waublankenshipgeorgee0369.xml,80444/xv97756,19,18,12,49
"Unknown",waupritchardjoelm3600.xml,80444/xv38482,17,16,16,49
"H. David Kaplan Collection of New York Theater and Opera Programs",waukaplanhdavid5599.xml,80444/xv29580,8,17,23,48
"Unknown",wauhenryfrancis2198.xml,80444/xv32638,17,17,14,48
"Unknown",waubowmangriffithfamily2516.xml,80444/xv38958,17,16,15,48
"Unknown",waurobbinsarnoldb5343.xml,80444/xv78967,15,16,17,48
"Unknown",waumcmickenfamily0040.xml,80444/xv29174,14,7,27,48
"Unknown",waupacificnorthwesttradeassociation2901.xml,80444/xv16787,16,16,16,48
"Jaffe (Bernard and Audrey) Oral History",waujaffebernard5773.xml,80444/xv19747,16,14,18,48
"Unknown",waubenjaminmaxm3442.xml,80444/xv17391,16,16,16,48
"Unknown",wauwashingtonvsjohnmudge2230.xml,80444/xv07702,17,16,15,48
"Unknown",waumichelsonmoe3661.xml,80444/xv80453,15,17,16,48
"Parker (Curtiss) Photograph Collection",wauparkercurtissphcoll1026.xml,80444/xv98379,16,16,16,48
"Unknown",waubloomrobert0961.xml,80444/xv85461,14,17,17,48
"Unknown",wauwinansedgarv1547.xml,80444/xv20156,15,15,18,48
"Unknown",waushaferjulius2830.xml,80444/xv88314,16,15,17,48
"Unknown",waupracnaarthurb0024.xml,80444/xv67364,16,17,15,48
"Oral History Interviews of the South Asian Oral History Project",wausouthasianoralhistoryproject5415.xml,80444/xv36407,16,15,17,48
"Unknown",waugrahamguyv1104.xml,80444/xv84741,15,18,15,48
"Unknown",wauharrystrumanlibrary4926.xml,80444/xv01040,17,15,16,48
"Unknown",wauyeatsroberts5363.xml,80444/xv53167,13,17,18,48
"Unknown",waucopeharryc0429.xml,80444/xv96902,15,18,15,48
"Unknown",wauwashingtonpensionunion0185.xml,80444/xv96084,22,14,12,48
"Unknown",waubabcockjohnpease0860.xml,80444/xv59667,19,13,16,48
"Unknown",wauwallingjohn3091.xml,80444/xv41455,15,18,15,48
"Daschbach (John S.) Papers",waudaschbachjohns3050.xml,80444/xv92006,21,6,21,48
"Unknown",wauloewerrheinhold5421.xml,80444/xv57775,18,15,15,48
"Unknown",wauleatherwoodstephen3536.xml,80444/xv50375,18,15,15,48
"Unknown",waudalyidaflagler2530.xml,80444/xv46472,16,16,16,48
"Unknown",waugoldsboroughhughallen4654.xml,80444/xv04699,22,13,13,48
"Unknown",waupuechlerottilie3736.xml,80444/xv07241,15,14,19,48
"Unknown",wauseattlegardenclubseattlewash0589.xml,80444/xv87704,17,18,13,48
"May (Luke)",waumaylukes1299.xml,80444/xv26400,9,19,20,48
"Unknown",waubeardsleyarthurs3093.xml,80444/xv16641,18,16,14,48
"Unknown",waucollegeinnseattlewash5364.xml,80444/xv38296,23,13,12,48
"Burrows-Warren Photograph Collection",wauburrowswarrenphcoll141.xml,80444/xv97479,18,12,18,48
"Stereocard Collection",waustereocardphcoll058.xml,80444/xv00299,17,17,14,48
"Unknown",waucurtismelville2336.xml,80444/xv81619,15,16,17,48
"Columbia Valley Lumber Company Photograph Album",waudonovanjjphcoll826.xml,80444/xv91510,10,16,22,48
"Unknown",wausidelllorraine4372.xml,80444/xv37557,15,15,18,48
"Kingsbury (Chester H.) Papers",waukingsburychester3259.xml,80444/xv67727,10,13,25,48
"Alaska and Washington Cyanotype Collection",waucyanotypephcoll416.xml,80444/xv82583,21,17,10,48
"Unknown",wausampsonalexander4878.xml,80444/xv63018,16,15,17,48
"University of Washington School of Music Records",wauuwresource00285.xml,80444/xv62399,14,7,27,48
"Unknown",wauweisfieldleo2099.xml,80444/xv29644,19,15,14,48
"Hamley (Frederick G.) Papers",wauhamleyfrederickg405_1.xml,80444/xv16767,16,17,15,48
"Unknown",waumizukigiichiro1121.xml,80444/xv96551,16,15,17,48
"Unknown",waubuttnickmetabloom1849.xml,80444/xv90084,9,6,33,48
"Unknown",wauvanbuskirkphilipc3621.xml,80444/xv62957,16,14,18,48
"Dora Keen Photograph Collection",waukeendoraphcoll453.xml,80444/xv42700,10,12,26,48
"Unknown",waudrachmangaberell4522.xml,80444/xv16799,15,18,15,48
"Unknown",wauamericansocietyoflandscapearchitectspnwchapter4447.xml,80444/xv44480,13,9,26,48
"Unknown",waumcloughlinjohn4810.xml,80444/xv79501,14,19,15,48
"Dunn (S.B.) Photographs",waudunnsbphcoll561.xml,80444/xv89187,16,17,15,48
"Unknown",waumayessharon2629.xml,80444/xv61618,14,18,16,48
"Cowell (Adrian) Film and Research Collection",waucowelladrianphcoll1262.xml,80444/xv28945,14,6,28,48
"Unknown",wauwashingtonstatefederationofteachers2201.xml,80444/xv52874,11,16,20,47
"Unknown",waudonahoeed2073.xml,80444/xv54718,16,15,16,47
"Unknown",waucampbelljohn0013.xml,80444/xv73220,15,15,17,47
"Unknown",wauforcehorton4731.xml,80444/xv08020,15,16,16,47
"Unknown",waupeacelutheranchurchsilvanawash3171.xml,80444/xv18511,15,15,17,47
"Unknown",waucrittendenfamily0256.xml,80444/xv94525,18,16,13,47
"Unknown",wauepsteinfamily2997.xml,80444/xv13027,17,15,15,47
"Unknown",wauisraelleon4393.xml,80444/xv28857,16,14,17,47
"Unknown",wautindallphilip0649.xml,80444/xv84646,15,16,16,47
"Unknown",waumorrisjd2277.xml,80444/xv75299,15,15,17,47
"Unknown",waudonnellynancyd5164.xml,80444/xv15585,11,19,17,47
"Unknown",waucragwelljohn5389.xml,80444/xv11694,16,15,16,47
"Unknown",wauwashingtondemocraticcouncil3502.xml,80444/xv89706,16,14,17,47
"Unknown",wauhughesellwoodclarke3104.xml,80444/xv34930,14,18,15,47
"Unknown",wausondlandharry4047.xml,80444/xv68109,15,17,15,47
"Unknown",waufloodgeorgee0911.xml,80444/xv94226,25,15,7,47
"Unknown",waujewishfederationofgreaterseattle3051.xml,80444/xv91644,16,8,23,47
"Unknown",wausmithalicemaude4155.xml,80444/xv46295,15,16,16,47
"Unknown",waucenterforthestudyofdemocraticinstitutions1137.xml,80444/xv20675,14,17,16,47
"Unknown",waupettierobertg2652.xml,80444/xv96481,15,17,15,47
"Unknown",waulehmannfamily3191.xml,80444/xv64123,15,16,16,47
"Unknown",wauchildrensorthopedichospitalandmedicalcenterseattlewash3530.xml,80444/xv54797,10,9,28,47
"Mountaineers, Summit Registers",waumountaineerssummitregisters2013.xml,80444/xv75036,19,14,14,47
"Kerry (Albert S.) Collection of Photographs and Other Material",waukerryalbertsph2009_010.xml,80444/xv17742,20,9,18,47
"Shaw (Melvin C.) Collection of Theta Chi Fraternity Photographs",waushawmelvincphcoll490.xml,80444/xv34451,23,12,12,47
"Unknown",waublumenthalsophie3036.xml,80444/xv78503,15,14,18,47
"Unknown",waumitchellbertg1210.xml,80444/xv86026,15,15,17,47
"Unknown",wauaxebe4243.xml,80444/xv34268,16,15,16,47
"Pierson & Co. King County School Photographs for the AYPE",waupiersonschoolphcoll747.xml,80444/xv33126,17,13,17,47
"Unknown",waubullertbj5290.xml,80444/xv32015,16,17,14,47
"Unknown",wauseattlesun3508.xml,80444/xv26248,14,20,13,47
"Unknown",wauamericanscandinavianfoundationseattlechapter4444.xml,80444/xv45547,16,16,15,47
"Unknown",waubeatonwilliam2804.xml,80444/xv24212,15,16,16,47
"Unknown",waubeharelazar3209.xml,80444/xv72833,5,13,29,47
"Beals (Walter B.) Photograph Collection",waubealswalterphcoll1250.xml,80444/xv08129,15,16,16,47
"Unknown",wauquaranteclubseattlewash3085.xml,80444/xv73818,18,17,12,47
"Dunn (Jennifer) Papers",waudunnjennifer5386.xml,80444/xv98080,15,15,17,47
"Arboretum-Lakeside Trail Friends Records",wauarboretumlakesidetrailfriends5617.xml,80444/xv35678,17,15,15,47
"Unknown",waudavismelaniezwang3637.xml,80444/xv80987,16,15,16,47
"McBride (Ella) Soroptimist photograph albums",waumcbrideellasoroptimistalbumsphcoll1037.xml,80444/xv41229,17,17,13,47
"Unknown",waumaslanmichael3721.xml,80444/xv58950,15,16,16,47
"Unknown",wauandorgalleryseattlewash3676.xml,80444/xv36514,16,14,17,47
"Convair Photograph Collection",wauconvairphcoll593.xml,80444/xv03088,26,11,10,47
"Grondal (Bror Leonard) Papers",wauua24_00_2358grondalbrorleonard.xml,80444/xv66700,14,11,22,47
"Unknown",wauhornloislogan5285.xml,80444/xv37112,14,17,16,47
"Unknown",wauahavathachimcongregationseattlewash3166.xml,80444/xv55551,15,15,17,47
"Unknown",waumillsblakedavid3585.xml,80444/xv00515,23,13,11,47
"Unknown",waumcleanwalterg0670.xml,80444/xv13568,15,18,14,47
"Unknown",wauamericaninstituteofplannerspacificnorthwestchapter4212.xml,80444/xv46200,15,17,15,47
"Unknown",wauhayesralphc5361.xml,80444/xv48800,18,14,14,46
"Unknown",wauhillreubend4273.xml,80444/xv32794,13,18,15,46
"Unknown",wauamericangoldstarmothersincseattlechapternoseattlewash5135.xml,80444/xv35040,12,14,20,46
"Unknown",waubaronskyedward2349.xml,80444/xv47445,15,15,16,46
"Unknown",waumarkholtottilie4191.xml,80444/xv11242,13,18,15,46
"Scheffer (Victor B.) Photograph Collection",wauscheffervictorbphcoll445.xml,80444/xv15742,11,12,23,46
"Johnston (Norman J.)<emph render="italic"> Cities in the Round </emph>Illustrations Collection",waujohnstonnormcitiesintheroundphcoll539.xml,80444/xv78570,17,15,14,46
"Beals (Walter B.) Album on Roald Amundsen",waubealswalterbphcoll782.xml,80444/xv96200,17,15,14,46
"Burak (Tim) Papers",wauburaktim5673.xml,80444/xv79684,13,8,25,46
"Unknown",waulearyjohn4674.xml,80444/xv73696,14,17,15,46
"Unknown",waufinancialexecutivesinstituteseattlechapter3012.xml,80444/xv98281,13,16,17,46
"Unknown",waunormancharlesa1139.xml,80444/xv51513,14,16,16,46
"Unknown",waujohnesther4523.xml,80444/xv29138,16,13,17,46
"Unknown",waualbertifrank5150.xml,80444/xv49093,19,13,14,46
"Unknown",wauvoorheesdonald4456.xml,80444/xv95774,18,14,14,46
"Unknown",waudrakelaura5209.xml,80444/xv69093,12,18,16,46
"Unknown",wauwrightkatharyn3681.xml,80444/xv81683,24,11,11,46
"Unknown",waupiercecountyswedishamericanjubileecommitteewash5224.xml,80444/xv07232,17,14,15,46
"Stuart (B. Dudley) Architectural Photograph Collection",waustuartphcoll585.xml,80444/xv85166,15,17,14,46
"Unknown",wauunderwoodwilliamh1217.xml,80444/xv32363,16,15,15,46
"Unknown",waualveyalexisa4994.xml,80444/xv84967,4,10,32,46
"Unknown",waufreydmyron2778.xml,80444/xv14419,16,16,14,46
"Unknown",waufrankeljohn2819.xml,80444/xv28878,14,15,17,46
"Unknown",wauvolpepaula1160.xml,80444/xv96408,15,14,17,46
"Unknown",waushiffmurray3992.xml,80444/xv82168,13,16,17,46
"Unknown",wauhunterlila1907.xml,80444/xv05691,15,15,16,46
"Anderson (Pauline) Papers",wauandersonpauline5674.xml,80444/xv45742,14,15,17,46
"Unknown",wauworldaffairscouncilofseattle1110.xml,80444/xv07650,15,14,17,46
"Unknown",waustoreyellsworthp0517.xml,80444/xv28622,15,15,16,46
"Unknown",wauunitedstatesnationalcouncilforartweek0542.xml,80444/xv90951,15,16,15,46
"Northern Pacific Railway Photograph Collection",waunorthernpacificrailwayphcoll357.xml,80444/xv86218,17,15,14,46
"Unknown",waumoshcatelrebeccamorhaime2137.xml,80444/xv20126,18,15,13,46
"Lee (James P.) Photographs",wauleejamespphcoll294.xml,80444/xv12902,19,13,14,46
"Unknown",wauliskirene3573.xml,80444/xv58306,14,17,15,46
"Unknown",waumarplelorna0411.xml,80444/xv11013,15,15,16,46
"Unknown",wauschwarzisidor3734.xml,80444/xv81521,15,13,18,46
"Neubauer (Nathan I.) Photograph Collection",wauneubauernathanphcoll751.xml,80444/xv43270,14,17,15,46
"Unknown",waumercermaryl5153.xml,80444/xv44342,16,14,16,46
"Mueller (James I.) University of Washington College of Mines Photograph Collection",waumuellerjamesiphcoll194.xml,80444/xv69400,13,15,18,46
"Unknown",wauseattleturnvereinseattlewash4889.xml,80444/xv50253,15,16,15,46
"Unknown",waudanzcarolynblumenthal3895.xml,80444/xv13876,17,16,13,46
"Unknown",waualhadeffpearl3271.xml,80444/xv51751,15,14,17,46
"Unknown",waucaliforniafishcompanylosangelescalif0116.xml,80444/xv86404,16,13,17,46
"Unknown",waulaurelhurstcommunityclub3922.xml,80444/xv94030,16,13,17,46
"Unknown",waukatipunandemokratikongpilipino5889.xml,80444/xv03320,11,15,20,46
"Unknown",waurossjd0838.xml,80444/xv35357,10,14,22,46
"Federation of Western Outdoor Clubs Records",waufwoc1886.xml,80444/xv67040,17,8,21,46
"United Faculty of Central Records",wauunitedfacultyofcentral5684.xml,80444/xv89529,16,13,17,46
"Unknown",waumcdermottjames4074.xml,80444/xv64862,15,16,15,46
"Anderson (Herman) photograph collection",wauandersonhermanphcoll1242.xml,80444/xv46337,16,8,22,46
"Woodby (Alice) Photograph Album",wauwoodbyalicephcoll171.xml,80444/xv73123,14,18,13,45
"Unknown",wauheebnerwilliam4753.xml,80444/xv11422,16,17,12,45
"Unknown",wausmithedward4895.xml,80444/xv41616,14,16,15,45
"Unknown",wauseattlecreativeactivitiescenterseattlewash0248.xml,80444/xv61398,15,15,15,45
"Unknown",waucitizenseducationcenterseattlewash3930.xml,80444/xv13235,16,16,13,45
"Unknown",wautunksmargaretc3675.xml,80444/xv88781,17,15,13,45
"Anderson (Bette) Photograph Collection",wauandersonbettephcoll073.xml,80444/xv82861,14,16,15,45
"Unknown",wauseattleportcommission2148_4230.xml,80444/xv12954,12,12,21,45
"Unknown",wausiegalsylviamaecohen4190.xml,80444/xv58508,14,16,15,45
"Oakhurst Sanatorium Photograph Album",wauoakhurstsanatoriumph2010_013.xml,80444/xv39093,9,9,27,45
"Unknown",waumillerwinlockwilliam0231.xml,80444/xv81051,15,17,13,45
"Unknown",waudavisnorman2661.xml,80444/xv93566,17,12,16,45
"Goldberg (Harry) Photograph Collection",waugoldbergharryphcoll1068.xml,80444/xv65811,13,16,16,45
"Unknown",wauamericanlibraryassociationsocialresponsibilitiesroundtableofwashingtonstate3719.xml,80444/xv06149,16,14,15,45
"Unknown",waugraudenzsamuel3545.xml,80444/xv18557,16,17,12,45
"Unknown",wauseattlefederationofwomensclubs5175.xml,80444/xv31821,12,11,22,45
"Hogenauer (Irwin R.) Papers",wauhogenauerirwinr3697_3.xml,80444/xv21555,13,16,16,45
"Unknown",waucalvoroseazose4430.xml,80444/xv46591,14,14,17,45
"Unknown",waucrosbyhenryw4713.xml,80444/xv56869,13,17,15,45
"Unknown",wausamaritansocietyseattlewash2620.xml,80444/xv54098,13,15,17,45
"Darmer (Carl August) Photograph Collection",waudarmercaphcoll197.xml,80444/xv45684,6,14,25,45
"Neill (Thomas) Bridge Construction Photographs and Ephemera Collection",wauneillthomasphcoll11.xml,80444/xv99190,17,18,10,45
"Krafft (Charles) papers",waukrafftcharles5670.xml,80444/xv01773,15,16,14,45
"West Seattle Art Club Records",wauwestseattleartclub5691.xml,80444/xv02130,17,15,13,45
"Unknown",wauthompsonmelissaann3464.xml,80444/xv26998,16,15,14,45
"Unknown",waudusannezoe2430.xml,80444/xv60491,14,6,25,45
"Unknown",waukingcountycentralbloodbankinc3892.xml,80444/xv88726,15,14,16,45
"Unknown",waufisherharry0790.xml,80444/xv26913,15,14,16,45
"Unknown",wauclokemilton2310.xml,80444/xv75521,15,15,15,45
"Unknown",wauseausecouncil4201.xml,80444/xv54116,18,14,13,45
"Unknown",wauamericansocietyoflandscapearchitectswashchapter5317.xml,80444/xv11649,13,10,22,45
"Durham, Anderson, Freed Company Photograph Collection",waudurhamandersonandfreedphcoll069.xml,80444/xv89385,14,16,15,45
"Unknown",wauofficeandprofessionalemployeesinternationalunionlocal8_3185.xml,80444/xv78741,16,14,15,45
"Sturholm (Phil)",wausturholmphilphcoll951.xml,80444/xv92922,0,0,45,45
"Waldbaum (Cheryl) Oral History",wauwaldbaumcheryl5605.xml,80444/xv56912,15,16,14,45
"Unknown",waujohnsonphilipc4386.xml,80444/xv41613,15,14,16,45
"Unknown",waucarlsonalbertm5434.xml,80444/xv10174,16,13,16,45
"University of Washington Department of Military Science Photograph Collection",wauuwdeptmilitarysciencephcoll668.xml,80444/xv64773,19,17,9,45
"Unknown",wauhavinhenry3237.xml,80444/xv77209,15,15,15,45
"University of Washington. Libraries. Special Collections",wauuwresource00752.xml,80444/xv38854,14,15,16,45
"Unknown",wauwashingtonstatetheater4081.xml,80444/xv81045,15,14,16,45
"Unknown",waukirkpatrickjohn3450.xml,80444/xv66610,15,17,12,44
"Unknown",wausingerjacob3769.xml,80444/xv03598,14,14,16,44
"Unknown",wauzemanskygilbertmarek3534.xml,80444/xv44763,16,15,13,44
"Abrams (Sydney)",wauabramssydney5806.xml,80444/xv35476,12,12,20,44
"Unknown",waunullej3122.xml,80444/xv01406,16,17,11,44
"Unknown",waudarmercarlaugust3497.xml,80444/xv16387,14,14,16,44
"Unknown",waubeckerjerome3210.xml,80444/xv30499,12,9,23,44
"Unknown",wauyakimabuddhistchurchyakimawash1521.xml,80444/xv46496,18,15,11,44
"A. Rose & Son records",wauaroseandson5695.xml,80444/xv27487,16,15,13,44
"Unknown",waudennyarthurarmstrong2343.xml,80444/xv13983,12,11,21,44
"Unknown",wauedmondsmeanyhotel5086.xml,80444/xv92556,15,15,14,44
"Bethel (James S.) papers",waubetheljamessua5786.xml,80444/xv40008,20,10,14,44
"Unknown",wauspurrjosiahedward2328.xml,80444/xv97024,15,15,14,44
"Unknown",waubraasgeorgephcoll631.xml,80444/xv90637,14,15,15,44
"Matsushita Family Photograph Collection",waumatsushitafamilyphcoll162.xml,80444/xv60388,24,10,10,44
"Unknown",waucrystalcityassociation4525.xml,80444/xv87661,15,11,18,44
"Merrill (Elbridge W.) Photographs",waumerrillelbridgewarrenphcoll325.xml,80444/xv16516,17,17,10,44
"Kolb (Keith) Photograph and Architectural Drawing Collection",waukolbkeithph2006_004.xml,80444/xv79782,14,18,12,44
"Harborview Medical Center (Seattle, Wash.).",wauuwresource00465.xml,80444/xv31118,11,8,25,44
"Unknown",waujonesfay2644.xml,80444/xv50332,15,14,15,44
"Ballaine (John E.) Photograph Collection",wauballainejohnephcoll1185.xml,80444/xv38766,16,11,17,44
"Domingo (Silme) Papers",waudomingosilme5652.xml,80444/xv81161,24,15,5,44
"Unknown",waufashiongroupseattlewash2546.xml,80444/xv38659,17,14,13,44
"Japanese Theater Photograph Collection",waujapanesetheaterphcoll163.xml,80444/xv58526,15,13,16,44
"Unknown",waurindfamily4237.xml,80444/xv71804,17,15,12,44
"Seattle Women's Ensemble Records",wauseattlewomensensemble5257.xml,80444/xv36602,19,14,11,44
"Unknown",wauwilsonbarbarajeanvanark4182.xml,80444/xv18377,15,15,14,44
"Unknown",wauhoquiammillcompanyhoquiamwash4758.xml,80444/xv08984,16,12,16,44
"Holbrook (Stewart) Photograph Collection",wauholbrookstewartphcoll511.xml,80444/xv12127,16,11,17,44
"Carlyon (Fred) Photographs",waucarlyonfredphcoll299.xml,80444/xv56780,17,18,9,44
"Unknown",wauosbornedwardthomas3514.xml,80444/xv68722,12,15,17,44
"Unknown",waukocherginnazaryv2412.xml,80444/xv82846,13,15,16,44
"Unknown",waumenefeeallan3958.xml,80444/xv19891,22,13,9,44
"Unknown",wauwemlingerjulesr0254.xml,80444/xv76739,16,15,13,44
"Hammerschmidt (Wilhelm) Egypt Photographs",wauhammerschmidtwilhelmegyptphcoll677.xml,80444/xv44810,10,18,16,44
"Unknown",wauseattlerainiers5774.xml,80444/xv46282,13,13,18,44
"Unknown",waupottercarrierollins3909.xml,80444/xv27288,14,14,16,44
"Brenner (Charles) Photograph Collection",waubrennercharlesphcoll1058.xml,80444/xv26708,9,17,18,44
"Unknown",wausteinbrecherfamily3148.xml,80444/xv05093,15,15,14,44
"Unknown",waumitchellwilliamhenry4823.xml,80444/xv86071,14,16,14,44
"Seattle Audubon Society Photographs",wauseattleaudubonsocietyphcoll671.xml,80444/xv83121,16,11,17,44
"Unknown",waubethisraelcongregationaberdeenwash3762.xml,80444/xv29431,14,16,13,43
"Unknown",waupiercecountycentrallaborcouncilwash2882.xml,80444/xv00503,17,11,15,43
"Unknown",wautitletrustcompanyseattlewash5211.xml,80444/xv12945,16,16,11,43
"Bolton (Frederick E.) Photograph Collection",wauboltonfrederickphcoll644.xml,80444/xv21565,8,15,20,43
"Unknown",waupacificnorthwestconservationcouncil3824.xml,80444/xv05889,15,16,12,43
"Unknown",wauwrightgeorgea2334.xml,80444/xv17861,19,14,10,43
"European Art and Architecture Photograph Collection",waueuropeanartphcoll474.xml,80444/xv24203,12,16,15,43
"Dorian Group Records",waudoriangroup5074_1.xml,80444/xv06850,15,11,17,43
"Attebery (E. Raymond) Photograph Collection",wauatteberyeraymondph2008_024.xml,80444/xv43923,18,14,11,43
"Unknown",waureitersuzannew4452.xml,80444/xv32467,15,14,14,43
"Unknown",waubetaphimuwesternwashingtonprofessionalchapter5054.xml,80444/xv83651,15,15,13,43
"Schultz (Cecilia) Photograph Collection",wauschultzceciliaphcoll066.xml,80444/xv88104,17,14,12,43
"Unknown",waumillerfloydc2434.xml,80444/xv35583,13,16,14,43
"Unknown",wauseattlepeaceinformationcenter1719.xml,80444/xv46734,12,16,15,43
"Unknown",waunewmandavidb5338.xml,80444/xv50405,15,13,15,43
"Ships Collection",waushipsphcoll1137.xml,80444/xv83972,10,15,18,43
"Unknown",wausudatakematsu2034.xml,80444/xv88436,15,13,15,43
"Unknown",wausherwinmarie1979.xml,80444/xv25921,14,17,12,43
"Unknown",wauderanjajohne1352.xml,80444/xv10891,15,15,13,43
"Sick (Martha White) Photograph Collection",wausickmarthawhitephcoll600.xml,80444/xv67381,12,18,13,43
"Unknown",waumedicalwomensclub3910.xml,80444/xv43856,14,15,14,43
"Calvo (Sema) Photograph Collection",waucalvosemaphcoll1060.xml,80444/xv74270,15,16,12,43
"Unknown",wauworkingwashington5892.xml,80444/xv59979,15,15,13,43
"Unknown",wauadamsleo2839.xml,80444/xv91455,6,9,28,43
"Unknown",waujamesflorencebean2117.xml,80444/xv66723,11,19,13,43
"McLean (Walter G.) Photograph Collection",waumcleanwaltergphcoll084.xml,80444/xv77529,16,14,13,43
"Unknown",waumansfieldreese4269.xml,80444/xv75854,15,16,12,43
"Unknown",wauskrivanicgeorgea1310.xml,80444/xv79803,14,14,15,43
"Unknown",waustrongruthmaria0957.xml,80444/xv39959,13,16,14,43
"Phillips (W.S.) Photograph and Illustration Collection",wauphillipswsphcoll111.xml,80444/xv25527,8,16,19,43
"Unknown",wauhebrewbenevolentsocietyofpugetsoundolympiawash3226.xml,80444/xv71609,16,13,14,43
"Temple Beth Am Photograph Collection",wautemplebethamphcoll1089.xml,80444/xv59808,11,11,21,43
"Unknown",wauwilmansjohnmacdonald2195.xml,80444/xv43322,13,16,14,43
"Unknown",wauamericanrevolutionbicentennialcommission2674.xml,80444/xv56311,16,15,12,43
"Unknown",waupricewilliamhoward1463.xml,80444/xv66671,14,14,15,43
"Unknown",wausheltondavid4025.xml,80444/xv20794,8,13,22,43
"Hargreaves (Kenneth L.) Photograph and Drawing Collection",wauhargreaveskennethph2009_007.xml,80444/xv12948,14,13,16,43
"Unknown",waubatemanwilliamg4488.xml,80444/xv50750,15,15,13,43
"University of Washington Department of Family Medicine records",wauuwresource00384.xml,80444/xv03472,14,12,17,43
"Duggan (Robert) Papers",waudugganrobertd5677.xml,80444/xv55499,7,15,21,43
"Unknown",wauwidditschann2249.xml,80444/xv60556,12,15,16,43
"Unknown",waunewbergerjosephh1569.xml,80444/xv14489,16,14,13,43
"Unknown",wausideslavondaperrine3938.xml,80444/xv91549,15,14,14,43
"Kaplan (Jacob) Photograph Collection",waukaplanjacobphcoll770.xml,80444/xv29049,12,16,15,43
"University of Washington Campus Engineering Photographs",wauuwcampusengineeringph2015_022.xml,80444/xv80004,10,9,23,42
"Unknown",wauwheelereleanor1625.xml,80444/xv49554,14,14,14,42
"Rutter (Thomas H.) Photograph Collection",waurutterthomashphcoll287.xml,80444/xv19855,18,13,11,42
"Alderson (Lt. John T.) collection of Japan photographs",waualdersonjohntphcoll1101.xml,80444/xv80856,17,12,13,42
"Unknown",waucarbrayrichardj3073.xml,80444/xv21182,13,14,15,42
"Unknown",waumonroerobertd5232.xml,80444/xv19555,15,15,12,42
"Unknown",wauboothroydwilliamh0949.xml,80444/xv84930,14,13,15,42
"Behar (Elazar) Photograph Collection",waubeharelazarphcoll1056.xml,80444/xv50860,6,19,17,42
"Aagaard (Ann) Collection",wauaagaardannph2004_046.xml,80444/xv97164,5,14,23,42
"Unknown",waukendallbionfreeman4801.xml,80444/xv47872,14,15,13,42
"Unknown",waubarnetteugene4553.xml,80444/xv69979,12,15,15,42
"Unknown",waubuschmannfamilyhomemoviesphcoll976.xml,80444/xv93322,20,11,11,42
"Soule (John P.) Photograph Album",wausoulejohnpalbumph2009_005.xml,80444/xv16030,14,13,15,42
"Unknown",waucanadianminer4471.xml,80444/xv17123,13,17,12,42
"Prosch (Thomas) Indian Photograph Albums",wauproschindianphcoll018.xml,80444/xv85000,17,20,5,42
"Mink (Art) papers",wauminkart1195.xml,80444/xv35168,17,15,10,42
"Unknown",wausilverabe3195.xml,80444/xv88882,15,15,12,42
"Unknown",wauseattleaudubonsociety1171.xml,80444/xv53368,14,13,15,42
"Unknown",wauarnautoffjake2965.xml,80444/xv32882,11,10,21,42
"Unknown",waumondayclubseattlewash1497.xml,80444/xv63589,20,12,10,42
"Esfeld (Sol) Photograph Collection",wauesfeldsolphcoll750.xml,80444/xv93426,12,15,15,42
"Unknown",wauwohlgelerntersamuel3213.xml,80444/xv54071,15,16,11,42
"Unknown",wauyeoldecuriosityshopseattlewash5431.xml,80444/xv41702,16,16,10,42
"Unknown",wausussmanmary2262.xml,80444/xv31405,14,15,13,42
"Robbin (Imogene Miller) Photograph Collection",waurobbinimogenemillerphcoll072.xml,80444/xv88549,16,8,18,42
"Watson (Dwight) Films",wauwatsondwightfilmsphcoll1049.xml,80444/xv42654,14,8,20,42
"Brill (Muriel Mosler) Papers",waubrillmurielmosler2015_2631.xml,80444/xv31710,9,10,23,42
"Brass (Paul R.) Papers",waubrasspaulua5329.xml,80444/xv34133,11,11,20,42
"Ethel (Garland)",wauethelgarlandua2406.xml,80444/xv33749,21,9,12,42
"Harlow (Frederick Pease) papers",wauharlowfrederickpease5847.xml,80444/xv49517,15,11,16,42
"Unknown",wauconeymary2789.xml,80444/xv88403,8,7,27,42
"Unknown",wauhenryed4266.xml,80444/xv50482,16,14,12,42
"Unknown",waucrofutcharlesh5301.xml,80444/xv43255,16,14,12,42
"Shepro (Theresa Aragon de) Papers",wauua19_16_2913sheprotheresa.xml,80444/xv50628,15,14,13,42
"Unknown",wauhansonole3568.xml,80444/xv84298,8,19,15,42
"Powell (Mildred T.) Photograph and Ephemera Collection",waupowellmildredphcoll558.xml,80444/xv73540,15,14,13,42
"Reed (Gervais)",waureedgervaisua2503.xml,80444/xv10000,12,16,14,42
"Unknown",waubaxterlutherloren4605.xml,80444/xv97329,3,9,30,42
"Caballeros de Dimas-Alang (Photographs of the)",waucaballerosdedimasalangphcoll767.xml,80444/xv64163,10,13,19,42
"Unknown",wauamfriendsservcomm4791.xml,80444/xv41391,7,12,23,42
"University of Washington, Health Sciences and Medical Affairs, News and Community Relations Records",wauuwresource00440.xml,80444/xv68725,11,12,18,41
"Unknown",wauseattlehumanrightscommission0976_1546.xml,80444/xv24957,14,13,14,41
"Unknown",wauledwichleol4061.xml,80444/xv95315,16,10,15,41
"Seattle Postcard Collection",wauseattlepostcardphcoll798.xml,80444/xv77566,15,16,10,41
"Unknown",waumunicipalleagueofseattleandkingcounty0472.xml,80444/xv84457,7,6,28,41
"Unknown",wauseattlechamberofcommerce0206.xml,80444/xv07199,14,13,14,41
"Fink (John)",waufinkjohnbrooke1063_1065.xml,80444/xv05340,9,23,9,41
"Unknown",waumensalvaschrisd2361.xml,80444/xv53848,10,13,18,41
"Unknown",wauschreiberisadore2385.xml,80444/xv69616,16,13,12,41
"Botten (Iver) Photographs of Silvana, Washington",waubotteniverphotosofsilvanaphcoll1332.xml,80444/xv97271,12,16,13,41
"Hubbard (Walter T.) Papers",wauhubbardwalter5330.xml,80444/xv77311,16,9,16,41
"Ross (Robert Hugh) architectural drawings and project files",waurossroberthughph2012_012.xml,80444/xv26885,10,22,9,41
"Unknown",wauseattlejewishprimaryschool4407.xml,80444/xv14251,13,15,13,41
"Antonino (Rose) Grand Coulee Dam Photograph Album",wauantoninorosephcoll809.xml,80444/xv66818,10,12,19,41
"Unknown",waushephardesther0994.xml,80444/xv23297,14,10,17,41
"Meeds (Lloyd) Photograph Collection",waumeedslloydphcoll071.xml,80444/xv13848,16,15,10,41
"Stedman (Vernon R.) Papers",waustedmanvernon4661.xml,80444/xv96572,16,10,15,41
"Unknown",waumarinecooksstewardsunion1128.xml,80444/xv44165,21,13,7,41
"Contractors Hardware Company Records",waucontractorshardwareco5626.xml,80444/xv40206,14,14,13,41
"Unknown",wauchaikinsamuel2963.xml,80444/xv87112,5,34,2,41
"Unknown",wauayerelizabeth3981.xml,80444/xv19692,10,11,20,41
"Bailey (Frank C.) Photographs",waubaileyfrankphcoll276.xml,80444/xv23948,14,12,15,41
"Cle Elum Ranger Residence and Garage Photograph Collection",waucleelumrangerresidencephcoll829.xml,80444/xv05923,13,14,14,41
"Warner (Arthur Churchill) Photographs",wauwarnerarthurchurchillphcoll273.xml,80444/xv12719,12,21,8,41
"Unknown",wauwashingtonnaturalresourcesassociation4290.xml,80444/xv41607,13,13,15,41
"Red Sky Poetry Theatre and Seattle Muse Community records",wauredskyseattlemuse5790.xml,80444/xv00567,10,20,11,41
"Ward (Dillis B.) Photograph Collection",wauwarddillisbphcoll488.xml,80444/xv04266,9,14,18,41
"Long (Priscilla) Papers",waulongpriscilla4306.xml,80444/xv67648,9,15,17,41
"Engberg (Henry) Photograph Collection",wauengberghenryphcoll491.xml,80444/xv31695,13,13,15,41
"Veloria (Velma) Papers",wauveloriavelma5588.xml,80444/xv93478,16,13,12,41
"Unknown",waudioncarlr4154.xml,80444/xv33533,10,12,19,41
"Unknown",waumadsenchristian3261.xml,80444/xv76693,15,13,13,41
"Unknown",waucommunistpartyoftheunitedstatesofamerica0464.xml,80444/xv78295,11,13,17,41
"Brady (Ferdinand) Photographic Postcards of Tulalip Indian School, Washington State",waubradyferdinandphcoll139.xml,80444/xv15063,10,17,14,41
"Unknown",waupettusterry0139_0463.xml,80444/xv44088,10,13,18,41
"Unknown",wauseidlefamily3763.xml,80444/xv22982,14,14,13,41
"Unknown",waubrownbertha3479.xml,80444/xv42153,14,13,14,41
"Tollman and Canaris Photographs",wautollmancanarisphcoll293.xml,80444/xv88595,12,11,18,41
"Seattle Trolleys",wauseattletrolleysphcoll896.xml,80444/xv18774,13,17,11,41
"Unknown",waumacdonalddorothy3207.xml,80444/xv16003,14,15,12,41
"Finlandia Foundation Seattle Chapter Records",waufinlandiafoundationseattlechapter5533.xml,80444/xv07000,16,14,11,41
"University of Washington Associated Students Records",wauuwresource02749.xml,80444/xv26184,7,17,17,41
"Bennett (Fred S.) College life at the University of Washington Photograph Album",waubennettfredsphcoll464.xml,80444/xv71533,7,14,20,41
"Major (Adolph) Collection",waumajoradolph5712.xml,80444/xv42977,17,15,9,41
"Unknown",wausupremelodgeofthedanishsisterhoodofamericalodge40seattlewash2171.xml,80444/xv37597,13,13,15,41
"Unknown",waumanringbenjaminfranklin2677.xml,80444/xv94265,13,13,15,41
"Day (Lola) Papers",waudaylola2746_1.xml,80444/xv93376,15,9,16,40
"Hallock (Peter R.) papers",wauhallockpeterr5846.xml,80444/xv36190,20,6,14,40
"Unknown",waubarnettjames2363.xml,80444/xv58602,3,14,23,40
"Skinner (G. William) Papers",wauskinnergwilliam5709.xml,80444/xv10552,14,14,12,40
"Unknown",wauaaup_uw4364.xml,80444/xv52099,6,6,28,40
"Seattle Department of Community Development Architectural Drawings of the Pike Place Urban Renewal Project",wauseattledeptcommunitydevelopmentpikeplaceprojectph2009_029.xml,80444/xv51119,9,12,19,40
"University of Washington Department of Botany Records",wauuwresource00309.xml,80444/xv20397,12,17,11,40
"Unknown",waurichardsevalouisealvey1502.xml,80444/xv63888,16,10,14,40
"Unknown",wausiannasocietytacomawash0134.xml,80444/xv84509,14,13,13,40
"University of Washington Graduate School, Academic Programs Office Records",wauuwresource03449.xml,80444/xv07510,17,8,15,40
"Unknown",wauosbornetremperandcoincseattlewash0784.xml,80444/xv23510,17,14,9,40
"Asberry (Nettie J.) Photograph Collection",wauasberrynettiejphcoll663.xml,80444/xv81062,22,10,8,40
"Alaska-Yukon-Pacific Exposition Photograph Collection",wauaypephcoll792.xml,80444/xv20013,17,13,10,40
"Unknown",wauhaubergannegould2991.xml,80444/xv30633,10,8,22,40
"Skrivanic (George A.) Photograph Collection",wauskrivanicgeorgeaphcoll544.xml,80444/xv07907,15,14,11,40
"Morford (Carl E.) Photograph Albums",waumorfordcarlephcoll009.xml,80444/xv73138,15,15,10,40
"University of Washington, Laboratory of Radiation Ecology Records",wauuwresource00457.xml,80444/xv21606,10,6,24,40
"Boschok (Jackie)",wauboschokjackiephcoll1112.xml,80444/xv49157,14,9,17,40
"Shemanski (Alfred) Photograph Collection",waushemanskialfredphcoll913.xml,80444/xv99346,10,10,20,40
"Miller (John Leonard) Photograph Collection",waumillerjohnleonardphcoll085.xml,80444/xv95349,10,11,19,40
"Unknown",wauhillgeorged4267.xml,80444/xv94746,11,12,17,40
"Rice (Rick) Papers",wauricerick5827.xml,80444/xv33679,14,14,12,40
"William Grand Photographs of the Snake River Mail Boat Route",waugrandwilliamsnakeriverphcoll773.xml,80444/xv92362,8,19,13,40
"Unknown",waubrotherhoodofrailwayandsteamshipclerksfreighthandlersexpressandstationemployesnorthernpacificsystemboardofadjustmenttacomadivision2275.xml,80444/xv35519,15,14,11,40
"Boyd and Braas Photographs",wauboydandbraasphcoll277.xml,80444/xv96865,13,8,19,40
"Unknown",waunielsonroy3906.xml,80444/xv22518,15,14,11,40
"Unknown",waukleincharna5090.xml,80444/xv19921,7,10,23,40
"Unknown",wauwilsonlesliee2985.xml,80444/xv47384,15,13,12,40
"Unknown",waumacbridephilipd2966.xml,80444/xv81433,10,11,19,40
"Unknown",waustrongsydney0959.xml,80444/xv76544,16,10,14,40
"Unknown",waucrumbakermartha0428.xml,80444/xv20364,14,14,12,40
"Musicians' Association of Seattle records",waumusiciansassociationofseattle5685.xml,80444/xv12707,15,10,15,40
"Deutsch (Eva Esfeld) Photograph Collection",waudeutschevaphcoll808.xml,80444/xv96606,14,6,20,40
"Unknown",wauschmoefloydwilfred0496.xml,80444/xv34594,16,7,17,40
"Denny",waudennypartyphcoll1197.xml,80444/xv93118,14,7,19,40
"Unknown",waugandyjosephe1738.xml,80444/xv16116,8,16,16,40
"Rotschy (Edgar) Papers",waurotschyedgar3298.xml,80444/xv11898,16,10,14,40
"Kodiak, Alaska, Photograph Collection",waukodiakalaskaphcoll638.xml,80444/xv21556,16,7,16,39
"Unknown",wauashharry3520.xml,80444/xv32775,13,9,17,39
"Unknown",wauvelascovictorioa1435.xml,80444/xv62872,17,8,14,39
"Unknown",wauwashingtonenvironmentalcouncil1729_3005.xml,80444/xv82211,11,5,23,39
"University of Washington Faculty Senate Records",wauuwresource00021.xml,80444/xv13723,5,5,29,39
"Lenggenhager (Werner) Photographs",waulenggenhagerwernerphcoll660.xml,80444/xv13004,19,10,10,39
"Hadley Smelter Photograph Collection",wauhadleysmelterphcoll850.xml,80444/xv36703,14,11,14,39
"Witherup (William) Papers",wauwitherupwilliam4321.xml,80444/xv95037,16,10,13,39
"Welcome to the Fleet at Frisco Photograph Album Photograph Album",waujohansonrussphcoll255.xml,80444/xv69027,14,13,12,39
"Unknown",wauparkerherbertm3616.xml,80444/xv14726,18,9,12,39
"Bussemaker (Angela S.and Gerit J.) Photograph Albums",waubussemakerphcoll834.xml,80444/xv08245,11,15,13,39
"Gould (Carl F.) Photograph Collection",waugouldcarlphcoll426.xml,80444/xv91671,14,8,17,39
"Unknown",waubeharleon2416.xml,80444/xv90933,18,5,16,39
"Chittenden (Hiram)",wauchittendenhiram4632.xml,80444/xv77420,13,10,16,39
"Jones (Wesley. L.) Photograph Collection",waujoneswesleyphcoll715.xml,80444/xv58905,7,12,20,39
"Sempere (Thom) UW Drama School Productions Photographs",wausemperethomphcoll354.xml,80444/xv63623,15,13,11,39
"Cress (John D.) Lumber Industry of the Pacific Northwest: Reforestation - Timber - Logging - Manufacture",waucressjohndphcoll213.xml,80444/xv27026,11,12,16,39
"Unknown",waubuttonsmedalsribbonscollection5130.xml,80444/xv30191,10,9,20,39
"Unknown",wauitotomie5310.xml,80444/xv16415,14,14,11,39
"Unknown",waufostergeorgialaberee3633.xml,80444/xv55734,14,14,11,39
"Unknown",wauwomanscenturyclubseattlewash4033.xml,80444/xv50976,12,8,19,39
"Neylan (Mickey) Photograph Collection",wauneylanmickeyphcoll449.xml,80444/xv79327,18,11,10,39
"Unknown",waudennetteugenev3917.xml,80444/xv46902,10,8,21,39
"Unknown",waukoenigjohnfranklin2734.xml,80444/xv79272,7,6,26,39
"Weiner (Elsie Deutsch) Photograph Collection",wauweinerelsiephcoll741.xml,80444/xv04470,18,6,15,39
"Magnolia Historical Society Photograph Collection",waumagnoliahistoricalsocietyphcoll712.xml,80444/xv81826,11,6,22,39
"Hinkle (James W.) Papers",wauhinklejamesw5750.xml,80444/xv91983,7,13,19,39
"Morgan (Edith) Photograph Collection",waumorganedithphcoll645.xml,80444/xv53020,18,8,13,39
"Buttnick (Meta) Photograph Collection",waubuttnickmetaphcoll909.xml,80444/xv74337,15,9,15,39
"Groundswell Off Broadway Records",waugroundswelloffbroadway5508.xml,80444/xv78314,10,8,21,39
"Semple and Mizner Families photograph collection",wausemplemiznerfamiliesphcoll1120.xml,80444/xv18331,5,19,15,39
"Unknown",wauunitedstatesembassyrussia4934.xml,80444/xv29742,15,13,11,39
"Benezra (Henry)",waubenezrahenry1685_4608.xml,80444/xv64038,8,11,20,39
"Unknown",wauconovercharlestallmadge1052.xml,80444/xv15875,9,7,23,39
"Unknown",waureedbob3512.xml,80444/xv47564,7,22,10,39
"Unknown",wauseattleteachersassociationseattlewash1402.xml,80444/xv99819,12,19,8,39
"Unknown",waudealclydew1596.xml,80444/xv89987,6,15,17,38
"Unknown",waufraserclararichard0500_1381.xml,80444/xv98165,14,13,11,38
"Seattle - The Seaport of success Photograph Album",wauseattleseaportofsuccessphcoll106.xml,80444/xv09454,16,12,10,38
"Unknown",waujapaneseassociationofnorthamerica1235.xml,80444/xv86877,12,9,17,38
"Unknown",wauhesterwilhelm3149.xml,80444/xv22872,14,14,10,38
"Olsborg (Gunnar) Papers",wauolsborggunnar1978.xml,80444/xv80384,14,11,13,38
"Loveless (Arthur) Photograph Collection",waulovelessarthurphcoll428.xml,80444/xv28585,12,15,11,38
"Welch (Douglass) Papers",wauwelchcdouglass0779.xml,80444/xv04022,10,13,15,38
"Aldrich (Robert)",waualdrichrobertaua4569.xml,80444/xv55303,9,10,19,38
"Unknown",wauandersonlloyd2648.xml,80444/xv41552,10,11,17,38
"Cableship Dellwood Photograph Collection",waucableshipdellwoodphcoll697.xml,80444/xv88936,16,10,12,38
"Eckert (Robert A.) Architectural Drawings, Photographs and Other Materials",waueckertrobertaph2008_051.xml,80444/xv94000,24,5,9,38
"Unknown",wauleiferiksonleagueoftheseattlearea1982.xml,80444/xv90863,14,14,10,38
"Harrison (Joseph B.) Papers",wauua19_13_0494harrisonjosephb.xml,80444/xv40022,17,4,17,38
"University of Washington, Department of Architecture Records",wauuwresource00264.xml,80444/xv06906,14,15,9,38
"Unknown",waunorthwestdesignercraftsmenassociation2514.xml,80444/xv67272,12,11,15,38
"Unknown",wausteinbergfamily3660.xml,80444/xv97909,11,6,21,38
"Jewish Education Council of Greater Seattle Photograph Collection",waujewisheducationcouncilgreaterseattlephcoll907.xml,80444/xv44671,16,13,9,38
"Unknown",wauandersongordonlee2866.xml,80444/xv06951,7,10,21,38
"University of Washington Engineering Experiment Station Records",wauuwresource07689.xml,80444/xv76849,14,7,17,38
"Puget Mill Company Alderwood Manor Photograph Album",waupugetmillphcoll256.xml,80444/xv73907,6,8,24,38
"Davis (Melanie Zwang) Photograph Collection",waudavismelaniephcoll695.xml,80444/xv00863,15,7,16,38
"Unknown",wauparkhurstminnie1848.xml,80444/xv31222,16,8,14,38
"Unknown",wauwillapaharborsportsmansassociation4970.xml,80444/xv78179,14,12,12,38
"Hogenauer (Irwin R.) photograph collection",wauhogenauerirwinrphcoll1108.xml,80444/xv36273,13,6,19,38
"Unknown",wauamericanfederationteacherslocal401_0616.xml,80444/xv26129,6,14,18,38
"Unknown",waulatourellelaine4587.xml,80444/xv45971,15,13,10,38
"Unknown",wauseattlefreelances5071.xml,80444/xv42727,13,13,12,38
"Lovett (Wendell) papers",waulovettwendell5776.xml,80444/xv35202,10,14,14,38
"Miller (Charles B.) Architectural Drawings",waumillercharlesdrawingsphcoll761.xml,80444/xv60595,19,7,12,38
"Unknown",waualaskagastineauminingcompanyjuneaualaska0011.xml,80444/xv05917,7,11,20,38
"Grand Coulee Dam (Views of the), Columbia Basin Project, Washington",wauhughbmitchellgrandcouleedamphcoll239.xml,80444/xv55412,10,13,15,38
"Kernberger (Karl) Visual Materials Collection",waukernbergerkarlph2006_008.xml,80444/xv72155,16,11,11,38
"Unknown",wauscottpublishingcompanyvscolumbiabasinpublishers2268.xml,80444/xv81845,13,15,10,38
"Unknown",wausmithmayb4216.xml,80444/xv71920,15,13,10,38
"Rashkov (Eli and Esther) Papers",waurashkoveliandesther4564.xml,80444/xv33190,11,10,17,38
"Unknown",waumcdonaldlucilesaunders2234.xml,80444/xv80184,12,14,12,38
"Eckstein (Nathan) Papers",wauecksteinnathan0109.xml,80444/xv55386,9,6,23,38
"Unknown",wauseattlegradeteachersclub5435.xml,80444/xv29614,14,12,12,38
"Unknown",waugreenjoshua0645.xml,80444/xv09481,16,8,14,38
"Scribner (Belding H.) Papers",wauua27_08_3301scribnerbelding.xml,80444/xv18359,22,8,8,38
"Unknown",wauwesternforestryandconservationassociationus1070.xml,80444/xv85336,14,13,10,37
"Unknown",wauintassocmachinistsaerospaceworkerslocal751e5818.xml,80444/xv39938,18,8,11,37
"Unknown",wauyamashitatakuji5151.xml,80444/xv90798,6,15,16,37
"Unknown",waubridgeralph3413.xml,80444/xv16769,2,10,25,37
"Unknown",wauchildsgladwynmurray2208.xml,80444/xv95681,10,9,18,37
"Unknown",waushipmanhoward0246.xml,80444/xv88906,14,13,10,37
"Haas (Saul) Papers",wauhaassaul2213.xml,80444/xv11416,11,12,14,37
"Unknown",wauymcauw2126.xml,80444/xv43444,12,13,12,37
"Irvin (Karen) Papers",wauirvinkaren4341_4.xml,80444/xv13346,17,10,10,37
"Arai (Tatsuya) Family Photograph Album",wauaraitatsuyaphcoll1038.xml,80444/xv71688,14,11,12,37
"Unknown",waunishitanimartha4421.xml,80444/xv06539,14,7,16,37
"Stiefel (Doris) Papers",waustiefeldoris3890.xml,80444/xv00357,14,10,13,37
"Potoski (Tony) Album of Photographs of the Aleutian Islands in World War II",waupotoskitonyphcoll1098.xml,80444/xv01879,10,12,15,37
"Scroggin Family Albums",wauscrogginfamilyalbumsphcoll349.xml,80444/xv65499,13,13,11,37
"University of Washington Office of Minority Affairs Records",wauuwresource00106.xml,80444/xv72564,16,6,15,37
"University of Washington College of Architecture and Urban Planning Records",wauuwresource00263.xml,80444/xv66101,13,14,10,37
"Anonymous Alaska-Yukon-Pacific Exposition Photographs",wauanonymousaypephcoll756.xml,80444/xv61237,13,8,16,37
"Unknown",waubinhmemorialcommitteeseattlewash2242.xml,80444/xv01257,12,8,17,37
"Hankins (Thomas L.) Papers",wauhankinsthomasua5186.xml,80444/xv30203,9,13,15,37
"Unknown",waunorthwesternlumbercompanywash4287.xml,80444/xv03378,11,8,18,37
"Unknown",wauwashingtonstateconservationsociety0202.xml,80444/xv63766,13,15,9,37
"Mensalvas (Chris D.) Photograph Collection",waumensalvaschrisdphcoll657.xml,80444/xv15057,6,16,15,37
"Sternwheeler Philip B. Low Photograph Album",wauphilipblowphcoll038.xml,80444/xv11340,13,13,11,37
"Unknown",wauyonedakarlg1273.xml,80444/xv74807,10,11,16,37
"Seattle Peace Park Records",wauseattlepeaceparkassociates5611.xml,80444/xv83657,12,12,13,37
"Field (Eugene H.) Lummi Indian Photographs",waufieldeugenehphcoll77.xml,80444/xv12107,12,13,11,36
"Lein (John N.) Papers",wauleinjohnua5430.xml,80444/xv89419,2,5,29,36
"Unknown",wauscientistscitizensorganizedonpolicyissues3597.xml,80444/xv37954,13,13,10,36
"Ford (Helen) Collection of T. Enami Photographs",wauenamiphcoll570.xml,80444/xv83987,9,10,17,36
"Poindexter (Miles) Photograph Collection",waupoindextermilescphcoll174.xml,80444/xv09161,10,18,8,36
"Unknown",waubeckerrayfield0972.xml,80444/xv85818,16,5,15,36
"Unknown",wauamentdeloristarzan5122.xml,80444/xv56039,11,10,15,36
"Bowen (Betty) Photograph Collection",waubowenbettyphcoll070.xml,80444/xv69494,12,7,17,36
"Unknown",waushemanskialfred1313.xml,80444/xv15896,8,6,22,36
"Sierra Club Northwest Office",wausierraclubnorthwestoffice2678_3613.xml,80444/xv49398,10,15,11,36
"Preston (Howard)",wauprestonhowardhallua1867.xml,80444/xv63272,15,7,14,36
"Unknown",wauconemolly4378.xml,80444/xv15969,7,7,22,36
"Coder (Bob) Lockheed Shipbuilding Company Lockout scrapbook",waucoderbob5711.xml,80444/xv40835,17,7,12,36
"Brill (Muriel Mosler) Photograph Collection",waubrillmurielmoslerphcoll1059.xml,80444/xv94567,5,7,24,36
"Unknown",waunationalassociationfortheadvancementofcoloredpeoplevancouverbranchvancouverwash1246.xml,80444/xv65681,11,11,14,36
"Unknown",waumcculloughesthermary2236.xml,80444/xv92227,10,17,9,36
"McGilvra Family Photograph Collection",waumcgilvrafamilyphcoll487.xml,80444/xv47205,15,6,15,36
"Amalgamated Meat Cutters Playing Cards",wauamalgamatedmeatcuttersplayingcardsphcoll1318.xml,80444/xv68215,11,19,6,36
"Unknown",wausavellemax0844-005.xml,80444/xv27014,13,8,15,36
"Alaska and Pacific Northwest Early Photographers Collection",wauearlyphotographersphcoll334.xml,80444/xv52062,16,11,9,36
"Herberg (Ruth) Photograph Collection",wauherbergruthphcoll147.xml,80444/xv11157,12,6,18,36
"Roberts (Milnor) Photograph Collection",waurobertsmilnorphcoll153.xml,80444/xv29067,14,10,12,36
"Unknown",wauboyerjohne0138.xml,80444/xv77197,8,9,19,36
"Fowler (David)",waufowlerdavidcua1696.xml,80444/xv01782,7,12,17,36
"Unknown",waubrananarthurd1073.xml,80444/xv85906,12,12,12,36
"Graves (Steve) papers",waugravessteve5746.xml,80444/xv83428,17,4,15,36
"Unknown",wauforbusladywillie0259.xml,80444/xv35293,12,11,13,36
"Young Women's Christian Association (University of Washington) Photograph Collection",wauywcauwphcoll628.xml,80444/xv57807,15,11,10,36
"Unknown",waunatureconservancy3026.xml,80444/xv77304,9,10,17,36
"Couch (Alden B.) Seattle World's Fair Slide Collection",waucouchaldenbph2008_031.xml,80444/xv53335,10,8,18,36
"Unknown",waumagnoliahistoricalsociety5345.xml,80444/xv49645,13,11,12,36
"Seattle Draft Counseling Center Records",wauseattledraftcounsctr3925_3.xml,80444/xv52676,10,12,14,36
"Unknown",wauwomenpainterswashington2572.xml,80444/xv44132,13,9,13,35
"Unknown",waukennedyjohnc0659.xml,80444/xv44937,8,12,15,35
"Barnard (Kathryn)",waubarnardkathryneua5178.xml,80444/xv54617,8,9,18,35
"Unknown",wauinternationalassociationofmachinistshopelodge79seattlewash0093.xml,80444/xv75375,10,17,8,35
"Unknown",wauwinnnormanl1944.xml,80444/xv85339,11,12,12,35
"Unknown",wausylvesteralberthale1518.xml,80444/xv19442,11,11,13,35
"Unknown",waunationalmarineengineersbeneficialassociationus0512.xml,80444/xv53070,22,8,5,35
"Pacific Northwest Library Association Records",waupacificnorthwestlibraryassociation1920.xml,80444/xv43487,7,9,19,35
"Unknown",waumontecristominingcompany0799.xml,80444/xv51473,19,9,7,35
"Unknown",waurockwoodcharlesp3078.xml,80444/xv18830,11,7,17,35
"Abell (Millicent)",wauabellmillicentdua5098.xml,80444/xv81588,8,14,13,35
"Eggert (Charles)",wauwildernessrivertrailfilmphcoll1268.xml,80444/xv40130,16,10,9,35
"Hodge (Paul W.) Papers",wauua19_32_3342hodgepaulw.xml,80444/xv71486,14,14,7,35
"University of Washington Housing and Food Services Office Records",wauuwresource00136.xml,80444/xv09310,16,8,11,35
"Unknown",wauackleynormanb0688.xml,80444/xv07958,6,7,22,35
"Insurance Personnel Conference (University of Washington).",wauinsurancepersonnelconference3315.xml,80444/xv90307,3,6,26,35
"Unknown",wauunitedfarmworkers3643.xml,80444/xv52725,11,9,15,35
"Unknown",wauweintzdorothyj2697.xml,80444/xv29768,11,7,17,35
"Unknown",wausnokingjewishhavurahwash5028.xml,80444/xv40457,12,13,10,35
"Eccles (John M.) Papers",wauecclesjohn4517_1.xml,80444/xv44809,9,12,14,35
"Hull (Irene B.) Papers",wauhullireneb3783.xml,80444/xv45401,13,12,10,35
"WPA Museum Extension Project Costume Drawings Collection",wauwpamuseumextensionprojectphcoll538.xml,80444/xv35122,7,18,10,35
"Unknown",wauamericanfederationofteacherslocaleverettwash3848.xml,80444/xv63354,17,8,10,35
"Margolies (Hermine Rosenblatt) Photograph Collection",waumargoliesherminerphcoll774.xml,80444/xv68771,12,10,13,35
"Unknown",wauwomenartistsgroupofthenorthwest5168.xml,80444/xv84280,13,12,10,35
"Unknown",wauruppjohnn2961.xml,80444/xv22329,5,9,21,35
"Cook (Seymour Samuel) Cabinet Card Collection",waucookseymoursamuelphcoll517.xml,80444/xv45223,7,13,15,35
"Unknown",wauihrigherbertg1549.xml,80444/xv22756,14,11,10,35
"Curt-Teich postcard proof photographs of Seaside, Oregon",waucurtteichphcoll892.xml,80444/xv98712,10,8,17,35
"Granada Relocation Center Records",waugranadareloc4171_1.xml,80444/xv82431,8,11,16,35
"Miller (Charles Al) Papers",waumillercharlesal5966.xml,80444/xv09622,8,14,13,35
"Aasen (Wendy)",wauaasenwendykg2696-061.xml,80444/xv04885,11,5,19,35
"Libby, McNeill and Libby Company Salmon Division",waulibbymcneillibbysalmonphcoll824.xml,80444/xv95724,15,10,10,35
"Windoffer (Melba) Papers",wauwindoffermelba1798.xml,80444/xv17486,14,4,17,35
"Unknown",wauassociatedvintnersbellevuewash3461.xml,80444/xv93933,7,11,17,35
"Unknown",waulathanroosevelt3554.xml,80444/xv63052,13,12,10,35
"Elliott (Merton) Architecture and Mortuary Art Photograph Collection",wauelliottmertonmortuaryartphcoll1233.xml,80444/xv11724,11,8,15,34
"Stricker (Milton) architectural drawings and project files",waustrickermiltonph2012_018.xml,80444/xv30026,13,9,12,34
"Unknown",waustrongtracy1445.xml,80444/xv84463,12,11,11,34
"Unknown",wauuwresource00407.xml,80444/xv85232,9,10,15,34
"Unknown",wausimpsonrogerua4165.xml,80444/xv75662,20,10,4,34
"Bikur Cholim-Machzikay Hadath Photograph Collection",waubikurcholemphcoll914.xml,80444/xv85214,10,9,15,34
"Unknown",wauepsteinjesse3043.xml,80444/xv90429,5,17,12,34
"Unknown",wauhirshnormand3740.xml,80444/xv38104,13,8,13,34
"Harrison (Arthur E.) Glacier Photographs",wauharrisonarthurephcoll164.xml,80444/xv14785,10,6,18,34
"Seders (Francine) Papers",wausedersfrancine2426.xml,80444/xv68071,12,7,15,34
"University of Washington. University Relations.",wauuwresource00204.xml,80444/xv42660,7,8,19,34
"Carr (Kenneth) Papers",wauua19_18_5144carrkenneth.xml,80444/xv89618,9,13,12,34
"Dassow (Ethel) Papers",waudassowethel5574.xml,80444/xv81387,6,9,19,34
"Davidson (Issac G.) Photographs",waudavidsonissacgphcoll332.xml,80444/xv79504,8,7,19,34
"McGrath (James A.) Photograph Collection",waumcgrathjamesph2004_053.xml,80444/xv23187,6,5,23,34
"Unknown",waushafferemily5283.xml,80444/xv18939,10,3,21,34
"Alaska-Yukon-Pacific Exposition Grounds Pre-Exposition Photograph Collection",wauaypegroundspreexpositionph757.xml,80444/xv90765,13,3,18,34
"Kohn (Alan J.) papers",waukohnalanjua5157.xml,80444/xv84014,12,8,14,34
"Denton (Eric B.) Papers",waudentonericb5789.xml,80444/xv53732,16,9,9,34
"Unknown",waupioneersquaretheater4067.xml,80444/xv36090,15,10,9,34
"Unknown",wauuwresource07096.xml,80444/xv35266,12,10,12,34
"Unknown",waufukuyamabetty4411.xml,80444/xv36609,8,13,13,34
"Higano Family Papers",wauhiganofamily2870_1.xml,80444/xv59173,15,9,10,34
"Frederick Law Olmsted National Historic Site AYPE Photograph Collection",wauayperesearchphcoll172.xml,80444/xv28408,12,10,12,34
"Unknown",waufrankeljoseph2813.xml,80444/xv06747,12,13,9,34
"Farber (Jack)",waufarberjack5489.xml,80444/xv09066,10,6,18,34
"Winberg (Andrew) Photograph Collection",wauwinbergandrewphcoll385.xml,80444/xv81964,3,17,14,34
"Cascade Locks and Columbia River Highway Map and Drawing Collection",waucascadelockscolumbiariverhighwayphcoll840.xml,80444/xv73754,6,13,15,34
"Unknown",waudennyfryefamily0096.xml,80444/xv64865,7,12,15,34
"Carmack (George W.) Photographs of",waucarmackgeorgephcoll692.xml,80444/xv85520,9,10,15,34
"Thode (Kay) Papers",wauthodekay5353.xml,80444/xv98754,7,10,17,34
"Unknown",wauclarafraserdefensecommittee3187.xml,80444/xv18630,16,11,7,34
"Unknown",waukingcountynursesassociationkingcountywash3049.xml,80444/xv39205,12,14,7,33
"Unknown",wauesfeldsol2018.xml,80444/xv32373,7,7,19,33
"Ybarra-Frausto (Tomás) Photograph Collection",wauybarrafraustotomasphcoll437.xml,80444/xv45788,8,4,21,33
"Friedman (Susie Michael) Photograph Collection",waufriedmansusiemichaelphcoll688.xml,80444/xv16372,16,7,10,33
"Benezra Family",waubenezrafamily5912.xml,80444/xv32611,10,9,14,33
"Unknown",wauruckerfamily3067.xml,80444/xv40042,17,6,10,33
"Unknown",wauindustrialworkersworld0691_1975_2160_2235.xml,80444/xv96456,12,12,9,33
"California Seafood Canning Plants photograph collection",waucaliforniaseafoodphcoll1123.xml,80444/xv51007,16,11,6,33
"Unknown",waudempseymark5076.xml,80444/xv80902,10,11,12,33
"Spring (Bob and Ira) Films",wauspringbobandirafilmsphcoll1048.xml,80444/xv68011,8,10,15,33
"Bonds (Frank) Photographs",waubondsfrankphcoll6.xml,80444/xv00351,10,12,11,33
"Levine (Phillip) papers",waulevinephillip5743.xml,80444/xv52386,7,14,12,33
"Unknown",wauassociationofwesternpulpandpaperworkers2052.xml,80444/xv17974,9,13,11,33
"Brune (Martha E.) Frederick & Nelson Photograph Collection",waubrunemarthaephcoll138.xml,80444/xv73641,16,11,6,33
"Wenk (E.)",wauwenkeua2934.xml,80444/xv25094,7,10,16,33
"Kininnook (David) Photograph Collection",waukininnookphcoll643.xml,80444/xv19845,7,8,18,33
"Goldfarb (Samuel E.) Photograph Collection",waugoldfarbsamuelephcoll742.xml,80444/xv49530,10,11,12,33
"Century 21 Exposition Records",waucentury21exposition0507.xml,80444/xv95370,10,9,14,33
"Unknown",wauwashingtonstatecio0302.xml,80444/xv66159,13,10,10,33
"Torrance (Roscoe) Papers",wautorranceroscoec1326_1361_1951.xml,80444/xv67294,13,9,11,33
"Unknown",waumaritimefederationpacificcoast0789.xml,80444/xv95367,7,15,11,33
"Unknown",wauprottassam2216.xml,80444/xv06973,7,14,12,33
"Dehmelt (Hans)",waudehmelthansgua5281.xml,80444/xv06518,6,11,16,33
"Hirakawa (Kihachi) Photograph Collection",wauhirakawakihachiphcoll207.xml,80444/xv54394,14,9,10,33
"Russell (Clem) China Photograph Collection",waurussellclemchinaphcoll691.xml,80444/xv94421,7,12,14,33
"Siegel (Sylvia) Photograph Collection",wausiegelsylviaphcoll1085.xml,80444/xv30920,11,11,11,33
"Krebs (Edwin G.) Papers",waukrebsedwingua5254.xml,80444/xv87783,11,11,11,33
"Peiser (Theodore E.) Photographs",waupeisertheodoreephcoll282.xml,80444/xv94680,10,13,10,33
"Carstensen (Vernon) papers",waucarstensenvernonua2477_2980.xml,80444/xv13726,10,7,16,33
"Case (William H.) Alaska Photographs",waucasewilliamhphcoll300.xml,80444/xv87603,15,11,7,33
"Unknown",waucarrharryl2210.xml,80444/xv65127,12,10,11,33
"Unknown",waunordmannsforbundetpacificnorthwestchapter3649.xml,80444/xv86572,14,10,9,33
"Unknown",waukochsamuel1759.xml,80444/xv32052,9,8,16,33
"Hill (Francis) Photograph Albums",wauhillfrancisph2007_021.xml,80444/xv86013,10,11,12,33
"University of Washington, Department of Earth and Space Sciences Records",wauuwresource00292.xml,80444/xv87982,13,11,9,33
"Unknown",waudeanoscart0632.xml,80444/xv98010,5,8,20,33
"Dragon Gate Press Records",waudragongateinc5629.xml,80444/xv47998,7,8,18,33
"Washington State Jewish Historical Society photograph collection",wauwashstjewishhistsocphcoll1142.xml,80444/xv98226,7,12,13,32
"University of Washington School of Medicine. Dean's Office Records",wauuwresource00371.xml,80444/xv31918,10,7,15,32
"Unknown",waulindsleylawrencedenny2179.xml,80444/xv03457,13,7,12,32
"Wehr (Wesley) Papers",wauwehrwesley2316.xml,80444/xv42767,4,14,14,32
"Cooke (Clay and Relta) Photograph and Film Collection",waucookeclayandreltaphcoll003.xml,80444/xv36911,9,7,16,32
"Unknown",wauopportunitiesindustrializationcenterseattlewash4055.xml,80444/xv41479,3,23,6,32
"Bertelson (Ernest B.) Photographs",waubertelsonernestbphcoll477.xml,80444/xv45352,9,14,9,32
"Novick (Michael) photograph collection",waunovickmichaelphcoll1140.xml,80444/xv26837,12,7,13,32
"Unknown",wauazoseleo3286.xml,80444/xv95584,6,9,17,32
"Unknown",wauandersonedmundcarr2573.xml,80444/xv92721,4,9,19,32
"Young (Theodosia) Photograph Collection",wauyoungtheodosiaphcoll1162.xml,80444/xv89398,11,7,14,32
"Ittner (Ruth)",wauittnerruth4233.xml,80444/xv67477,8,10,14,32
"Senn (Deborah) Oral History",wausenndeborah5705.xml,80444/xv51077,4,8,20,32
"Unknown",waupaulwilliaml4246.xml,80444/xv81372,8,10,14,32
"Unknown",wauruegnitzwilliamc4205.xml,80444/xv62011,8,9,15,32
"Hearst (Armeta) Home Movie Collection",wauhearstarmetaphcoll930.xml,80444/xv00112,9,17,6,32
"Hargus (Sharon) Papers",wauhargussharon2696_5084.xml,80444/xv09133,8,13,11,32
"Horst (A.)",wauhorstapaulua2910.xml,80444/xv67837,10,9,13,32
"Linkletter (Lloyd G.) Photographs",waulinkletterlloydgphcoll292.xml,80444/xv90023,5,11,16,32
"Herzl-Ner Tamid Photograph Collection",wauherzlnertamidphcoll906.xml,80444/xv03109,19,8,5,32
"Unknown",waukinneymarions0461.xml,80444/xv61984,6,12,14,32
"Unknown",wauutleywindsor4219.xml,80444/xv31137,15,8,9,32
"Newberger Family Photograph Collection",waunewbergerfamilyphcoll1078.xml,80444/xv54739,7,9,16,32
"Unknown",waualmelehjacob1864.xml,80444/xv48043,5,9,18,32
"Unknown",wauneubauernathanignatius3138.xml,80444/xv59868,13,6,13,32
"Unknown",waunaacpseattle0465.xml,80444/xv06463,5,10,17,32
"Unknown",waureedmarkemarkedward0035.xml,80444/xv16998,16,9,7,32
"Wolff (Joel) photograph and film collection",wauwolffjoelphcoll991.xml,80444/xv86825,12,6,14,32
"Unknown",waumoranbrotherscompanyseattlewash4827.xml,80444/xv97144,11,6,15,32
"Denny Family Photograph Collection",waudennyfamilyphcoll879.xml,80444/xv04373,9,11,12,32
"Bauer (Harry Charles) Photographs of",waubauerharrycphcoll599.xml,80444/xv34550,10,15,7,32
"Unknown",wauuwresource07733.xml,80444/xv17163,14,3,15,32
"Sonneman (Joseph) Photographs and Other Material",wausonnemanjosephph2008_029.xml,80444/xv25079,7,7,18,32
"Northern Pacific Railroad Company.",waunorthernpacificrailroadcompany0350_0371_0800_3233_4415_5117.xml,80444/xv30249,7,12,13,32
"Alexander (Edward,)",waualexanderedwardua3183.xml,80444/xv96963,6,8,18,32
"Glant (Douglas) Oral History",wauglantdouglas5699.xml,80444/xv71832,8,13,11,32
"Booth (T. William) Photographs of Carl F. Gould's Architectural Work",wauboothwilliamphcoll427.xml,80444/xv69592,8,7,17,32
"Wright (John Dutton) Photograph Collection",wauwrightjohnduttonphcoll100.xml,80444/xv56356,7,14,11,32
"Goodwin (Arthur)",waugoodwinarthurfilmsphcoll835.xml,80444/xv88537,12,5,15,32
"Unknown",waudoublekmountainranchgooseprairiewash2133.xml,80444/xv97421,12,9,11,32
"University of Washington Trademarks and Licensing Office Records",wauuwresource00206.xml,80444/xv50974,9,10,13,32
"University of Washington Associate Vice President for Medical Affairs, Management & Finance and School of Medicine Associate Dean for Management & Administration Records",wauuwresource07708.xml,80444/xv02786,11,11,10,32
"Wehr (Wesley) Totem Pole Raising Ceremony Photographs",wautotempolephcoll609.xml,80444/xv29422,4,13,15,32
"Unknown",wauretailclerksinternationalprotectiveassociationlocalenumclawwash5402.xml,80444/xv02499,8,12,12,32
"Unknown",wauworkjohn4981.xml,80444/xv27307,5,10,17,32
"Unknown",wauhansonisabel2429.xml,80444/xv11480,7,3,22,32
"Unknown",waugoweylawton3908.xml,80444/xv95358,17,7,8,32
"Unknown",waukochcarlg3196.xml,80444/xv58425,8,6,18,32
"Abernathy (Ruth,)",wauabernathyruthua2474.xml,80444/xv33755,5,6,21,32
"University of Washington School of Public Health",wauuwresource00458.xml,80444/xv30114,14,8,10,32
"Waite (Alvin H.) Photographs",wauwaitephcoll291.xml,80444/xv73199,11,8,13,32
"Civil Works Administration and State of Washington Emergency Relief Administration",waucwaphcoll267.xml,80444/xv91943,12,13,7,32
"Unknown",waukeepwashingtongreenorganization0572.xml,80444/xv17422,12,14,5,31
"White (George)",wauwhitegeorgephotographalbumphcoll1227.xml,80444/xv53665,10,13,8,31
"Doig (Ivan)",waudoigivan3883.xml,80444/xv98135,11,6,14,31
"Curtis (Asahel) Klondike-Alaska Photograph Collection",waucurtisasahelklondikealaskaphcoll519.xml,80444/xv44982,9,12,10,31
"Skowronek Family Papers",wauskowronekfamily5849.xml,80444/xv50064,6,9,16,31
"<emph render="italic"> Our Trip to Mount Tacoma </emph>",wauourtriptomounttacomaphcoll647.xml,80444/xv18476,14,10,7,31
"Watkins (Carleton E.) Photographs",wauwatkinscarletonphcoll286.xml,80444/xv67449,12,9,10,31
"Ring Family Papers",wauringfamily4241.xml,80444/xv47888,12,6,13,31
"Unknown",waucentury21objects5662.xml,80444/xv19085,10,13,8,31
"Darbous (Nan) Boxer Rebellion Photograph Collection",waudarbousnanphcoll560.xml,80444/xv58029,8,9,14,31
"Arai (Clarence T.) papers",wauaraiclarencet5542.xml,80444/xv42837,7,11,13,31
"Unknown",wauhuppinceugene4063.xml,80444/xv79403,10,7,14,31
"Gorman (Robert "Bob") papers",waugormanrobert5710.xml,80444/xv48355,10,10,11,31
"Unknown",waugrouptheatrecompanyseattlewash4340.xml,80444/xv94635,4,13,14,31
"Unknown",waubryantalicefranklin1109.xml,80444/xv62619,8,13,10,31
"Unknown",waunelsonalbert1726.xml,80444/xv53283,8,10,13,31
"Purcell (Abbie Ann Stimson) Papers",waupurcellabbieannstimson5634.xml,80444/xv08450,8,11,12,31
"Moore (George N.) Photographs",waumooregeorgephcoll281.xml,80444/xv32781,10,12,9,31
"Jeff Stookey and Jesse Bernstein papers",waustookeyjeff5734.xml,80444/xv77133,11,6,14,31
"Smith (Joe) Papers",wausmithjoe252_1.xml,80444/xv27710,12,5,14,31
"Bartlett (Francis G.) Papers",waubartlettfrancisua5377.xml,80444/xv55517,1,8,22,31
"Unknown",wauuwresource00196.xml,80444/xv31896,5,14,12,31
"Freeland Colony (Whidbey Island, Wash.).",waufreelandcolony0889_2078.xml,80444/xv04238,7,15,9,31
"Thomas (Irv) Papers",wauthomasirv5722.xml,80444/xv75442,11,7,13,31
"Beattie (Curtis) Architectural Drawings",waubeattiecurtisph2010_018.xml,80444/xv92074,9,6,16,31
"Unknown",wauuwresource00368.xml,80444/xv43884,8,12,11,31
"Unknown",waucrislerlois2060.xml,80444/xv63159,8,11,12,31
"Unknown",waukingjohnnevin0312.xml,80444/xv98596,1,7,23,31
"Unknown",waubadermax5437.xml,80444/xv34674,5,8,18,31
"Bell (Allan)",waubellallanl1372_1419_1486.xml,80444/xv22106,9,6,16,31
"Nelsen (Ibsen A.) Collection",waunelsenibsenph2004_094.xml,80444/xv44952,11,8,12,31
"Bender (Clara Eichenwald) photograph collection",waubenderclaraeichenwaldphcoll1164.xml,80444/xv66677,11,5,15,31
"Squire (Watson C.) Photograph Collection",wausquirewatsonphcoll1230.xml,80444/xv15826,10,12,9,31
"Unknown",waucoalitionagainstoilpollution3599.xml,80444/xv41397,16,8,7,31
"Gorst (Vern C.) Photographs",waugorstphcoll810.xml,80444/xv66241,17,9,5,31
"H. David Kaplan Photograph Collection",waukaplandavidphcoll192.xml,80444/xv23709,8,9,14,31
"Unknown",wausephardicbikurholimcongregationseattlewash2389.xml,80444/xv19406,7,12,12,31
"University of Washington Publications",wauuwresource00134.xml,80444/xv93014,9,4,18,31
"Unknown",waubuchanancharlesmilton3907.xml,80444/xv71511,8,7,16,31
"Unknown",wauandersonbette2811.xml,80444/xv80175,8,8,15,31
"Moore (Margaret) photograph album",waumooremargaretphcoll1125.xml,80444/xv11889,8,10,13,31
"Miller (John Franklin) Photographs of",waumillerjohnfphcoll689.xml,80444/xv86596,11,9,11,31
"Unknown",wauseattlewashdeptofcommunitydevelopment2668.xml,80444/xv80279,9,8,14,31
"Unknown",waurobinsondwightua0851.xml,80444/xv59094,11,8,12,31
"Unknown",wausvenskaposten1298.xml,80444/xv75512,11,4,16,31
"Otsuka (Edward and Jeanette) film collection, 1946-1962",wauotsukaedwardandjeanettephcoll934.xml,80444/xv98361,24,5,2,31
"Pacific Northwest and Alaska Photographers Stereocard Collection",waustereocardphcoll031.xml,80444/xv16635,7,11,13,31
"Woolfe (Joe L.) Photograph Collection",wauwoolfejoelphcoll1091.xml,80444/xv37155,9,11,11,31
"Clark (Donald H.) Photograph Collection",wauclarkdonaldph2004_078.xml,80444/xv52606,5,12,14,31
"Unknown",wauwinbergandrew2699.xml,80444/xv25317,7,13,11,31
"Unknown",wauabbotttwymano3094.xml,80444/xv43078,7,6,18,31
"Unknown",wauhalfertyguypeter0133.xml,80444/xv18966,7,12,12,31
"Hazzard (George H.) Russian Railway Service Corps Photograph Albums",wauslavicdepartmentphcoll470.xml,80444/xv25067,10,10,11,31
"Unknown",waugranthowardfranklin4261.xml,80444/xv57131,14,6,11,31
"Corr (Michael William) collection",waucorrmichaelwilliam5733.xml,80444/xv08856,10,7,14,31
"Porter, Burt C. Sound Recordings",wau_waseumc2012.01.xml,80444/xv86273,5,10,16,31
"Parks (Norman) Papers",wauparksnorman5967.xml,80444/xv48416,4,10,16,30
"Dicks (Norman D.) Papers",waudicksnorm5823.xml,80444/xv16256,12,10,8,30
"Unknown",waugortlerjoshuah3665.xml,80444/xv42599,6,7,17,30
"Unknown",wauprattjohnf0039.xml,80444/xv32202,10,4,16,30
"Unknown",wauangelmarc2835.xml,80444/xv92651,7,4,19,30
"Graphic Communications International Union, Local 767M",waugraphiccommunicationsunionlocal767mphcoll1105.xml,80444/xv25296,9,10,11,30
"Fortin (F.) Walla Walla, Washington Photograph Collection",waufortinfwallawallaphcoll716.xml,80444/xv26698,19,5,6,30
"Unknown",waubnaibrithantidefamationleaguenorthwestregionaloffice2045.xml,80444/xv54522,9,10,11,30
"Unknown",wauwohlebandwohleb4242.xml,80444/xv81332,16,8,6,30
"Unknown",waubradfordjamese0945.xml,80444/xv03234,8,8,14,30
"Anti-Defamation League of B'nai B'rith photograph collection",wauantidefamationleaguephcoll1168.xml,80444/xv47424,8,8,14,30
"Spruce Production Division at Siemscarey, Washington",wausiemscareyphcoll405.xml,80444/xv25817,5,13,12,30
"Post (Austin) glacier and landforms photographs",waupostaustinphcoll0734.xml,80444/xv25207,5,16,9,30
"Barnes (Albert Henry) Photographs",waubarnesalberthenryphcoll542.xml,80444/xv76599,5,15,10,30
"Unknown",waumercerthomas4817.xml,80444/xv90161,16,10,4,30
"Black (John Cecil) papers",waublackjohncecil5470.xml,80444/xv37475,9,6,15,30
"Seattle Golf Club Photograph Collection",wauseattlegolfclubphcoll196.xml,80444/xv61568,10,3,17,30
"Fabbe (Harry) Papers",waufabbeharryviking2252_2.xml,80444/xv31129,11,9,10,30
"Unknown",wauseattleeducationassociation4217.xml,80444/xv81286,4,13,13,30
"Unknown",waumagnoliacommunityclubseattlewash4331.xml,80444/xv90771,12,6,12,30
"Todd (Calvin F.) Photographs",wautoddcfphcoll232.xml,80444/xv29669,12,11,7,30
"Unknown",wauwanamakerpearlanderson0987.xml,80444/xv37936,10,10,10,30
"Watson (Dwight Alvin) Photograph Collection",wauwatsondwightphcoll165.xml,80444/xv11795,5,13,12,30
"Newbill (James G.) Research Materials on Yakima Valley Labor History",waunewbilljames5258.xml,80444/xv89954,7,11,12,30
"Steinbrecher (Rosalie) Photograph Collection",wausteinbrecherrosaliephcoll1087.xml,80444/xv64108,5,11,14,30
"Schwabacher Family Photograph Collection",wauschwabacherfamilyphcoll1083.xml,80444/xv61047,7,11,12,30
"Seattle Repertory Theatre Photograph Collection",wauseattlerepertorytheatreiiphcoll576.xml,80444/xv76553,2,7,21,30
"Winter and Pond Photographs",wauwinterandpondphcoll308.xml,80444/xv24096,3,16,11,30
"Callahan (Margaret Bundy) papers",waucallahanmargaretbundy5865.xml,80444/xv88497,8,8,14,30
"Unknown",waufullerricharde2039.xml,80444/xv83636,7,12,11,30
"Unknown",wauhandsoffwashington_kitsapcoalition5335.xml,80444/xv47891,14,4,12,30
"Green Lake Gun Club Records",waugreenlakegunclub3871_1.xml,80444/xv19844,6,8,16,30
"University of Washington Department of Military Science Records",wauuwresource00121.xml,80444/xv76276,7,7,16,30
"Randlett (Mary) Artist Photographs",waurandlettmaryiiiphcoll422.xml,80444/xv77392,10,7,13,30
"Curtis (George) Photograph Collection",waucurtisgeorgephcoll590.xml,80444/xv65475,4,6,20,30
"Unknown",waumountaineerssocietyclimbingcommittee1838.xml,80444/xv60070,9,5,16,30
"Gowey (Lawton) Street Railways Photograph Collection",waugoweylawtonphcoll209.xml,80444/xv41680,7,12,11,30
"Unknown",waustimsonemmab5115.xml,80444/xv12533,5,9,16,30
"Unknown",wauinternationaltypographicalunion5370.xml,80444/xv80072,13,8,9,30
"Bradley (Levi) Photograph Collection",waubradleyleviphcoll359.xml,80444/xv33435,3,17,10,30
"Savan (Jean Singer) photograph collection",wausavanjeansingerphcoll1171.xml,80444/xv14242,9,14,7,30
"Unknown",waulaunderarthuri3843.xml,80444/xv85717,7,8,15,30
"Grand Coulee Dam Photograph Collection",waugrandcouleedamphcoll478.xml,80444/xv76470,8,9,13,30
"University of Washington Tyee Collection Collection",wauuwresource00159.xml,80444/xv74565,7,7,15,29
"Puget Mill Company (Webster and Stevens) Photograph Collection",wauwebsterstevenspugetmillcophcoll1030.xml,80444/xv65765,7,8,14,29
"Mensalvas (Chris) family photograph collection",waumensalvaschrisphcoll1145.xml,80444/xv63125,5,10,14,29
"Unknown",wauiversonstanleyo1884.xml,80444/xv69076,11,6,12,29
"Burgess (Jessie Hugh)",wauburgessfamilyfilmsphcoll1260.xml,80444/xv54953,9,7,13,29
"Unknown",wauloskeva3174.xml,80444/xv02532,18,4,7,29
"Unknown",waudeutschevaesfeld2498.xml,80444/xv30059,6,6,17,29
"Langton (Basil) Collection of Photographs of Mark Tobey",waulangtonbasilphcoll790.xml,80444/xv66897,9,9,11,29
"Unknown",wauballainejohne0498.xml,80444/xv91778,11,5,13,29
"Boland (Marvin D.) Photographs of Tacoma, Washington",waubolandmarvinphcoll730.xml,80444/xv01449,11,12,6,29
"Unknown",waumountaineerssocietyadministrativedivision2885.xml,80444/xv24816,11,6,12,29
"Davis (Dan) mountain photograph collection",waudavisdanmountainphcoll1238.xml,80444/xv88388,0,17,12,29
"Unknown",waujenkinsfrank1964.xml,80444/xv91159,6,10,13,29
"Unknown",wauwashingtonstatenursesassociation1385_1559_1807_1937.xml,80444/xv63748,9,7,13,29
"Washington State FERA Projects Photograph Collection",wauferaphcoll263.xml,80444/xv47640,5,4,20,29
"Archibald (John G.)",wauarchibaldjohngph2014_009.xml,80444/xv94644,5,6,18,29
"Owen (Phyllis) A Snapshot Diary of the Owens Photograph Album",wauowenphyllisphcoll811.xml,80444/xv58657,12,10,7,29
"Unknown",wauwashingtoncongressofparentsandteachersseattlecouncilseattlewash3421.xml,80444/xv85821,5,12,12,29
"Lonsdale (Adrian L.) Collection on Northwest Rum-Running",waulonsdaleadrianl5633.xml,80444/xv00302,17,7,5,29
"Curtis (Asahel) Lantern Slides",waucurtisasahellanternslidesphcoll407.xml,80444/xv53485,5,12,12,29
"Alaska-Yukon-Pacific Exposition (1909 : Seattle, Wash.).",waualaskayukonpacificexposition0296.xml,80444/xv61657,3,9,17,29
"Unknown",wausanfordmarvin0278.xml,80444/xv67776,11,7,11,29
"Adams (Hazard,)",wauadamshazardua4501.xml,80444/xv87567,2,6,21,29
"Towne (Bertram C.) Photographs",wautownebertramphcoll502.xml,80444/xv78327,10,10,9,29
"Halferty (Damon and Barbara) Photograph Collection",wauhalfertydamonbarbaraphcoll724.xml,80444/xv61712,19,5,5,29
"Clark (Irving)",wauclarkirvingmsr0273.xml,80444/xv24227,8,15,6,29
"Nowell (Frank H.) Photographs",waunowellfrankhphcoll316.xml,80444/xv75506,9,9,11,29
"Markel (Hazel) Photograph Collection",waumarkelhazelphcoll460.xml,80444/xv30062,10,8,11,29
"Northwest Craft Center records",waunorthwestcraftcenter5678.xml,80444/xv70095,8,13,8,29
"Unknown",waurosenbaummildredandharold5273.xml,80444/xv64624,5,9,15,29
"Erikson (Patricia)",waueriksonpatriciapierce2696-110.xml,80444/xv95303,7,11,11,29
"Sherwin (Marie) Photograph Collection",wausherwinmariephcoll726.xml,80444/xv82745,14,3,12,29
"Magnusson (Carl Edward) Photograph Collection",waumagnussoncarlphcoll648.xml,80444/xv15719,12,11,6,29
"Unknown",wauaeschlimanralph2812.xml,80444/xv30230,9,8,12,29
"Rucker (Helen) Photograph Collection",wauruckerhelenphcoll1082.xml,80444/xv00936,12,9,8,29
"Allen (Raymond B.) Photographs of",wauraymondballenphcoll845.xml,80444/xv12750,15,6,8,29
"Jacobsen (John T.) Architectural Drawings and Other Material",waujacobsenjohntphcoll549.xml,80444/xv95346,11,5,13,29
"Unknown",waukilgrenedith2605.xml,80444/xv41421,5,6,18,29
"Fine Arts Study Club Records",waufineartsstudyclub3955.xml,80444/xv44708,10,7,12,29
"Harstine Island Photograph Album",wauharstineislandphcoll817.xml,80444/xv11160,15,6,8,29
"Bowman (Elizabeth)",waubowmanelizabeth1835.xml,80444/xv92633,3,20,6,29
"Dootson Family Papers",waudootsonfamily5885.xml,80444/xv13024,13,3,13,29
"Penn Mining Company Photograph Collection",waupennminingcompanyphcoll013.xml,80444/xv74078,9,9,11,29
"Frey (Lawrence E.) University of Washington Photographs",waufreylawrenceuwphcoll556.xml,80444/xv07876,8,9,12,29
"Unknown",waugottleibchaim3160.xml,80444/xv88891,11,10,8,29
"Robinson (John)",waurobinsonjohns5319.xml,80444/xv84078,4,6,19,29
"Bolotin (Ruth) photograph collection",waubolotinruthphcoll1152.xml,80444/xv51934,12,8,9,29
"University of Washington Libraries Records",wauuwresource02570.xml,80444/xv43206,9,9,11,29
"Merritt Family Papers",waumerrittfamily5863.xml,80444/xv03585,11,8,10,29
"Unknown",wauwashingtonmillcompany1005_3257.xml,80444/xv42193,8,5,16,29
"Unknown",waulittellnormanm4419.xml,80444/xv17004,8,7,14,29
"WWAMI Center for Health Workforce Studies Records",wauuwresource06533.xml,80444/xv44738,7,13,9,29
"Unknown",wautripfromnomephcoll492.xml,80444/xv19161,8,3,18,29
"Rind (Martin) Photograph Collection",waurindmartinphcoll748.xml,80444/xv41928,9,8,12,29
"Fujita Family Photograph Collection",waufujitafamilyphcoll186.xml,80444/xv28736,8,10,10,28
"Valenza (Roberto) Papers",wauvalenzaroberto5775.xml,80444/xv11932,10,9,9,28
"Hunn (Eugene) papers",wauhunneugenes2696-006.xml,80444/xv04312,9,8,11,28
"University of Washington School of Nursing Records",wauuwresource00418.xml,80444/xv51028,4,3,21,28
"Estes (William Edwin, III)",wauesteswilliamedwin5864.xml,80444/xv65567,3,4,21,28
"University of Washington. Extension.",wauuwresource00530.xml,80444/xv64733,6,6,16,28
"Lewis (Carl) Photographs of Grand Coulee Schools",waulewisgrandcouleeschoolsphcoll1328.xml,80444/xv99438,11,4,13,28
"Takahashi (Charles Theodore) Papers",wautakahashicharles3542_3542_2.xml,80444/xv55755,13,4,11,28
"Collins (Dorothy Castonia)",waucollinsdorothycastonia5858.xml,80444/xv43981,14,2,12,28
"Unknown",waubenezrasarahberro2793.xml,80444/xv36535,7,9,12,28
"Dickey (William Andrews) family",waudickeyfamily0460.xml,80444/xv98382,6,5,17,28
"Unknown",waubarnettpowells0721.xml,80444/xv18197,7,11,10,28
"Unknown",wauflukejohnm2341.xml,80444/xv93005,7,9,12,28
"Unknown",wauforumfoundationgreaterseattlecitizencouncilornetworkproject5096.xml,80444/xv01226,7,9,12,28
"Unknown",waufrancoalbertm2834.xml,80444/xv13281,8,9,11,28
"Unknown",waubeckeleanornordhoff0629.xml,80444/xv62521,11,7,10,28
"Butcher (Jeffrey Lee) Photograph Album",waubutcherjeffphcoll348.xml,80444/xv36618,6,8,14,28
"Forsythe (Lawrence F.) Actors and Movies Photograph Collection",wauforsythelawrencefphcoll245.xml,80444/xv21517,9,8,11,28
"Unknown",wauyoungmanalbertn3583.xml,80444/xv33160,7,7,14,28
"Prottas (Sam) Photograph Collection",wauprottassamphcoll883.xml,80444/xv47598,7,6,15,28
"Pedersen (Elfrida) Photograph Collection",waupedersenelfridaphcoll435.xml,80444/xv58578,11,7,10,28
"Douglas (Malcolm) Photograph Collection",waudouglasmalcolmphcoll713.xml,80444/xv80883,11,8,9,28
"Miller (Charles B.) Photograph Collection",waumillercharlesbphcoll154.xml,80444/xv82537,8,8,12,28
"Goodlad (John I.) papers",waugoodladjohniua4282.xml,80444/xv06942,7,11,10,28
"Unknown",waubaptistmissionarychildrenshomeassociationofthepacificcoast4604.xml,80444/xv61087,6,9,13,28
"King (W. Ivan) Photographs",waukingwivanph2009_019.xml,80444/xv21395,12,4,12,28
"Pickett (Lee) Photographs",waupickettleephcoll580.xml,80444/xv32824,11,10,7,28
"Unknown",waupylerobertmichael3293.xml,80444/xv50390,12,7,9,28
"Unknown",waudouglasmalcolm1045.xml,80444/xv35955,6,7,15,28
"Lindsley (Lawrence D.) Photograph Collection",waulindsleyphcoll548.xml,80444/xv50848,4,8,16,28
"Unknown",waucentralbaptistchurchseattlewash0617.xml,80444/xv17953,14,8,6,28
"Ground Zero Center for Nonviolent Action Visual Materials Collection",waugroundzeroph2004_054.xml,80444/xv08886,5,10,13,28
"Hudson (Leonard)",wauhudsonleonarddua4152.xml,80444/xv37210,11,7,10,28
"Unknown",waulitchmanmarkl1244.xml,80444/xv80697,3,13,12,28
"Unknown",waugoldenben5085.xml,80444/xv79754,8,8,12,28
"Unknown",wauhenryhoracec1420.xml,80444/xv54373,10,5,13,28
"Unknown",waunoreliuseric3571.xml,80444/xv16201,8,11,9,28
"Plumb (Herbert L.) Photograph Collection",wauplumbherbertlphcoll436.xml,80444/xv69927,7,6,15,28
"Riaboff (Alexander) Papers",wauriaboffalexander5555.xml,80444/xv06851,11,10,7,28
"Unknown",waupollharold2579.xml,80444/xv76354,6,7,15,28
"Unknown",waurogelannlee5443.xml,80444/xv38354,7,5,16,28
"Unknown",waukilbourneedwardcorliss0184.xml,80444/xv53500,7,8,13,28
"Mantle Club. Seattle District No. 3.",waumantleclubseattledistrictno3_5218.xml,80444/xv93920,7,8,13,28
"Unknown",wauissaquahalpstrailsclub5042.xml,80444/xv72488,10,11,7,28
"Kingston (Deanna)",waukingstondeannam2696-105.xml,80444/xv24566,7,9,12,28
"Gerberding (William)",waugerberdingwilliampua4500.xml,80444/xv45126,11,7,10,28
"Committee on Modernization of Electric Transportation (COMET) Records",waucomet5179_1.xml,80444/xv38313,9,6,13,28
"Haydon (John M.) Papers",wauhaydonjohnm3467_1.xml,80444/xv22922,7,12,9,28
"Alexander (Lavinia)",waualexanderlavinia3416-001.xml,80444/xv93936,9,9,10,28
"Douglas (James) Papers",waudouglasjames5906.xml,80444/xv59133,10,9,9,28
"Silverman (Goldie) papers",wausilvermangoldie5857.xml,80444/xv15451,9,9,10,28
"Unknown",waufisherrobertl4249.xml,80444/xv42764,8,11,9,28
"Hagenstein (William D) Papers",wauhagensteinwilliamd5853.xml,80444/xv74603,7,8,13,28
"Larss and Duclos Photographs",waularssandduclosphcoll306.xml,80444/xv09799,7,7,14,28
"Butler (Nicholas)",waubutlernicholasmurrayua2926.xml,80444/xv71170,8,10,10,28
"Markus (Andrew L.) Papers",wauua19_10_4541markusandrewl.xml,80444/xv64653,7,8,13,28
"Randall (Edwin) Photographs",waurandalledwinphcoll250.xml,80444/xv17990,8,8,12,28
"Unknown",wauinverarityrobertbruce4445.xml,80444/xv07571,7,8,13,28
"Unknown",waureiflerhenrietta3696.xml,80444/xv18338,4,12,12,28
"Unknown",waubauerwolfg1669.xml,80444/xv82183,3,11,14,28
"Benham (Allen)",waubenhamallenrogersua0190.xml,80444/xv76147,11,10,7,28
"Unknown",waufockeanne2846.xml,80444/xv66751,11,12,5,28
"Flaherty (James E.) Papers",wauflahertyjames5436.xml,80444/xv11053,8,12,8,28
"Unknown",waurobertsonjackb3587.xml,80444/xv38998,9,5,14,28
"Unknown",waubookermargaret5196.xml,80444/xv01220,9,10,9,28
"Clevenger (Mark)",wauclevengermarktua2504.xml,80444/xv84069,7,11,10,28
"Unknown",waumoranrobert0859.xml,80444/xv37902,6,9,12,27
"Unknown",waubrenneritsey3934.xml,80444/xv01885,6,7,14,27
"Unknown",waupowellmildredt1829.xml,80444/xv12490,9,9,9,27
"Bent (George Eben) Photograph Collection",waubentgeorgephcoll133.xml,80444/xv25372,3,8,16,27
"Unknown",wauslateramos0596.xml,80444/xv49307,13,6,8,27
"Unknown",waucolehazel3578.xml,80444/xv54357,10,4,13,27
"Elliot (Thompson) Moran School album",wauelliotthompsonmoranschoolalbumphcoll1212.xml,80444/xv08081,12,5,10,27
"University of Washington School of Medicine, Associate Dean for Clinical Affairs Records",wauua27_01_18uwassociatedeanclinicalaffairs.xml,80444/xv78402,12,2,13,27
"Crowley (Walt) Papers",waucrowleywalt5573.xml,80444/xv48315,7,15,5,27
"Unknown",wauobrienjohnlawrence1580.xml,80444/xv71762,8,4,15,27
"Hemphill (Cynthia Flash) papers",wauhemphillcynthiaflash5793.xml,80444/xv41897,10,7,10,27
"Unknown",waubrownandrewanphin1446.xml,80444/xv50131,8,10,9,27
"Blair (John)",waublairjohnsua3314.xml,80444/xv76882,14,6,7,27
"Unknown",wauintllongshoremensandwarehousemensunionlocal9_5809.xml,80444/xv19238,13,5,9,27
"Unknown",waubuyagawanapoloniok2263.xml,80444/xv46347,4,9,14,27
"Unknown",waucrislerherb3852.xml,80444/xv51214,3,6,18,27
"Ayer (Leslie)",wauayerlesliejua0583.xml,80444/xv04992,4,10,13,27
"Unknown",waumagnusondonaldhammer0293.xml,80444/xv36950,12,7,8,27
"Lambda Rho Alumni Association Records",waulambdarhoalumniassociation4168.xml,80444/xv06732,7,8,12,27
"Isaacs (Walter F.) Papers",wauisaacswalterfua1030.xml,80444/xv71374,9,10,8,27
"Pedersen (Elfrida J.) Papers",waupedersenelfrida2227_1.xml,80444/xv98164,6,8,13,27
"Boyd (William F.) Photograph Album",wauboydwilliamfphcoll034.xml,80444/xv16348,8,11,8,27
"Unknown",wauuwresource00261.xml,80444/xv33526,5,6,16,27
"Unknown",waumountaineerssocietyhistorycommittee5038.xml,80444/xv08779,8,13,6,27
"Ryan (Eileen A.) papers",wauryaneileena5593.xml,80444/xv71795,6,8,13,27
"Unknown",waucuffewilliam0515.xml,80444/xv06359,8,7,12,27
"Peace Movement Posters",waupeacemovementposters5781.xml,80444/xv85284,3,13,11,27
"Unknown",wauanchesirving3219.xml,80444/xv13113,8,7,12,27
"Hatten, C.T. (Barry) Papers",wauhattencanterburytheodore5583.xml,80444/xv42459,5,6,16,27
"Unknown",waubenezrajosephn4187.xml,80444/xv09628,6,5,16,27
"Sund (Robert) Papers",wausundrobert5740.xml,80444/xv02612,9,7,11,27
"Adams (Mary)",wauadamsmarye1165.xml,80444/xv86053,6,4,17,27
"Hadley (Eleanor)",wauhadleyeleanormua5289.xml,80444/xv45904,5,8,14,27
"Unknown",waubraceblanche2971.xml,80444/xv20056,14,6,7,27
"Bonneville,.",waubonneville3109.xml,80444/xv85922,12,9,6,27
"Unknown",wauscottrobertc0579.xml,80444/xv49269,8,6,13,27
"Engineering Students' Council (University of Washington).",wauengineeringstudentscouncil4314.xml,80444/xv13162,7,12,8,27
"Chase (Sgt. Ruby)",wauchasesgtrubyphcoll1300.xml,80444/xv81655,10,11,6,27
"Unknown",waublumenthalhelenberkman2121.xml,80444/xv10086,11,7,9,27
"Unknown",waunordeenjohn1668.xml,80444/xv25076,5,8,14,27
"Association of College and Research Libraries, Washington State Chapter Records",wauassociationofcollegeandresearchlibrarieswashingtonstatechapter4404.xml,80444/xv93887,10,6,11,27
"Unknown",waustarincaroloseran3991.xml,80444/xv98403,12,2,13,27
"Gerdts (Donna B.) Papers",waugerdtsdonnab2696-019.xml,80444/xv74829,7,13,7,27
"University of Washington, Department of Bioengineering Records",wauuwresource00403.xml,80444/xv18243,10,10,7,27
"Unknown",waubergmanfredh2975.xml,80444/xv13455,6,5,16,27
"Unknown",wauhuffhenryp1499.xml,80444/xv71051,11,7,9,27
"Unknown",waufrederickdonalde1296.xml,80444/xv66549,11,6,10,27
"Unknown",waucommissiononfreedomofthepress0078.xml,80444/xv55416,10,5,12,27
"Savage (George A.) and Pulsipher (Catherine Savage) Papers",wausavagegeorgea5405.xml,80444/xv86539,6,11,10,27
"Unknown",waupeaceactionofwash5795.xml,80444/xv51190,15,5,7,27
"Pease (Otis) Papers",waupeaseotisaua5595.xml,80444/xv90621,8,7,12,27
"Unknown",waucivilianconservationcorpsphcoll1264.xml,80444/xv70407,6,12,9,27
"Unknown",waulawrencecorajane1711.xml,80444/xv78875,12,8,7,27
"American Loyalty League.",wauamericanloyaltyleague1735.xml,80444/xv49340,5,7,15,27
"Gowen (Herbert)",waugowenherberthua1561_3016.xml,80444/xv98342,8,5,14,27
"Chisholm (Margaret E.) Papers",wauchisholmmargareteua4507.xml,80444/xv22598,5,7,15,27
"Arons (A. B.) Papers",wauaronsarnoldua5380.xml,80444/xv70364,7,6,14,27
"Elam (James L.)",wauelamjameslua5843.xml,80444/xv35754,9,7,11,27
"Gray (Florence) papers",waugrayflorenceua5767.xml,80444/xv30484,14,5,8,27
"Unknown",wauthomasedwardb2863.xml,80444/xv51589,9,6,12,27
"Washington State PTA Records",wauwashingtoncongressofparentsandteachers2226.xml,80444/xv70150,7,9,11,27
"Matsumoto (T.T.) Album of Architecture Photographs",waumatsumotophcoll019.xml,80444/xv85317,11,8,8,27
"Crowell (Laura)",waucrowelllauraiua4484.xml,80444/xv32757,5,7,15,27
"Unknown",wauofferharoldb2469.xml,80444/xv93270,9,9,9,27
"Hilen (Andrew)",wauhilenandrewrua1844.xml,80444/xv29986,7,14,6,27
"Prosch (Thomas) Washington Views Photograph Album",wauproschwashingtonviewsphcoll28.xml,80444/xv15274,11,10,6,27
"Unknown",waustrawndorothyua4550_1.xml,80444/xv61912,12,7,8,27
"Unknown",wauminerluella1090.xml,80444/xv43627,9,10,8,27
"Aronin (Zerline) Photograph Collection",wauaroninzerlinephcoll1053.xml,80444/xv30303,3,9,15,27
"Ames (Edwin Garner) Photograph Albums",wauamesedwingphcoll205.xml,80444/xv42684,6,8,13,27
"Balint (Judy) Photograph Collection",waubalintjudyphcoll1054.xml,80444/xv27999,10,6,10,26
"Unknown",waubutlerhenry5339.xml,80444/xv35491,9,10,7,26
"University of Washington School of Medicine, Alumni Association records",wauuwresource00380.xml,80444/xv25552,10,7,9,26
"Unknown",waudaiberome3592.xml,80444/xv85031,6,9,11,26
"Hills (Liston F.) Home Movies",wauhillslistonfphcoll819.xml,80444/xv82757,13,4,9,26
"Dabney Family Photograph Collection",waudabneyfamilyph2009_008.xml,80444/xv89062,6,3,17,26
"University of Washington Theaters Photograph Collection",wauuniversityofwashingtontheatersphcoll236.xml,80444/xv24475,8,9,9,26
"Collier (Herbert L.) photograph collection",waucollierherbertlphcoll1157.xml,80444/xv09008,10,4,12,26
"Unknown",wauamericanfederationofteacherslocal1690edmonds5890.xml,80444/xv22424,8,7,11,26
"Cohen (Joseph)",waucohenjoseph2116.xml,80444/xv32720,9,7,10,26
"Azose (Isaac) Oral History",wauazoseisaac5867.xml,80444/xv84527,7,2,17,26
"Seattle Women's Ensemble Photograph Collection",wauseattlewomensensemblephcoll626.xml,80444/xv24634,10,12,4,26
"Meisnest (Darwin) Photograph Collection",waumeisnestdarwinphcoll82.xml,80444/xv43102,5,9,12,26
"Claridge and Whipple Family Album",wauclaridgewhipplefamilyalbumphcoll1206.xml,80444/xv52630,10,6,10,26
"Unknown",waulagawierarthur2671.xml,80444/xv89694,4,6,16,26
"Unknown",waugouldchampneyarchitects3515.xml,80444/xv55111,11,6,9,26
"Friedman (Henry) Photograph Collection",waufriedmanhenryphcoll1067.xml,80444/xv16152,12,9,5,26
"Damm (Peter M.)",waudammpeterm5836.xml,80444/xv28692,9,8,9,26
"Odegaard (Charles E.) papers",wauodegaardcharleseua2380.xml,80444/xv10797,6,10,10,26
"University of Washington Health Policy Analysis Program Records",wauuwresource04191.xml,80444/xv77309,10,9,7,26
"Unknown",waucommoncauseus3021.xml,80444/xv13934,4,9,13,26
"Michaelson (Mary E.) Photograph Collection",waumichaelsonmaryephcoll579.xml,80444/xv46826,5,10,11,26
"Unknown",waupriceted5249.xml,80444/xv19430,4,10,12,26
"Unknown",wauphillipsws0511.xml,80444/xv31732,5,8,13,26
"University of Washington Engineering Experiment Station Collection of Tacoma Narrows Bridge Photographs and Ephemera",wauuniversityofwashingtonengineeringexperimentstationphcoll290.xml,80444/xv77728,11,6,9,26
"Buckner (Fannie Marylander) Papers",waubucknerfanniemarylander5899.xml,80444/xv89596,9,7,10,26
"Elliott (Thompson Baker) Moran School Album",wauelliottthompsonbph2009_044.xml,80444/xv14801,7,10,9,26
"Hartmann and Weinland Inuit Photographs",wauhartmannweinlandphcoll319.xml,80444/xv55072,10,6,10,26
"Woodhouse (R. Y.)",wauwoodhousery5721.xml,80444/xv64132,3,9,14,26
"Unknown",waugoulddorothyfay3172.xml,80444/xv96844,6,10,10,26
"Rader (Melvin)",wauradermelvinua5839.xml,80444/xv47656,8,10,8,26
"Hilen Longellow Collection",wauhilenlongellowcollection1817.xml,80444/xv67074,5,6,15,26
"Unknown",waucitizensforreturnablebeveragecontainers3985.xml,80444/xv65472,4,7,15,26
"Seattle Fire Album",wauseattlefirealbumphcoll26.xml,80444/xv55079,7,11,8,26
"Edson (Norman)",wauedsonnorman0884_1517.xml,80444/xv16970,6,9,11,26
"Unknown",waubementdouglas4607.xml,80444/xv14868,4,8,14,26
"LaViolette (Forrest E.) Slides and Photographs",waulaviolettephcoll522.xml,80444/xv42417,11,5,10,26
"Unknown",waupalmercokingcoalcompanyblackdiamondwash5424.xml,80444/xv23150,7,10,9,26
"Unknown",wauwolfhazel3647.xml,80444/xv56692,9,2,15,26
"Stern (Robert F.) Papers",wausternrobertf5528.xml,80444/xv94982,8,12,6,26
"Dobbs (Beverly Bennett) Alaska-Yukon-Pacific Exposition Photographs",waudobbsaypephcoll755.xml,80444/xv61111,10,6,10,26
"Takayoshi (Henry Sukezo) Photographs",wautakayoshihenrysukezophcoll440.xml,80444/xv36233,15,5,6,26
"Unknown",wausimerjeremy5142.xml,80444/xv71514,10,7,9,26
"Brenner (Charles) Papers",waubrennercharles5909.xml,80444/xv26882,6,5,15,26
"Alaska Midland Railway Photograph Album",waualaskamidlandrailwayphcoll230.xml,80444/xv02648,10,8,8,26
"University of Washington School of Social Work Dean",wauuwresource00436.xml,80444/xv58529,10,6,10,26
"Thomson (Reginald H. Album)",wauthomsonreginaldhphcoll043.xml,80444/xv74411,7,7,12,26
"Bohan (Antonai) 1995 AFL-CIO Convention Delegate Collection",waubohanantoniak5579.xml,80444/xv03955,7,10,9,26
"Unknown",wauenglesharold2006.xml,80444/xv41586,9,6,11,26
"University of Washington Metropolitan Tract Office",wauuwresource07728.xml,80444/xv76107,5,4,17,26
"Todd Shipyards film<emph render="italic"> Fighting Ships for Fighting Men </emph>",wautoddshipyardsfilmphcoll968.xml,80444/xv23663,11,3,12,26
"Unknown",wauhanfordch1512.xml,80444/xv67129,5,9,12,26
"Unknown",waucohoneleanor2523.xml,80444/xv11868,4,9,13,26
"Arthur and Elizabeth Schlesinger Library on the History of Women in America. Black Women Oral History Project.",wauarthurandelizabethschlesingerlibraryonthehistoryofwomeninamericablackwomenoralhistoryproject3084.xml,80444/xv34408,6,10,10,26
"Dyer (Polly)",waudyerpolly3258.xml,80444/xv01840,5,7,14,26
"Fox (Jay) Photograph Collection",waufoxjayphcoll189.xml,80444/xv05911,2,8,16,26
"Reiter (Suzanne Weisfeld) Photograph Collection",waureitersuzanneweisfeldphcoll1080.xml,80444/xv21673,9,6,11,26
"Devin (William)",waudevinwilliamf0234_1610_2035.xml,80444/xv10205,3,8,15,26
"Unknown",wauvarsityboatclubua3368.xml,80444/xv52105,7,6,13,26
"Unknown",wauallenjohnbeard4688.xml,80444/xv01962,6,5,15,26
"Unknown",wausierraclubpugetsoundgroup3249.xml,80444/xv42361,10,8,8,26
"Pillsbury (Arthur Clarence) Photographs",waupillsburyarthurclarencephcoll331.xml,80444/xv81817,9,7,10,26
"Unknown",wauamccancerresearchcenterandhospitaldenvercoloseattleladiesauxiliary2293.xml,80444/xv10040,9,9,8,26
"Seattle Civil Rights and Labor History Project Records",wauseattlecivilrightsandlaborhistoryproject5571.xml,80444/xv12048,7,9,10,26
"Dose Family Photograph Collection",waudosefamilyphcoll353.xml,80444/xv96401,11,4,11,26
"Penny, (Prudence) recipe cards",waupennyprudence5878.xml,80444/xv55093,8,9,9,26
"Hatch (Melville)",wauhatchmelvilleharrisonua2374.xml,80444/xv37390,6,10,10,26
"Liddle (Alan) Papers",wauliddlealan5883.xml,80444/xv75802,11,5,10,26
"Cole (Geraldine V.)",waucolegeraldinev5873.xml,80444/xv48901,7,2,17,26
"Wightman (Roberta A.) Landscape Architecture Drawings",wauwightmanrobertaph2010_009.xml,80444/xv35617,12,10,4,26
"Unknown",wauuwresource07329.xml,80444/xv89105,9,10,7,26
"Unknown",waumcmahontheresaschmidua0110.xml,80444/xv02810,9,7,10,26
"Lushington (Beatrice Roethke) Photograph Collection",waulushingtonbeatriceroethkephcoll198.xml,80444/xv05490,3,5,18,26
"Unknown",waukazamadonaldd2012.xml,80444/xv97357,5,5,16,26
"Unknown",wauclassicalassociationofpacificnorthwest5904.xml,80444/xv07376,6,5,15,26
"Unknown",wauwillnerina5284.xml,80444/xv68484,4,4,17,25
"Unknown",wauphrateresbetachapter5412.xml,80444/xv67681,7,7,11,25
"Unknown",wauhanfordlitigationoffice5911.xml,80444/xv53143,3,10,12,25
"George (Earl) Papers and Photographs",waugeorgeearl5910.xml,80444/xv87622,9,6,10,25
"Historic American Buildings Survey No. WA-213 (Henry Art Gallery) Collection",wauhenryartgalleryphcoll623.xml,80444/xv92007,4,6,15,25
"Bureau of Reclamation Grand Coulee Dam Construction Photographs",waubureaureclamationcouleedamph2008_33.xml,80444/xv98092,5,8,12,25
"Svare (Richard) Papers",wausvarerichard5557.xml,80444/xv16836,8,6,11,25
"Unknown",waucalvosema1938.xml,80444/xv33947,3,6,16,25
"Unknown",wauandrewsclarenceleroy4797.xml,80444/xv49664,5,9,11,25
"Unknown",wauschwabacherfamily2149.xml,80444/xv82794,10,8,7,25
"Bates (Matthew C.) papers",waubatesmatthewc5782.xml,80444/xv82025,8,7,10,25
"Kleinberg Family Photograph Collection",waukleinbergfamilyphcoll1075.xml,80444/xv64352,6,8,11,25
"American Plywood Association Little Diomede Island Health Center Construction photograph collection",waulittlediomedeislandphcoll843.xml,80444/xv54998,9,9,7,25
"Houghton (E.W.) Architectural Drawings for the Kellogg Family Residences",wauewhoughtonphcoll842.xml,80444/xv78274,10,8,7,25
"Keystone Stereocard Collection",waukeystonestereocardsphcoll372.xml,80444/xv37652,13,6,6,25
"Unknown",waukrausefayetteflorent2217.xml,80444/xv58895,3,2,20,25
"Unknown",wausamuelgomperscentennialcommittee4655.xml,80444/xv85269,12,5,8,25
"Day With a Forest Industry Photograph Album",wauforestindustryalbumphcoll709.xml,80444/xv87227,10,7,8,25
"Unknown",waucalvofortuna2794.xml,80444/xv30816,8,5,12,25
"Sesnon Family Photograph Collection",wausesnonjohnphcoll1240.xml,80444/xv07742,8,13,4,25
"King County (Wash.). County Assessor.",waukingcountyassessor1905_2612.xml,80444/xv31121,7,5,13,25
"Nelson (Lonnie) Papers",waunelsonlonnie5826.xml,80444/xv15283,8,10,7,25
"University of Washington College of Fisheries.",wauuwresource00448.xml,80444/xv64559,10,8,7,25
"Unknown",waumountaineerssocietyconservationdivision2886.xml,80444/xv80206,4,8,13,25
"Unknown",wauseattlechamberofcommercearmypostcommittee4631.xml,80444/xv75051,5,10,10,25
"Cress (John D.) Lumber Industry Photographs",waucressjohndphcoll431.xml,80444/xv34924,5,8,12,25
"Alhadeff (Kenneth) papers",waualhadeffkenneth5761.xml,80444/xv28460,7,6,12,25
"Ivey (Edwin) P.K. Leberman Residence Architectural Drawings",waulebermanresidencephcoll841.xml,80444/xv02954,7,7,11,25
"Unknown",wauwhitecarriem4964.xml,80444/xv65017,8,4,13,25
"Zenk (Henry Benjamin) papers",wauzenkhenrybenjamin2696_041.xml,80444/xv84057,4,13,8,25
"Unknown",waubluechelalan3598.xml,80444/xv28134,6,4,15,25
"Unknown",wausamethstella2254.xml,80444/xv41241,8,6,11,25
"Unknown",wauroethkebeatrice4538.xml,80444/xv75762,3,4,18,25
"Caldwell (Liz) Papers",waucaldwellliz3658.xml,80444/xv44474,9,4,12,25
"Unknown",wauhayesben2650.xml,80444/xv27774,12,6,7,25
"McBride Studio Photographs",waumcbridestudiophcoll551.xml,80444/xv21417,9,8,8,25
"Unknown",waudowntownseattledevelopmentassociationseattlewash2653.xml,80444/xv45880,6,6,13,25
"Escalona (Daniel) Alaska Cannery Photographs",wauescalonadanielph2016_005.xml,80444/xv27017,9,10,6,25
"Gibson (Harold J.)",waugibsonharoldj5866.xml,80444/xv72970,6,9,10,25
"B'nai B'rith Girls. Seattle Chapter.",waubnaibrithgirlsseattlechapter5315.xml,80444/xv88827,5,10,10,25
"Burke (William)",wauburkewilliamtua3101.xml,80444/xv15142,12,5,8,25
"University of Washington College of Fisheries Album",wauuwcollegeoffisheriesphcoll202.xml,80444/xv46441,9,11,5,25
"Bulosan (Carlos) Photograph Collection",waubulosancarlosphcoll1156.xml,80444/xv35046,11,4,10,25
"Arai (Clarence T.) Photographs",wauaraiclarenceph2010_008.xml,80444/xv25613,7,9,9,25
"Unknown",wauevansdennis2845.xml,80444/xv00677,2,8,15,25
"University of Washington. Capital Projects Office.",wauuwresource07257.xml,80444/xv93121,9,7,9,25
"Unknown",wauheermansharryclay4309.xml,80444/xv74554,8,10,7,25
"Aleutian Islands in World War II Air Base Photograph Collection",waualeutianislandswwiiph2009_025.xml,80444/xv31567,8,6,11,25
"Unknown",waumyersflorencew5325.xml,80444/xv91619,8,11,6,25
"Unknown",wausonsrevolutionwasociety2193.xml,80444/xv75772,5,5,15,25
"Seattle Gay Clinic Records",wauseattlegayclinic5552.xml,80444/xv05673,8,6,11,25
"Elliott (Eric,)",wauelliotteric2696-080.xml,80444/xv13079,9,8,8,25
"Unknown",wauamericanfriendsservicecommitteepacificnorthwestregionaloffice3950.xml,80444/xv22811,6,8,11,25
"Unknown",waucooperbellataylormcknight1174.xml,80444/xv77664,7,7,11,25
"Havana, Cuba Photograph Album",wauhavanacubaphcoll062.xml,80444/xv45980,3,9,13,25
"Owens (Ray) photograph collection",wauowensrayphcoll1199.xml,80444/xv62835,6,7,12,25
"Robinson (Earl) Photograph Collection",waurobinsonearlphcoll419.xml,80444/xv56982,6,9,10,25
"Unknown",wauandrewsclarenceleroyphcoll520.xml,80444/xv60977,4,11,10,25
"Unknown",waukolloenfamily2770.xml,80444/xv93945,4,10,11,25
"University of Washington School of Music Photograph Collection",wauuwschoolmusicph2004_096.xml,80444/xv72012,5,10,10,25
"Unknown",waucoffeejohnmain3002.xml,80444/xv98678,8,7,10,25
"Watson (Dwight)",wauwatsondwightalvin2170.xml,80444/xv44168,7,7,11,25
"Music of Remembrance Collection",waumusicofremembrance5760.xml,80444/xv39022,5,5,15,25
"Seattle Midwifery School Records",wauseattlemidwiferyschool5597.xml,80444/xv38723,8,4,13,25
"Daniel (Barbara) Oral History Interview",waudanielsbarbara5884.xml,80444/xv90335,5,8,12,25
"Pruzan (Herb) Papers",waupruzanherb5762.xml,80444/xv38058,10,8,7,25
"Unknown",waucarlsoniverwalter4702.xml,80444/xv29858,6,8,11,25
"Strong (Tracy,)",waustrongtracyjr2075.xml,80444/xv04776,9,6,10,25
"Pratt (John Francis) Photograph Collection",wauprattjohnfrancisphcoll567.xml,80444/xv57421,7,6,12,25
"Hatate (Harry R.) Papers",wauhatateharry4513_1.xml,80444/xv11638,6,9,10,25
"Pierce (Frank Richardson) Photograph Collection",waupiercefrankrichardsonphcoll529.xml,80444/xv17510,3,7,15,25
"Greengard (Joseph) Photograph Collection",waugreengardjosephphcoll1070.xml,80444/xv91412,6,7,12,25
"Cone (Gerald) Papers",wauconegerald5026.xml,80444/xv19769,9,6,10,25
"Carstens Packing Company",waucarstenspackingcompanyphcoll1299.xml,80444/xv98272,7,7,11,25
"Hiscox (Donald)",wauhiscoxdonaldfua3373.xml,80444/xv84973,10,5,10,25
"Unknown",wauosawashigeru0960.xml,80444/xv43301,12,3,10,25
"University of Washington Continuing Dental Education Records",wauuwresource00356.xml,80444/xv48873,6,9,10,25
"Landes (Charles) Photograph and Ephemera Collection",waulandesphcoll140.xml,80444/xv35498,8,11,6,25
"Unknown",wauywcaseattlekingcounty3919.xml,80444/xv86468,9,9,7,25
"University of Washington Forest Club Records",wauforestclubua3383.xml,80444/xv51126,8,10,7,25
"University of Washington, Bothell Records",wauuwresource00446.xml,80444/xv89935,9,9,6,24
"Unknown",wauneurathhansua2708.xml,80444/xv19750,9,8,7,24
"Unknown",wausoroptimistintlseattlemetro5808.xml,80444/xv61083,15,5,4,24
"Unknown",waurychterdalbert3299.xml,80444/xv48052,3,7,14,24
"Anderson (Eva)",wauandersoneva3162.xml,80444/xv98263,4,7,13,24
"University of Washington Office of Commencement Exercises Records",wauuwresource02148.xml,80444/xv13540,8,10,6,24
"Wernstedt (Lage) Photographs",wauwernstedtlagephcoll667.xml,80444/xv40972,8,4,12,24
"Clark (Donald H.) Photograph Collection",wauclarkdonaldhphcoll672.xml,80444/xv08996,4,6,14,24
"Conklin (Louie Marian) Photograph Albums",wauconklinlouiemarianphcoll17.xml,80444/xv75602,7,3,14,24
"Unknown",waucampbellbodilwiel3566.xml,80444/xv04269,11,7,6,24
"Adams (Wanda) articles",wauadamswanda5872.xml,80444/xv03543,5,6,13,24
"Photographs of Frank Lloyd Wright Houses",wauwrightfranklloydphcoll107.xml,80444/xv97145,14,3,7,24
"Unknown",waurosenbaumharoldd3404.xml,80444/xv34729,7,5,12,24
"Unknown",wauindependentmediacenter5848.xml,80444/xv47940,5,7,12,24
"University of Washington Civil Defense Photograph Collection",waucivildefensephcoll367.xml,80444/xv53367,10,8,6,24
"Ritchie (Peter R.) Photograph Collection",wauritchiepeterrphcoll572.xml,80444/xv76824,9,8,7,24
"University of Washington Alumni Association records",wauuwresource00209.xml,80444/xv78802,7,8,9,24
"Unknown",wauuwresource00345.xml,80444/xv47369,7,3,14,24
"Bergsma (William) Papers",waubergsmawilliamua1721.xml,80444/xv39486,10,3,11,24
"Wilse (Anders Beer) Photographs",wauwilseandersbeerphcoll285.xml,80444/xv50509,12,5,7,24
"Unknown",waujapaneseassociationoftacoma4048.xml,80444/xv19039,12,4,8,24
"Unknown",waubuildingserviceemployeesinternationalunionlocal6seattlewash3140.xml,80444/xv36102,8,8,8,24
"Unknown",wauwashingtoncitizensfordeathwithdignity5069.xml,80444/xv07431,1,4,19,24
"Kusakovich (Theodore)",waukusakovichtheodorephcoll1312.xml,80444/xv78271,8,7,9,24
"B'nai B'rith Hillel Photograph Collection",waubnaibrithhillelphcoll912.xml,80444/xv44973,5,7,12,24
"Stamets (John) Photographs",waustametsjohnph2016_002.xml,80444/xv66256,2,13,9,24
"Larson (Edith Feero) Photograph Collection",waularsonedithfeerophcoll155.xml,80444/xv10781,8,8,8,24
"Unknown",wauwashingtonstatejewishhistoricalsociety3644.xml,80444/xv31677,2,8,14,24
"Unknown",waumendelsohnpeterpatrick1285.xml,80444/xv80630,6,11,7,24
"Rakus (Gust P.) Hellenic Studies Collection",waurakusgust5543.xml,80444/xv37426,6,10,8,24
"Frank Childs Collection of Klondike Gold Rush Photographs",wauchildphcoll302.xml,80444/xv89612,9,2,13,24
"Washington Sea Grant Program records",wauuwresource00452.xml,80444/xv97946,5,6,13,24
"Unknown",waugundlachjean5207.xml,80444/xv21511,4,9,11,24
"Unknown",waulogueharoldf1599.xml,80444/xv96520,7,5,12,24
"Denny (Arthur W.) University of Washington Campus Site Photographs",waudennyarthurwphcoll288.xml,80444/xv18862,11,8,5,24
"Reed (Roland)",waureedrolandphcoll465.xml,80444/xv21597,7,14,3,24
"United State Department of Agriculture",wauusdeptagricultureforestservicephcoll1211.xml,80444/xv29516,8,8,8,24
"Hennes (Robert)",wauhennesrobertgua2206.xml,80444/xv27059,5,9,10,24
"Unknown",wausnohomishcountycentrallaborcouncil3531.xml,80444/xv31359,10,6,8,24
"Hunt (P.S.) Photographs",waupshuntphcoll313.xml,80444/xv46679,4,10,10,24
"Unknown",wauschrieberjeanette3039.xml,80444/xv87664,13,5,6,24
"Unknown",wauwellshuletm0422.xml,80444/xv03677,7,11,6,24
"Native American Rock Art Photographs",waunativeamericanrockartphcoll746.xml,80444/xv53109,3,14,7,24
"Unknown",wauchadwickstephenfowler0014_1522.xml,80444/xv23822,13,5,6,24
"Unknown",waugrahamjohn3921.xml,80444/xv05343,7,9,8,24
"Thomas Burke Memorial Washington State Museum Records",wauuwresource00318.xml,80444/xv77285,4,9,11,24
"Unknown",waulakewhatcomloggingcompany4469.xml,80444/xv90969,7,7,10,24
"Brannin (Carl,)",waubrannincarl1393_1472.xml,80444/xv00942,13,2,9,24
"Western Canada Photograph Collection",waucanadaphcoll393.xml,80444/xv92150,7,5,12,24
"Unknown",wautrumbullharlanleo2243.xml,80444/xv64794,5,9,10,24
"Unknown",wauaustinrussell4585.xml,80444/xv08563,5,7,12,24
"Sandler (Laurence) Papers",wauua27_45_4561sandlerlaurencem.xml,80444/xv58156,10,7,7,24
"Gortler (Joshua) Photograph Collection",waugortlerjoshuaphcoll1069.xml,80444/xv78488,5,8,11,24
"Unknown",waugriggschaunceyl2088.xml,80444/xv06668,4,4,16,24
"Glosser (Joanne) oral history",wauglosserjoanne5653.xml,80444/xv89495,6,8,10,24
"Ahleen (Reinhold)",wauahleenreinhold0592_1208.xml,80444/xv61553,5,5,14,24
"Unknown",waugilkeyrichardc2786.xml,80444/xv60385,6,8,10,24
"Unknown",waunationalorganizationforwomenseattlekingcountychapter2287.xml,80444/xv47921,11,4,9,24
"AFL-CIO, Washington State Labor Council Audiovisual Collection",wauaflciowashingtonstatelaborcouncilphcoll1134.xml,80444/xv56384,7,7,10,24
"ACT Theater Photograph Collection",wauacttheaterphcoll221.xml,80444/xv06414,7,7,10,24
"Love (Ruth Leeds) photograph collection",wauloveruthleedsphcoll1169.xml,80444/xv25521,9,5,10,24
"Emmons (George Thornton) Native American Photographs",wauemmonsgeorgethorntonphcoll131.xml,80444/xv42941,5,11,8,24
"Jaffee (Martin)",waujaffeemartinsua5024.xml,80444/xv54595,6,9,9,24
"Unknown",wauarteagavoyage2203.xml,80444/xv88845,12,7,5,24
"Chilberg (John)",wauchilbergjohnedward0166_1148.xml,80444/xv10940,6,9,9,24
"Grage (Rene I.) Photograph and Ephemera Collection",waugragereneirenephcoll1229.xml,80444/xv65509,7,5,12,24
"Unknown",wauthonnjerrye2384.xml,80444/xv75637,8,5,11,24
"Keyes (Charles F.) Papers",waukeyescharlesfua4120.xml,80444/xv33023,7,3,14,24
"Ordway (Fred)",waualaskayukonfilmphcoll1269.xml,80444/xv32263,8,4,12,24
"Unknown",waudurningmarvinb1997.xml,80444/xv60791,9,8,7,24
"Unknown",waublehabernard2568.xml,80444/xv05804,8,6,10,24
"Loudon (Max ) Photograph Album",wauloudonmaxphcoll037.xml,80444/xv49804,6,5,13,24
"Unknown",waudurhamandersonfreedcompany2898.xml,80444/xv96942,6,9,9,24
"Seattle City Light Albums",wauseattlecitylightphcoll045.xml,80444/xv57318,8,7,9,24
"Ethel (Garland) Photograph Collection",wauethelgarlandphcoll497.xml,80444/xv78793,8,6,10,24
"Sororia Alumnae (University of Washington) Records",wauua32_00_3350sororiaalumnae.xml,80444/xv96111,5,7,12,24
"Unknown",wauglazeredward3215.xml,80444/xv37423,4,8,12,24
"Register of students and alumni from the University of Washington",wauuwresource05144.xml,80444/xv95187,6,6,12,24
"Unknown",waunorthernpacificrailroadcompanymissouridivision4989.xml,80444/xv51205,5,9,10,24
"Variegated Glacier, Yakutat, Alaska, Moving Image Collection",wauvariegatedglacierphcoll855.xml,80444/xv33822,6,8,10,24
"University of Washington. School of Law.",wauuwresource00350.xml,80444/xv09188,7,8,9,24
"Senkler (Elinor W.) Photograph Collection",wausenklerelinorphcoll351.xml,80444/xv94360,8,7,9,24
"Bracket H Ranch Camp for Boys film",waubrackethranchphcoll1263.xml,80444/xv85867,9,5,10,24
"Unknown",wautempleadathisraelcentraliawash3165.xml,80444/xv02456,4,4,16,24
"American Astronomical Society Records",wauamericanastronomicalsocietyua5427.xml,80444/xv73425,7,9,8,24
"Unknown",waugehrireitha3090.xml,80444/xv26174,7,6,11,24
"Unknown",waumillerireneburns2354.xml,80444/xv28466,4,6,14,24
"Unknown",waurutzrichardemil4991.xml,80444/xv49810,6,12,6,24
"Unknown",wauyakimanihonjinkaiyakimaheigennihonjinshi1520.xml,80444/xv93188,6,8,10,24
"Unknown",waujurgensenelmerv5010.xml,80444/xv91864,9,2,13,24
"Freedman (Deborah K.)",waufreedmandeborah5840.xml,80444/xv79013,7,9,8,24
"Kleiner (Herman) Oral History",waukleinerherman5650.xml,80444/xv54647,8,7,8,23
"Koyasan Shingon Temples in North America Photographs of",waukoyasanbuddhistchurchphcoll763.xml,80444/xv82995,6,8,9,23
"Unknown",waugreatnortherndailynewsseattlewash2399.xml,80444/xv77517,7,9,7,23
"Johnston (Norman)",waujohnstonnormanjua1648.xml,80444/xv35076,9,10,4,23
"Unknown",waujapanamericasocietyofseattle3686.xml,80444/xv23568,5,6,12,23
"Unknown",wauchongfay2574.xml,80444/xv89022,8,7,8,23
"Unknown",wauamericanrecordsmanagementassociationgreaterseattlechapter1833.xml,80444/xv52905,4,5,14,23
"Fields (Paul E.) Photographs and Motion Pictures",waufieldspauleph2010_021.xml,80444/xv86843,7,9,7,23
"Center for Urban Horticulture Arboretum Photographs",waucenterforurbanhorticulturearboretumphcoll526.xml,80444/xv30364,10,6,7,23
"Unknown",waupantagesalexander0331.xml,80444/xv40652,3,4,16,23
"Otto Seligman Gallery (Seattle, Wash.).",wauottoseligmangallery1901_2431.xml,80444/xv56936,8,10,5,23
"Curtis (Asahel) Makah Collection",waucurtisasahelmakahphcoll898.xml,80444/xv40875,7,8,8,23
"Draper (Horace H.) Photograph Collection",waudraperhoracehphcoll324.xml,80444/xv58846,9,10,4,23
"Unknown",wauwashingtonassociationforsocialwelfare3882.xml,80444/xv11730,3,8,12,23
"Anne Brown Oral History",waubrownanne5612.xml,80444/xv11166,7,5,11,23
"Harper (Carol Ely) Papers",wauharpercarolely5540.xml,80444/xv51034,14,4,5,23
"Krems (Nathan) photograph collection",waukremsnathanphcoll1147.xml,80444/xv00949,6,6,11,23
"Ayer (Elizabeth) Photograph Collection",wauayerelizabethphcoll068.xml,80444/xv98745,9,7,7,23
"Bonsteel (David L.) Photograph Collection",waubonsteeldavidlphcoll510.xml,80444/xv30004,5,6,12,23
"Chancellor Gold Mining Company Photograph Album",wauchancellorgoldminingcompanyphcoll022.xml,80444/xv34878,8,3,12,23
"Mosler (George)",waumoslergeorge2040.xml,80444/xv89831,6,9,8,23
"Unknown",wauwallingfordcommunitycouncil5422.xml,80444/xv54476,2,5,16,23
"Fant (Karen) papers",waufantkaren5766.xml,80444/xv23962,5,10,8,23
"Unknown",wauschenkmaria3045.xml,80444/xv44854,5,13,5,23
"Spring (Lucille) papers",wauspringlucille5932.xml,80444/xv99957,2,8,13,23
"Koide (Joseph) Papers",waukoidejoseph4223.xml,80444/xv15056,11,5,7,23
"Watkins (Carleton E.) Stereoviews",wauwatkinscarletonstereoviewsphcoll1025.xml,80444/xv03503,10,10,3,23
"Novick (Michael)",waunovickmichael5463.xml,80444/xv67166,4,11,8,23
"Unknown",waugaytonfamily0850.xml,80444/xv85189,8,6,9,23
"Bowen (Betty) Northwest Artists Photograph Collection",waubowenbettyiiphcoll421.xml,80444/xv29040,7,11,5,23
"Friedmann (John W.) Papers and Oral History Interview",waufriedmannjohnw5452.xml,80444/xv27630,5,9,9,23
"University of Washington. Public Affairs Institute.",wauuwresource00464.xml,80444/xv99874,6,9,8,23
"Emanuel (Irvin)",wauemanuelirvinua3384.xml,80444/xv49740,5,6,12,23
"Children's Orthopedic Hospital and Medical Center Photograph and Moving Image Collection",wauchildrensorthopedichospitalph2004_141.xml,80444/xv20062,4,4,15,23
"MacKay (Ralph E.) Alaska Photograph Albums",waumackayrobertphcoll413.xml,80444/xv50265,9,8,6,23
"Loughran (Henrietta)",wauloughranhenriettaadamsua1306_1399_1424_2004.xml,80444/xv00842,7,6,10,23
"Unknown",waucoecharles4041.xml,80444/xv50968,8,10,5,23
"Bouillon (Erna)",waubouillonernadora3416-001.xml,80444/xv09979,8,6,9,23
"Unknown",waumountaineerssocietyliteraryfundcommittee1584.xml,80444/xv65301,7,8,8,23
"Unknown",wauhartshornflorencem0570.xml,80444/xv10424,5,6,12,23
"Benedict (P. W.) University of Washington Photograph Album",waubenedictpwph2010_020.xml,80444/xv03277,5,6,12,23
"Kaiser (Ethel Chaiken Lippman) Photograph Collection",waukaiserethelchaikenlippmanphcoll1074.xml,80444/xv15173,9,8,6,23
"Starwich (Matt) Prohibition Era Photograph Collection",waustarwichmattphcoll676.xml,80444/xv11978,15,3,5,23
"Wilderness Alps of Stehekin",wauwildernessalpsstehekinfilmphcoll1281.xml,80444/xv27313,10,4,9,23
"Unknown",wausaunderscornelia4879.xml,80444/xv69689,13,5,5,23
"Feminists Northwest Records",waufeministsnorthwest5566.xml,80444/xv94674,9,6,8,23
"Unknown",waumusicandartfoundationseattlewash2787.xml,80444/xv28610,9,4,10,23
"Unknown",wauwashwildcoalition4426.xml,80444/xv46180,3,10,10,23
"Unknown",wauhobifrankd1877.xml,80444/xv31182,9,6,8,23
"William O. McKay Company Photograph Collection",wauwilliamomckaycompanyphcoll783.xml,80444/xv70553,7,10,6,23
"Tacoma Narrows Bridge Photograph Collecton",wautacomanarrowsbridgephcoll581.xml,80444/xv99197,7,8,8,23
"Curtis (Asahel) Photographs",waucurtisasahelphcoll482.xml,80444/xv58377,2,9,12,23
"Whitman (Frank) Collection on Inlandboatmen’s Union of the Pacific Strike Against Crowley Maritime Corporation",wauwhitmanfrankcollection5961.xml,80444/xv93008,9,7,7,23
"Unknown",wautempleemanuelspokanewash2154.xml,80444/xv17733,15,3,5,23
"Case (W. H.) postcard collection",waucasewhpostcardsphcoll1126.xml,80444/xv17068,4,11,8,23
"Unknown",waudotyjames4718.xml,80444/xv68246,9,4,10,23
"John M. Wallace Papers",wauwallacejohnmua5717.xml,80444/xv23513,9,8,6,23
"University of Washington. Office of the University Architect.",wauuwresource06117.xml,80444/xv83349,5,10,8,23
"Kawamura (Hiroaki)",waukawamurahiroaki2696-125.xml,80444/xv09783,5,9,9,23
"Lagen (William S.) Photograph Collection",waulagenwilliamsphcoll412.xml,80444/xv18618,2,14,7,23
"Groman (Neal)",waugromannealbua3418.xml,80444/xv13858,5,8,10,23
"Laakso and McPherson Family Papers",waulaaksomcphersonfamily5802.xml,80444/xv42874,5,4,14,23
"Unknown",waueaglesonjamesbeatty2970.xml,80444/xv52108,11,5,7,23
"Unknown",waugrossholtzjean4257.xml,80444/xv97772,6,6,11,23
"Unknown",waulangrichard3214.xml,80444/xv03906,5,8,10,23
"Smith (J.)",wausmithjallen1889.xml,80444/xv62548,13,5,5,23
"Unknown",waudurhamrobertl3477.xml,80444/xv82363,5,8,10,23
"Unknown",waubrookerellene3979.xml,80444/xv78506,7,6,10,23
"Casey (Crysta)",waucaseycrysta5831.xml,80444/xv03698,7,6,10,23
"Stevens (Edwin)",waustevensedwinbua0112.xml,80444/xv56451,7,6,10,23
"George (Frances) papers",waujonesfrancesgeorgeua5768.xml,80444/xv37594,9,7,7,23
"Council of Jewish Women Photograph Collection",waucouncilofjewishwomenphcoll446.xml,80444/xv60650,8,9,6,23
"Unknown",waupeckgloriab2773.xml,80444/xv87084,7,8,8,23
"Chambers Family Photograph Collection",wauchambersfamilyph2004_097.xml,80444/xv50650,7,7,9,23
"Keller (David)",waukellerdavid5321.xml,80444/xv56829,7,10,6,23
"Photographs of Byles Family",waubylesfamilyphcoll1146.xml,80444/xv55154,9,7,7,23
"Unknown",waukingalberta0473.xml,80444/xv61239,6,7,10,23
"Unknown",waugibbsgeorge4653.xml,80444/xv94839,15,5,3,23
"Unknown",waudemonstrationprojectforasianamericansseattlewash3878.xml,80444/xv71835,6,6,11,23
"Bathhouse Theatre Photograph Collection",waubathhousetheatrephcoll378.xml,80444/xv30706,9,6,8,23
"Friedman Family Photograph Collection",waufriedmanfamilyphcoll1066.xml,80444/xv31219,8,5,10,23
"Unknown",wauwillisparkweed4068.xml,80444/xv35705,6,6,11,23
"Sperlin (Ottis)",wausperlinottisbedney2916.xml,80444/xv50225,7,7,9,23
"University of Washington Office of Development and Alumni Relations Records",wauuwresource00137.xml,80444/xv34884,9,6,8,23
"Unknown",waugerbersidney0503.xml,80444/xv47253,11,5,7,23
"Unknown",wausmithmadelaide4898.xml,80444/xv66943,8,2,13,23
"Japanese-American Citizens League, Seattle Branch Records",waujapaneseamericancitizensleagueseattle0217.xml,80444/xv29432,15,3,5,23
"Unknown",waubrownberiah4696.xml,80444/xv41177,7,5,11,23
"Unknown",waumcleodkenneth2487.xml,80444/xv74353,9,5,9,23
"Droker (Howard) Collection",waudrokerhoward1586_1617_1658_2112_2220.xml,80444/xv79098,8,8,7,23
"Unknown",waudaykennethw5081.xml,80444/xv96994,10,7,6,23
"Unknown",wauunitedstatesarmybasehospitalno50_3847.xml,80444/xv99035,5,10,8,23
"Gooding (Erik)",waugoodingerikd2696-106.xml,80444/xv21194,6,10,7,23
"Unknown",wauhigmanharrywentworth4293.xml,80444/xv45944,10,5,8,23
"University of Washington Department of Comparative Literature Records",wauuwresource00322.xml,80444/xv02402,9,7,7,23
"Unknown",waufirstchamberdancecompany3694.xml,80444/xv94598,10,5,8,23
"Unknown",waumeekerezra4814.xml,80444/xv16067,5,11,7,23
"Unknown",waubroderickfredamarkow2723.xml,80444/xv67440,4,3,16,23
"Unknown",wauappletonmarionb3008.xml,80444/xv89715,8,9,6,23
"Unknown",wauhorwoodrosemary2162.xml,80444/xv29608,5,5,13,23
"Engle (Nathanael)",wauenglenathanaelhua1330.xml,80444/xv93701,4,5,14,23
"Lehmann (J.)",waulehmannjh3640.xml,80444/xv39984,6,8,9,23
"Unknown",waulevinsonelsak2296.xml,80444/xv92712,6,7,10,23
"Gunther (Erna) Photograph Collection",wauguntherernaphcoll134.xml,80444/xv93783,10,6,7,23
"Lembcke (Jerry)",waulembckejerry5796.xml,80444/xv64782,7,5,11,23
"Legg (Herbert Hugh) FBI File",wauleggherberthugh5693.xml,80444/xv40673,6,5,12,23
"Peyser (Ethan)",waupeyserethanallen0620_1355.xml,80444/xv37014,4,7,12,23
"Birulin (Solomon) Photograph Collection",waubirulinsolomonphcoll1057.xml,80444/xv58261,8,7,8,23
"Morgan (Blanche) Drawings and Watercolors",waumorganblanchephcoll525.xml,80444/xv73849,15,5,3,23
"Methodist Episcopal Church. Missionary Society.",waumethodistepiscopalchurchmissionarysociety4818.xml,80444/xv23571,9,6,8,23
"Unknown",waumcadoobenjaminf1232.xml,80444/xv11682,3,10,10,23
"Fox (Michael) Papers",waufoxmichael5926.xml,80444/xv45712,9,9,5,23
"Voices of the Second Wave oral history collection",wauyangdorijones5675.xml,80444/xv50918,11,6,5,22
"Ullman (Joan)",wauullmanjoanconnellyua4580.xml,80444/xv78762,5,6,11,22
"Bone (Mary)",waubonemaryworth5517.xml,80444/xv56219,8,7,7,22
"Norling (Ernest Ralph) Drawings",waunorlingernestralphphcoll553.xml,80444/xv18536,11,7,4,22
"Unknown",wauweinersidneynathan5438.xml,80444/xv53451,10,3,9,22
"Brockman (C.)",waubrockmancfrankua1802.xml,80444/xv31283,3,11,8,22
"Unknown",wauuwresource00441.xml,80444/xv46737,4,6,12,22
"Unknown",wauiversonwaynef5167.xml,80444/xv89297,17,3,2,22
"St. Mark's Cathedral Construction Photographs",waustmarkscathedralconstructionphcoll042.xml,80444/xv20709,12,7,3,22
"Williams (Shedrich) Photographs",wauwilliamsshedrichphcoll204.xml,80444/xv66409,10,9,3,22
"Unknown",waukingcountyoutdoorsportscouncil5192.xml,80444/xv57205,4,6,12,22
"Fine (David) Papers and Oral History Interview",waufinedavid5891.xml,80444/xv54547,7,9,6,22
"Unknown",waulawsonsamshim3102.xml,80444/xv95407,3,4,15,22
"Kirk (Ruth) Papers",waukirkruth4166.xml,80444/xv61990,7,9,6,22
"Lundberg (Florence) Photographs",waulundbergflorencephcoll123.xml,80444/xv19473,5,5,12,22
"Unknown",wauketzlachnorman4050.xml,80444/xv60992,5,7,10,22
"Warnick (Jack,)",wauwarnickjack5469.xml,80444/xv40032,2,5,15,22
"Thompson (William)",wauthompsonwilliamfrancisua2597.xml,80444/xv60836,3,10,9,22
"Hitt family papers",wauhittfamily5880.xml,80444/xv75668,9,4,9,22
"Bayley (Christopher T.) Photograph Collection",waubayleychristopherphcoll1249.xml,80444/xv77795,8,6,8,22
"Pinkney (David H.) papers",waupinkneydavidhua4127.xml,80444/xv04229,10,8,4,22
"Bogue (Virgil)",wauboguevirgilgay4619.xml,80444/xv03601,4,6,12,22
"Wheeler (James W.) Photograph Collection",wauwheelerjameswphcoll159.xml,80444/xv41662,9,5,8,22
"Unknown",waumcgrathjamesa4547.xml,80444/xv19308,6,10,6,22
"Bolles (Robert)",waubollesrobertcua4463.xml,80444/xv36331,5,12,5,22
"Unknown",wauunitedbrotherhoodcarpentersjoinersamerica1227.xml,80444/xv50500,8,6,8,22
"Unknown",waukaplansarad4423.xml,80444/xv92257,8,5,9,22
"Soper (Leroy) Papers",wausoperleroyw5562.xml,80444/xv31369,5,4,13,22
"Hoffman (Louise)",wauhoffmanlouisei5490.xml,80444/xv15090,3,8,11,22
"Unknown",wauwalkerharrietk5223.xml,80444/xv27639,6,7,9,22
"University of Washington, Tacoma, Chancellor's Office Records.",wauuwresource00447.xml,80444/xv56207,10,4,8,22
"Cohen (Samuel) papers",waucohensamuel2801.xml,80444/xv41860,4,8,10,22
"Barton Brothers Photographs",waubartonbrothersphcoll365.xml,80444/xv08639,10,5,7,22
"B'nai B'rith, Greater Seattle Lodge 3003 Photograph Collection",waubnaibrithphcoll908.xml,80444/xv36151,5,4,13,22
"Unknown",waublankenshipgeorgec2398.xml,80444/xv74383,7,7,8,22
"Unknown",waugordondon2295.xml,80444/xv12783,5,9,8,22
"Unknown",waublumlenore4189.xml,80444/xv87350,9,5,8,22
"Biehn (Jeanne)",waubiehnjeanneellenvercoutere3416-001.xml,80444/xv96554,6,5,11,22
"Unknown",wauuwresource00417.xml,80444/xv00857,8,5,9,22
"Kroeber (Paul)",waukroeberpauld1835-022_2696-034.xml,80444/xv11816,11,3,8,22
"Frank, Andrew J. and Cecile E. photographs",waufrankandrewjcecileeph2010_016.xml,80444/xv33563,3,7,12,22
"Unknown",wauschweppealfredjohn3989.xml,80444/xv46392,6,10,6,22
"Mastroianni (Anna C.) Collection from the U. S. Advisory Committee on Human Radiation Experiments",waumastroianniadvisorycommhumanradiationexperimentsua5765.xml,80444/xv06320,10,10,2,22
"Hall (Camden M.) Papers",wauhallcamdenm5503.xml,80444/xv61950,5,9,8,22
"Schwellenbach (Lewis)",wauschwellenbachlewisb0003_0374.xml,80444/xv70944,10,5,7,22
"Unknown",waumedicallibraryassociationpacificnorthwestregionalgroup3761.xml,80444/xv92355,6,4,12,22
"Castle (Del) Papers",waucastledel5730.xml,80444/xv67352,9,7,6,22
"Lowen (Jeanette)",waulowenjeanettem5459.xml,80444/xv72033,7,8,7,22
"Hobbs (Richard S.) Oral History Interviews with Revels Cayton",wauhobbsrichards5483.xml,80444/xv44448,8,7,7,22
"Unknown",wautwerskyreva2581.xml,80444/xv66708,4,4,14,22
"Unknown",waurichardhaagassociates4405.xml,80444/xv69046,12,5,5,22
"Rogers (Joyce Lighter) Photograph and Film Collection",waurogersjoycelighterphcoll1081.xml,80444/xv99789,8,6,8,22
"Trabert (Harriet M.) travel slides",wautrabertharrietmph2012_007.xml,80444/xv24551,6,5,11,22
"Unknown",wauhinesnealo2930.xml,80444/xv33047,9,10,3,22
"Anonymous Alaska Yukon Pacific Exposition Postcard Album",wauaypepostcardalbumphcoll433.xml,80444/xv76336,6,6,10,22
"Unknown",wauruckerhelen2752.xml,80444/xv78598,6,6,10,22
"Unknown",wauwoodsrufus0284.xml,80444/xv55541,7,9,6,22
"University of Washington, Transportation Services Records",wauuwresource00130.xml,80444/xv92770,10,4,8,22
"Harborview Medical Center (Seattle, Wash.). Budget and Reporting Office.",wauuwresource00471.xml,80444/xv01358,9,6,7,22
"Unknown",waurwbeckandassociates4291.xml,80444/xv89639,9,6,7,22
"Cunningham (Imogen,)",waucunninghamimogen2645.xml,80444/xv89224,6,10,6,22
"Unknown",wauanichtchenkoevguenia5754.xml,80444/xv40490,6,9,7,22
"University of Washington, School of Dentistry, Dean Records",wauuwresource00355.xml,80444/xv90130,5,7,10,22
"University of Washington. Applied Physics Laboratory.",wauuwresource00313.xml,80444/xv98580,8,7,7,22
"University of Washington Photograph Album",wauuniversityofwashingtonalbumphcoll195.xml,80444/xv60629,8,5,9,22
"Ahlers (Eleanor)",wauahlerseleanore2596.xml,80444/xv21945,4,5,13,22
"Unknown",waurussellcharles4876.xml,80444/xv62576,7,4,11,22
"Unknown",wausimmonsjesseb0918.xml,80444/xv83566,5,8,9,22
"Stanley (William) Photograph Collection",waustanleywilliamphcoll345.xml,80444/xv28839,5,6,11,22
"Marshin (Carl) Photograph Collection",waumarshincarlphcoll1076.xml,80444/xv51022,6,6,10,22
"Japanese Internment Camp Photograph Collection",waujapaneseinternmentphcoll793.xml,80444/xv01660,8,7,7,22
"Unknown",waubalintjudylash4395.xml,80444/xv74371,5,5,12,22
"Gellatly (Peter)",waugellatlypeterua2700.xml,80444/xv51718,7,5,10,22
"Unknown",waufarwelldenise3602.xml,80444/xv63522,4,6,12,22
"Evanson (Ella) Scrapbooks",wauevansonella2402.xml,80444/xv29421,8,6,8,22
"Roys (Ralph)",wauroysralphlovelandua0777_1712.xml,80444/xv69909,5,5,12,22
"Unknown",waugillespiecynthiak4462.xml,80444/xv41946,8,4,10,22
"Unknown",waucoeearl0502.xml,80444/xv10897,9,7,6,22
"Unknown",wauwashingtoneducationassociation0731.xml,80444/xv96002,6,5,11,22
"Martin (James) Papers",waumartinjames5260.xml,80444/xv25320,12,7,3,22
"Hadassah Seattle Chapter",wauhadassahseattlechapterphcoll904.xml,80444/xv31112,5,7,10,22
"Unknown",wauthorpmichaelr3264.xml,80444/xv17675,4,8,10,22
"University of Washington Office of the Vice President for Student Affairs Records",wauuwresource00147.xml,80444/xv23168,7,4,11,22
"Unknown",waujohnswilliamdouglas4226.xml,80444/xv92636,7,12,3,22
"Canafax (Caroline) Papers",waucanafaxcaroline5272.xml,80444/xv05316,8,7,7,22
"Unknown",waucongregationezrabessarothseattlewash2739.xml,80444/xv95666,7,5,10,22
"Unknown",waudayhelen5201.xml,80444/xv91339,8,4,10,22
"Unknown",waustussersamm4300.xml,80444/xv19812,6,5,11,22
"Doak (Ivy)",waudoakivyg2696-037.xml,80444/xv27374,7,8,7,22
"Unknown",waumireljamesl2658.xml,80444/xv29803,5,6,11,22
"Unknown",waulesourdfrancisa0474.xml,80444/xv12875,9,5,8,22
"Unknown",wauulrichshermannf2138.xml,80444/xv74749,10,4,8,22
"Unknown",waugorriejackosborne0627.xml,80444/xv43045,2,7,13,22
"Unknown",waugreenebernice2337.xml,80444/xv96862,9,6,7,22
"University of Washington Department of English",wauuwresource00283.xml,80444/xv52435,7,3,12,22
"Unknown",wauconradricejoybelle2655.xml,80444/xv82958,8,6,8,22
"Hanks (Jane R.) Collection",wauhanksjanerichardson5544.xml,80444/xv13348,4,10,8,22
"Unknown",waugonzalesboyer2726.xml,80444/xv77044,4,8,10,22
"Dohner (Charles) Papers",waudohnercharlesua5671.xml,80444/xv48181,8,4,10,22
"Boy Scouts of America. Seattle Council. Troop 45.",wauboyscoutsofamericaseattlecounciltroop45_3223.xml,80444/xv22683,5,6,11,22
"Unknown",waukellerdale4544.xml,80444/xv17706,3,6,13,22
"American Library Association.",wauamericanlibraryassociation3088.xml,80444/xv31350,7,5,10,22
"University of Washington Registrar's Office, Data Management Services records",wauuwresource00149.xml,80444/xv47042,5,10,7,22
"University of Washington Provost.",wauuwresource00097.xml,80444/xv54351,5,9,8,22
"Freyd (Jane) Photograph Collection",waufreydjanephcoll1065.xml,80444/xv19146,6,8,8,22
"Unknown",waubergconstructioncompany4695.xml,80444/xv94430,2,9,11,22
"Bader (Greg) papers",waubadergreg5748.xml,80444/xv64523,8,7,7,22
"Unknown",wauhilltopwash3457.xml,80444/xv08474,7,5,10,22
"Unknown",wauchildwelfareleaguerenton5811.xml,80444/xv31146,7,6,9,22
"Unknown",waugroundswellnw5894.xml,80444/xv12850,9,4,9,22
"University of Washington. College of Arts and Sciences. Research and Facilities Office.",wauuwresource00276.xml,80444/xv25875,7,9,6,22
"Unknown",wauelshinjean2844.xml,80444/xv18215,9,6,7,22
"Howard (Lois Batwell) Photograph Collection",wauhowardloisbatwellphcoll067.xml,80444/xv42987,4,7,11,22
"Steinbrueck (Victor) Photographs",wausteinbrueckvictoruwcampusphcoll1113.xml,80444/xv07583,11,6,5,22
"Storvik (Jerry) Photographs",waustorvikjerryph2012_002.xml,80444/xv63543,7,7,8,22
"Unknown",waubordeauxrehei2228.xml,80444/xv67904,2,4,16,22
"Family Photograph Album of Washington State Views",waufamilywashingtonalbumphcoll860.xml,80444/xv47091,9,6,7,22
"American Institute of Architects Photograph Collection",wauamericaninstituteofarchitectsphcoll142.xml,80444/xv32302,5,6,10,21
"Unknown",waumountaineerssocietypresident2987.xml,80444/xv60598,9,6,6,21
"Dilworth family Letters",waudilworthfamily5575.xml,80444/xv26657,5,6,10,21
"Unknown",waulighteresther2278.xml,80444/xv86962,6,3,12,21
"Unknown",wauwhitneymemorialmethodistchurchtacomawash4819.xml,80444/xv65170,3,5,13,21
"Unknown",wauelliotteugenec2456.xml,80444/xv69122,6,6,9,21
"Simon (Herb) papers",wausimonherb5805.xml,80444/xv47463,8,7,6,21
"Unknown",wausamtergustav3672.xml,80444/xv62673,8,5,8,21
"Scott (Tyree) Photograph Collection",wauscotttyreephcoll1093.xml,80444/xv15087,6,4,11,21
"Unknown",waupaulfred4245.xml,80444/xv43524,6,5,10,21
"Palmer (Douglas Shaw) papers",waupalmerdouglasshaw5780.xml,80444/xv03924,6,8,7,21
"Unknown",wauseattleartscommission2492.xml,80444/xv18167,7,4,10,21
"Alexander (Edward) Papers",waualexanderedwardua5381.xml,80444/xv56616,3,8,10,21
"LeSourd (Peter) Papers",waulesourdpeterc5665.xml,80444/xv16827,10,5,6,21
"Unknown",waumcmickenwilliam0434.xml,80444/xv33511,5,5,11,21
"Unknown",waualhadeffalbert3460.xml,80444/xv35824,6,6,9,21
"Bereano (Philip) Papers",waubereanophilipua4188.xml,80444/xv20443,9,6,6,21
"Unknown",waumountaineerssocietymountaineerbooks2896.xml,80444/xv35324,5,6,10,21
"Jewish Women International, Seattle Chapter No. 647 Records",waubnaibrithwomenseattlechapterno647_5197.xml,80444/xv65255,5,5,11,21
"Unknown",wauwascottishterrier5817.xml,80444/xv40496,8,3,10,21
"Unknown",wauconeybyrond0349.xml,80444/xv75326,4,8,9,21
"Unknown",waunationalassociationofsocialworkerspugetsoundunit2738.xml,80444/xv16629,10,2,9,21
"McArthur (A.L.) Stereographs",waumcarthuralphcoll166.xml,80444/xv04486,9,9,3,21
"Unknown",waucongregationbikurcholimmachzikayhadathseattlewashsisterhood2054.xml,80444/xv93301,5,8,8,21
"Unknown",wauragsdillrh2186.xml,80444/xv82562,10,2,9,21
"McLaughlin (Frank) Photographs of",waumclaughlinfrankphcoll588.xml,80444/xv04797,12,5,4,21
"Unknown",waukremsnathan2145.xml,80444/xv12536,3,7,11,21
"Unknown",waumarshincarl3670.xml,80444/xv44058,6,5,10,21
"Unknown",wauhornedith5447.xml,80444/xv77804,7,5,9,21
"Brown (Robert A.) Papers",waubrownrobertaua5718.xml,80444/xv67919,4,7,10,21
"Unknown",waunicholsralphd4830.xml,80444/xv70019,7,4,10,21
"Unknown",waugraymarieelise3076.xml,80444/xv78564,3,13,5,21
"Hill (Warren)",wauhillwarrentua5320.xml,80444/xv64874,5,8,8,21
"Hanson (Kermit O.) Papers",wauua20_00_3393hansonkermit.xml,80444/xv97487,7,6,8,21
"McAllen (John L.) Photographs",waumcallenjlphcoll1350.xml,80444/xv38534,5,5,11,21
"Hoffman (Abe) Photograph Collection",wauhoffmanabephcoll1071.xml,80444/xv62039,10,4,7,21
"University of Washington Department of Health Services Records",wauuwresource00463.xml,80444/xv56027,7,5,9,21
"Unknown",waublissjosephj4615.xml,80444/xv94668,2,9,10,21
"Caplan (Irwin) Oral History",waucaplanirwin5647.xml,80444/xv43603,4,7,10,21
"Macaulay (Monica)",waumacaulaymonicaann2696-067.xml,80444/xv89550,3,11,7,21
"Unknown",waunorthernpacificrailwaycompanycoaldept0370.xml,80444/xv95223,8,9,4,21
"Unknown",wausuzukinobuko3924.xml,80444/xv58370,2,5,14,21
"Unknown",wauchasedoris2842.xml,80444/xv39202,3,4,14,21
"Judkins (D.R.) Photographs",waujudkinsdrphcoll280.xml,80444/xv12637,9,3,9,21
"Unknown",waumaimonsolomon3024.xml,80444/xv00128,5,7,9,21
"Washington State Railroad Bridges Photograph Collection",waucornellbridgephcoll862.xml,80444/xv06808,5,7,9,21
"Unknown",waurosenwilliam2284.xml,80444/xv92831,7,6,8,21
"Unknown",waufinnishhistoricalcommitteewash4728.xml,80444/xv40725,14,1,6,21
"Unknown",waumeanyedmonds1949.xml,80444/xv58792,2,8,11,21
"Waskowitz (Frank (Fritz) T.) Papers",wauwaskowitzfrankt5901.xml,80444/xv67700,4,7,10,21
"Whicker (H.)",wauwhickerhw3844.xml,80444/xv14849,6,8,7,21
"Harley (Heidi)",wauharleyheidi2696-133.xml,80444/xv78738,5,7,9,21
"Unknown",wausorosisclubseattlewash4431.xml,80444/xv17541,8,6,7,21
"Socialist Party (Wash.).",wausocialistparty3945.xml,80444/xv60214,3,8,10,21
"Unknown",waumalinalecm3722.xml,80444/xv84356,4,4,13,21
"American Federation of Teachers, Local 336 records",wauamericanfederationteacherslocal336_5715.xml,80444/xv34472,9,5,7,21
"Unknown",waubrashemalfreda3047.xml,80444/xv56945,7,8,6,21
"Kirk (Ruth) photograph collection",waukirkruthph2012_011.xml,80444/xv99987,6,6,9,21
"Beyer (Richard)",waubeyerrichards5187.xml,80444/xv75457,8,9,4,21
"University of Washington. School of Social Work.",wauuwresource00434.xml,80444/xv15859,4,4,13,21
"Conlon, Frank F. papers",wauconlonfrankfua5736.xml,80444/xv02752,7,5,9,21
"Franklin (Edward S.) UW Class of 1915 Album",waufranklinedwardsphcoll361.xml,80444/xv57159,13,2,6,21
"Roethke (Theodore) and Family Photographs of",wauroethketheodorephcoll791.xml,80444/xv73675,7,6,8,21
"Unknown",waujoinhandsseattlechapter1151.xml,80444/xv24343,9,4,8,21
"Moudon (Anne Vernez) Papers",waumoudonannevernezua5905.xml,80444/xv71359,7,8,6,21
"Spragens (John) Photographs, Moving Image and Audio",wauspragensjohnph2013_001.xml,80444/xv43237,5,4,12,21
"Burke (Frances Adams) Collection of Photographs of Fauntleroy Neighborhood, Seattle",wauburkefauntleroyneighborhoodphcoll1036.xml,80444/xv46096,11,4,6,21
"National Association of Social Workers. Oral History Project.",waunationalassociationofsocialworkersoralhistoryproject3283.xml,80444/xv13629,5,8,8,21
"Torrance (Roscoe) Photograph Collection",wautorranceroscoephcoll509.xml,80444/xv65118,5,4,12,21
"Gerard Schwarz Papers",wauschwarzgerard5703.xml,80444/xv79812,7,7,7,21
"Unknown",wauwestonevanm1116_1965.xml,80444/xv17507,8,6,7,21
"Aller (Leeon)",wauallerleeonfua4567.xml,80444/xv44079,6,7,8,21
"Cable (Seth) papers",waucableseth2696-137.xml,80444/xv68582,5,10,6,21
"Unknown",wauamericanfederationofteacherslocalyakimavalleycollege4145.xml,80444/xv32403,5,11,5,21
"Highway and the People Film",wauhighwayandthepeoplefilmphcoll1008.xml,80444/xv12796,5,2,14,21
"Unknown",wausmithmargareth5299.xml,80444/xv47103,2,6,13,21
"Unknown",wauchapmandouglasua4581_1.xml,80444/xv94742,10,7,4,21
"Baggerly (Florence)",waubaggerlyflorencemiller3416-001.xml,80444/xv40347,3,11,7,21
"Wehn (James A.) Photographs",wauwehnjamesaphcoll532.xml,80444/xv64678,8,7,6,21
"University of Washington. School of Nursing. Harborview Division.",wauuwresource06075.xml,80444/xv44418,4,7,10,21
"Unknown",wauquineradcliffe0304.xml,80444/xv45202,6,9,6,21
"Unknown",waubillingsleypaul4164.xml,80444/xv23989,6,5,10,21
"Unknown",waujewishclubwash5856.xml,80444/xv87438,13,4,4,21
"Carlson (Barry)",waucarlsonbarryf2001.xml,80444/xv69348,12,6,3,21
"Tomlinson (Owen A.) Mount Rainier National Park Photograph Albums",wautomlinsonphcoll029.xml,80444/xv98730,6,6,9,21
"Roberts (Milnora)",waurobertsmilnoradebeelen1129.xml,80444/xv00393,3,6,12,21
"Berner (Richard)",waubernerrichardcua1869.xml,80444/xv25680,8,7,6,21
"Neighbors in Need (Organization : Seattle, Wash.).",wauneighborsinneed3000.xml,80444/xv95285,4,6,11,21
"Agranoff (Julian) Oral History Interview",wauagranoffjulian5895.xml,80444/xv92581,7,5,9,21
"Lackman",waulackmanrobertandjanet5821.xml,80444/xv52822,12,4,5,21
"Kornfeld (Yechezkel)",waukornfeldyechezkel5466.xml,80444/xv57623,9,4,8,21
"Roman (Herschel)",wauromanherschellua2955.xml,80444/xv05328,7,7,7,21
"Unknown",waumillerelmer0808_1086.xml,80444/xv64706,5,4,12,21
"University of Washington Young Alumni Club Records",wauuwresource07692.xml,80444/xv08907,13,3,5,21
"Unknown",waucobbwilliam3173.xml,80444/xv53930,5,11,5,21
"Unknown",waukildallroberte2415.xml,80444/xv71136,6,3,12,21
"Unknown",wauschweppedoolittlekrugtausendbeezerandbeierleseattlewash2624.xml,80444/xv90713,7,4,10,21
"Mountaineers",waumountaineersfilmsphcoll1047.xml,80444/xv26602,4,7,10,21
"Maslan (Bob) Oral History",waumaslanbob5666.xml,80444/xv86209,5,6,10,21
"Unknown",waularssenak2737.xml,80444/xv05307,2,8,11,21
"Unknown",wauwanlessjw0485.xml,80444/xv44564,6,4,11,21
"Lancaster (Captain S.E.) Photograph Album",waulancastercaptsephcoll168.xml,80444/xv85223,8,8,5,21
"American Protective League. Minute Men Division. Precinct 265 (Seattle, Wash.).",wauamericanprotectiveleagueminutemendivisionprecinct265_5403.xml,80444/xv96356,4,8,9,21
"Unknown",waucapelotomary3401.xml,80444/xv48196,7,4,10,21
"Sjulstad Collection of Guy Scott photographs",wausjulstadphcoll513.xml,80444/xv01214,7,4,10,21
"Seattle Talmud Torah Hebrew School photograph collection",wauseattletalmudtorahhebrewschoolphcoll1132.xml,80444/xv73977,5,3,13,21
"Schmid (Calvin)",wauschmidcalvin2591.xml,80444/xv67239,9,5,7,21
"Russian Tsars Photograph Collection",waurussiantsarsphcoll452.xml,80444/xv67080,12,2,7,21
"Family Photograph Album",waufamilyalbumphcoll546.xml,80444/xv35253,6,8,7,21
"Unknown",waufreedomsocialistpartyseattlebranch1545.xml,80444/xv27291,5,9,7,21
"Harborview Medical Center (Seattle, Wash.). Community Relations Office.",wauuwresource00486.xml,80444/xv14877,5,4,12,21
"Cumming (William)",waucummingwilliam2553_2683.xml,80444/xv15625,5,5,11,21
"Barr (Maggie)",waubarrmaggiedaniels3416-001.xml,80444/xv80593,10,3,8,21
"Phi Beta Kappa. Washington Alpha Chapter Records",wauphibetakappawashingtonalphachapterua5060.xml,80444/xv53799,10,4,7,21
"Unknown",waupitterthomasoralhistoryinterview1637.xml,80444/xv79437,5,6,10,21
"Pletner (Irene,)",waupletnerirene5450.xml,80444/xv30560,7,7,7,21
"Cunningham (Imogen) Photographs",waucunninghamimogenphcoll485.xml,80444/xv73327,2,5,14,21
"Bray (Ina) Baltic Community Photograph Collection",waubrayinaph2007_014.xml,80444/xv31030,7,6,8,21
"Lee (Kai)",wauleekainua4133.xml,80444/xv52877,8,5,8,21
"Unknown",waurockerandrewc4013.xml,80444/xv42291,8,5,8,21
"Unknown",waukevillepeter4412.xml,80444/xv78439,5,5,11,21
"Unknown",waunaramorebainbradyjohanson2967.xml,80444/xv71459,5,5,11,21
"Unknown",waunorthernpacificrailroadcompanypacificdivision0017.xml,80444/xv14672,5,7,9,21
"Harry Bridges Center for Labor Studies Union Charters Collection",wauharrybridgescenterlaborstudies5725.xml,80444/xv27227,7,5,9,21
"University of Washington. Physical Plant Dept.",wauuwresource07338.xml,80444/xv61694,7,7,7,21
"Unknown",waupleasantbeachtractsbainbridgeislandwash2806.xml,80444/xv32705,7,4,10,21
"Johnson (Philip G.) Estate and Rosary Heights, Architectural Drawings and Photographs of",waujohnsonphiliprosaryheightsph2009_021.xml,80444/xv98587,5,6,10,21
"Unknown",waupugetsoundhealthsystemsagency3022.xml,80444/xv07733,9,6,6,21
"Ginn (Edward)",wauginnedward0005.xml,80444/xv46917,9,6,6,21
"Arthur (George)",wauarthurgeorgea1619_2053.xml,80444/xv84533,9,5,7,21
"Shipwrecks Photograph Collection",waushipwrecksphcoll1329.xml,80444/xv60772,7,4,10,21
"Miller (Mina) Oral History",waumillermina5658.xml,80444/xv70706,7,6,8,21
"Jacobson (Phillip)",waujacobsonphilliplua5265.xml,80444/xv63876,6,8,6,20
"Halpern Family (Gedaliah) photograph collection",wauhalpernfamilyphcoll753.xml,80444/xv52203,5,6,9,20
"Unknown",waumoyerkeith3997.xml,80444/xv39550,5,7,8,20
"Creel (Wilhelmine)",waucreelwilhelmineua2927.xml,80444/xv04522,5,7,8,20
"University of Washington. Dept. of Orthopaedics. Spine Resource Clinic.",wauuwresource00406.xml,80444/xv76098,11,5,4,20
"Unknown",waunorthwestfundfortheenvironment3760.xml,80444/xv73431,10,2,8,20
"Asia (Hilda)",wauasiahilda3827.xml,80444/xv72079,4,8,8,20
"Fukui (David H.) Architectural Drawings and Papers",waufukuidavidph2016_001.xml,80444/xv33053,8,5,7,20
"Unknown",wauarmsraceconcern5784.xml,80444/xv10528,4,7,9,20
"Bauer (Harry)",waubauerharrycua0874.xml,80444/xv74786,7,2,11,20
"Unknown",waudarreverett2144.xml,80444/xv44750,5,5,10,20
"Unknown",wauhopkinsonewilliam0462.xml,80444/xv30520,6,7,7,20
"Phillips (William)",wauphillipswilliamlua5052.xml,80444/xv34500,7,5,8,20
"Policar (Harry)",waupolicarharry1825.xml,80444/xv80822,5,7,8,20
"Unknown",waukatsmanalvin5324.xml,80444/xv38977,5,5,10,20
"Thompson (Jan Newstrom) Papers",wauthompsonjannewstrom5512.xml,80444/xv27084,7,4,9,20
"Unknown",waumacdonaldkennetha4555.xml,80444/xv03979,9,5,6,20
"Unknown",waufoxjohnm1429.xml,80444/xv14093,7,5,8,20
"Officer (Oscar Samuel) Family Photographs and Ephemera",wauofficerfamilyph2015_020.xml,80444/xv58407,6,4,10,20
"Cheney (Frederick W.) Papers",wauua27_09_2712cheneyfrederick.xml,80444/xv97820,6,4,10,20
"Unknown",wauhilltim3056.xml,80444/xv86630,4,7,9,20
"Hays (Blendine)",wauhaysblendineua4138.xml,80444/xv56521,4,4,12,20
"Unknown",wauconeythelmam2046.xml,80444/xv35998,7,5,8,20
"Barthmaier (Paul)",waubarthmaierpault2696-113.xml,80444/xv04223,6,4,10,20
"Fuller (Richard)",waufullerrichardphcoll1227.xml,80444/xv61718,11,4,5,20
"Block (Robert)",waublockrobertl5448.xml,80444/xv37442,6,6,8,20
"Osawa (Shigeru) Collection of<emph render="italic"> Minidoka Interlude </emph>Photographs",wauosawashigphcoll745.xml,80444/xv66339,7,6,7,20
"Ellis (William)",wauelliswilliamv5520.xml,80444/xv02575,6,8,6,20
"Dean (Harry H.)",waudeanharryhph2014_010.xml,80444/xv27249,4,1,15,20
"Unknown",waupricejack3691.xml,80444/xv37530,8,5,7,20
"Costigan (Giovanni)",waucostigangiovanniphcoll1348.xml,80444/xv58258,7,5,8,20
"Brower (David)",waubrowerdavidrossua3100.xml,80444/xv29348,5,4,11,20
"Horwood (Edgar)",wauhorwoodedgarmua3365.xml,80444/xv86608,3,6,11,20
"Unknown",wauoverlyfredjohn2214.xml,80444/xv34570,2,5,13,20
"Delaware, Lackawanna & Western Railroad Photograph Collection",waudelawarelackawannaphcoll729.xml,80444/xv28778,6,7,7,20
"Unalaska and Aleutian Islands Photograph Album",wauunalaskaaleutianislandsalbumphcoll1313.xml,80444/xv27838,4,7,9,20
"Gowen (Lancelot)",waugowenlancelotedward3579.xml,80444/xv43063,6,8,6,20
"Unknown",waubrownbagtheatreseattlewash5312.xml,80444/xv62750,9,3,8,20
"Unknown",wauiserithomast1589.xml,80444/xv41796,4,7,9,20
"Unknown",waulawsonlilliandubson3135.xml,80444/xv41085,6,3,11,20
"Ekroth (Fair)",wauekrothfairtaylor0689.xml,80444/xv39285,7,6,7,20
"Coughlin (Gilbert) labor button collection",waucoughlingilbert5708.xml,80444/xv73348,7,5,8,20
"Unknown",wauwehnjamesa2353.xml,80444/xv36489,6,6,8,20
"Unknown",wauelkinsmorris4087.xml,80444/xv91513,7,4,9,20
"Allen (Raymond B.) Papers",wauallenraymond1966.xml,80444/xv63903,10,3,7,20
"Burt Co. Cals-I-Dine Products Window Display Photograph Album",wauburtcocalsidinedisplaysph2008_013.xml,80444/xv02841,10,2,8,20
"Unknown",wauseagerallan3559.xml,80444/xv87414,4,7,9,20
"Japanese American Citizens League Photograph Collection",waujapaneseamericancitizensleaguephcoll732.xml,80444/xv06326,6,4,10,20
"Unknown",waujewisheducationcouncilgreaterseattle3255.xml,80444/xv57958,7,5,8,20
"Unknown",wausimpsonwilliam0587.xml,80444/xv77191,8,8,4,20
"Unknown",waubritishcolumbiaindianlanguageproject2479.xml,80444/xv06619,3,4,13,20
"Unknown",waupotterallenr3886.xml,80444/xv26007,5,5,10,20
"Norwood (Gus,)",waunorwoodgus0635_1462_1510_1994.xml,80444/xv82247,3,10,7,20
"Slusher (Ken)",wauslusherkenph2015_008.xml,80444/xv17864,7,4,9,20
"Aoki (Mary)",wauaokimary3416-001.xml,80444/xv10235,4,8,8,20
"Ulrichs (Hermann) Photographs",wauulrichshermannphcoll399.xml,80444/xv30987,9,7,4,20
"Unknown",wauseattleunionrecord4312.xml,80444/xv76934,6,5,9,20
"Unknown",waubirulinannneiss3182.xml,80444/xv29257,9,7,4,20
"Twight (Ben)",wautwightbenw1751_1769_1770.xml,80444/xv54916,6,7,7,20
"Unknown",wauwilliamsjoanfranks5250.xml,80444/xv38119,4,7,9,20
"Unknown",waumontgomeryelizabethrider1335.xml,80444/xv95150,5,5,10,20
"Sather (Evan A.) Photographs of the Klondike Gold Rush",wausatherevanayukongoldrushphcoll764.xml,80444/xv41366,7,3,10,20
"Anderson (Lilly) Photograph Collection",wauandersonlillyphcoll1389.xml,80444/xv71658,5,2,13,20
"Post Alaska-Yukon-Pacific Exposition photograph collection",waupostaypephcoll778.xml,80444/xv39624,7,7,6,20
"Unknown",waumartinzambitofineart5295.xml,80444/xv67910,9,4,7,20
"Chappell (Lillian)",wauchappelllillianiyall3416-001.xml,80444/xv40029,6,2,12,20
"Anderson (George)",wauandersongeorgecua4562.xml,80444/xv21609,7,5,8,20
"Niblack (Albert P.) Photographs",wauniblackalbertparkerphcoll321.xml,80444/xv96875,0,11,9,20
"Unknown",waurubensboris2797.xml,80444/xv68814,7,4,9,20
"Maslan (Florence) Photograph Collection",waumaslanflorencephcoll1077.xml,80444/xv15853,2,7,11,20
"University of Washington School of Drama Records",wauuwresource00289.xml,80444/xv48519,6,2,12,20
"Meltzer (Sidney)",waumeltzersidneyz3297.xml,80444/xv55624,6,7,7,20
"Henry M. Jackson School of International Studies Records",wauuwresource00280.xml,80444/xv05017,3,3,14,20
"Unknown",wauhartnettmauricea5093.xml,80444/xv42645,10,4,6,20
"Unknown",wauswainphilipb4319.xml,80444/xv38830,0,6,14,20
"Brown (Judith)",waubrownjudithgracekeyser3416-001.xml,80444/xv48373,9,3,8,20
"Unknown",waubathhousetheatre4358.xml,80444/xv65957,5,6,9,20
"Unknown",waubirulinsol3733.xml,80444/xv43774,4,5,11,20
"Henry (William)",wauhenrywilliame4167.xml,80444/xv47045,8,5,7,20
"Unknown",waustaadeckerwilliamb3206.xml,80444/xv53717,8,4,8,20
"Henry L. Yesler Estate, Inc.",wauhenrylyeslerestateinc0432_1523.xml,80444/xv41625,2,8,10,20
"Macy (Preston P.) Papers",waumacypreston3211.xml,80444/xv57464,5,11,4,20
"Babcock (William) Photograph Collection",waubabcockwilliamphcoll180.xml,80444/xv28170,4,6,10,20
"Unknown",wauhemlocksociety4270.xml,80444/xv13610,3,8,9,20
"McNeil Island Penitentiary Photographs",waumcneilislandpenitentiaryphcoll1304.xml,80444/xv30801,8,7,5,20
"Zaslove (Arne)",wauzaslovearne5807.xml,80444/xv91445,9,5,6,20
"Unknown",waufootehopelucille2502.xml,80444/xv74069,8,7,5,20
"Unknown",waucivilianconservationcorpsus1351.xml,80444/xv13070,5,11,4,20
"Katz (Max)",waukatzmax3247.xml,80444/xv52792,2,9,9,20
"Sleicher (Charles)",wausleichercharlesaua3388.xml,80444/xv09823,7,4,9,20
"Hayner (Norman)",wauhaynernormansua2706.xml,80444/xv99948,7,10,3,20
"Unknown",waubenaroyasamuel3911.xml,80444/xv30609,4,7,9,20
"Unknown",waumunksfamily2239.xml,80444/xv89035,5,6,9,20
"Woolston (Howard)",wauwoolstonhowardbrown1400.xml,80444/xv54620,5,7,8,20
"Association of Librarians of the University of Washington Records",wauassociationoflibrariansoftheuniversityofwashingtonua3304.xml,80444/xv05920,6,6,8,20
"Brewer (Stanley)",waubrewerstanleyhua1860.xml,80444/xv62139,4,7,9,20
"Unknown",waucoalitionforqualityintegratededucationseattlewash3130.xml,80444/xv22482,6,8,6,20
"University of Washington Center on Human Development and Disability Records",wauuwresource00112.xml,80444/xv36105,6,7,7,20
"Unknown",wauseattleactionforsovietjewry3904.xml,80444/xv23022,9,2,9,20
"Friedmann (Madelaine)",waufriedmannmadelaine5451.xml,80444/xv80535,6,8,6,20
"Federal Theatre Project Photograph Collection",waufederaltheaterphcoll455.xml,80444/xv15377,7,8,5,20
"Schmitz (Henry,)",wauschmitzhenryua0529.xml,80444/xv53863,4,4,12,20
"Unknown",wauherzlconservativecongregationseattlewash2884.xml,80444/xv86764,12,3,5,20
"Brady (Jerry) papers",waubradyjerry5964.xml,80444/xv74368,5,7,8,20
"Forest Fire Fighting Photographs",wauforestfirefightingphcoll863.xml,80444/xv64050,6,8,6,20
"University of Washington. School of Dentistry.",wauuwresource00354.xml,80444/xv53460,8,5,7,20
"McComb Family Papers",waumccombfamily5783.xml,80444/xv09323,6,8,6,20
"Case and Draper Alaska Photographs",waucaseanddraperphcoll301.xml,80444/xv06967,5,10,5,20
"Unknown",waucowlesalfrede2139.xml,80444/xv65991,6,2,12,20
"Curtis Studio Arctic Club portratit photographs",wauarcticclubphcoll512.xml,80444/xv72967,6,6,8,20
"Unknown",wauniatumduane2090.xml,80444/xv93814,6,4,10,20
"Unknown",waumoranjohnm1604.xml,80444/xv99014,8,7,5,20
"Unknown",wautemplebnaitorahmercerislandwash3901.xml,80444/xv26660,9,6,5,20
"Yukon Diary and Photographs",wauyukondiaryandphotographs5550.xml,80444/xv73562,6,6,8,20
"Marshall (William)",waumarshallwilliami4213.xml,80444/xv97714,5,4,11,20
"Shafer Family Photograph Collection",waushaferfamilyphcoll1084.xml,80444/xv13821,6,8,6,20
"Unknown",wauwashingtonpublicutilitydistrictsassociation0181.xml,80444/xv80343,4,5,11,20
"Bostetter (Edward)",waubostetteredwardeua2713.xml,80444/xv62130,3,7,10,20
"Unknown",wauvognildrussello0482.xml,80444/xv95544,8,7,5,20
"Bliss (Heather) linguistic research on the Blackfoot language",waublissheather2696-136.xml,80444/xv89196,2,8,10,20
"History",waupricetruman0519.xml,80444/xv64041,3,9,8,20
"Unknown",waulevineraphaelh2532.xml,80444/xv64593,7,4,9,20
"Unknown",waunicholsonpatriciakirkpatrick2425.xml,80444/xv50949,7,4,9,20
"Sytman, Alexander Oral History Interview",wausytmanalexander5832.xml,80444/xv27258,4,6,10,20
"Daniels (Joseph) Photograph Collection",waudanielsjosephph2005_048.xml,80444/xv63558,4,12,4,20
"Unknown",wauleagueofwomenvotersofpugetsound1369.xml,80444/xv52197,2,6,12,20
"B'nai B'rith Hillel Foundation Records",waubnaibrithhillelfoundationuw2338.xml,80444/xv83523,9,7,4,20
"Conway (John A.) Photograph Collection",wauconwayjohnph2004_077.xml,80444/xv79092,5,8,7,20
"Unknown",wauhemekeverlefrancis3965.xml,80444/xv96234,10,4,6,20
"Clark (Irving)",wauclarkirvingmjr2663.xml,80444/xv66342,3,8,9,20
"Unknown",waustubhansandreas3535.xml,80444/xv41650,1,10,9,20
"Suttles (Wayne) papers",wausuttleswaynep5202.xml,80444/xv41159,4,12,4,20
"Seattle City Light Projects",wauseattlecitylightphotosphcoll1124.xml,80444/xv30221,8,7,5,20
"Fujii (Yoshito) Papers",waufujiiyoshito1582_2.xml,80444/xv60200,9,2,9,20
"Unknown",waugotodelores2647.xml,80444/xv70742,5,6,9,20
"Seattle Women Act for Peace Photograph Collection",wauseattlewomenactforpeacephcoll629.xml,80444/xv58871,9,5,6,20
"Unknown",wauharringtonwilliaml3465.xml,80444/xv36697,4,8,8,20
"Bergman (Abraham)",waubergmanabrahambua4177.xml,80444/xv18225,5,6,9,20
"Unknown",wauhowesoundminingcompanyholdenvillagewash1014.xml,80444/xv88272,4,9,7,20
"Judkins (D.R) Oak Harbor Photographs",waujudkinsdroakharborphcoll1352.xml,80444/xv78671,6,5,9,20
"Hunt (Robert)",wauhuntrobertsua2371.xml,80444/xv47592,7,7,6,20
"Condon (Herbert T.) photographs of",waucondonherberttphcoll1355.xml,80444/xv18634,5,7,8,20
"Demers (Richard)",waudemersricharda2207.xml,80444/xv97888,2,10,8,20
"Monte Cristo Photograph Album",waumontecristophcoll415.xml,80444/xv08294,8,7,5,20
"Lott (Manuel) Oral History",waulottmanuel5700.xml,80444/xv28082,5,5,9,19
"University of Washington. Regional Primate Research Center.",wauuwresource05825.xml,80444/xv62033,2,9,8,19
"Bailey (Winona)",waubaileywinona2989.xml,80444/xv71115,4,10,5,19
"University of Washington Equal Opportunity Office Records",wauuwresource00197.xml,80444/xv24795,8,4,7,19
"Harborview Medical Center (Seattle, Wash.). General Accounting Dept.",wauuwresource00472.xml,80444/xv95651,7,5,7,19
"Cordell (Pauline)",waucordellpaulinew1655_1661.xml,80444/xv94274,7,7,5,19
"Unknown",wauhunsakerjanechandler1202.xml,80444/xv91336,11,4,4,19
"Langlie (Arthur)",waulangliearthurb0061_1327.xml,80444/xv93112,2,10,7,19
"Unknown",waupattersonwilliamt0709.xml,80444/xv99880,4,5,10,19
"University of Washington. School of Oceanography.",wauuwresource00450.xml,80444/xv15832,3,9,7,19
"Unknown",waulockwooddavide0163.xml,80444/xv77105,3,6,10,19
"Unknown",wauhartsteinlaura4148.xml,80444/xv85360,5,5,9,19
"Unknown",waudarmsted2843.xml,80444/xv47781,8,1,10,19
"Unknown",waulevylouisaf2365.xml,80444/xv21533,4,4,11,19
"Unknown",waukpluradio4342.xml,80444/xv26553,5,7,7,19
"Unknown",wautestujeanette0518.xml,80444/xv27804,6,6,7,19
"Sondland (Frieda) Oral History",wausondlandfrieda5616.xml,80444/xv01931,6,6,7,19
"Peck (Cornelius)",waupeckcorneliusjua4435.xml,80444/xv07421,3,11,5,19
"Unknown",wauicelandicliberalchurchseattlewash3451.xml,80444/xv77053,3,6,10,19
"Unknown",wauransomjayellis3292.xml,80444/xv13906,9,6,4,19
"American Protective League. Minute Men Division. Precinct 1 (Seattle, Wash.).",wauamericanprotectiveleagueminutemendivisionprecinct1_4288.xml,80444/xv56851,2,7,10,19
"University of Washington. Clinical Research Center.",wauuwresource00225.xml,80444/xv78036,6,8,5,19
"Unknown",waumetropolitanbuildingcompanyua1297.xml,80444/xv05624,7,8,4,19
"Tuohy (Albert) papers",wautuohyalbert5814.xml,80444/xv81439,11,4,4,19
"Unknown",wauvanhoeckeallan2432.xml,80444/xv96777,6,7,6,19
"Kirk (Ruth)",waukirkruthm2939.xml,80444/xv36215,5,7,7,19
"Columbia Basin Inter-Agency Committee.",waucolumbiabasininteragencycommittee1198_1659.xml,80444/xv09658,4,7,8,19
"Unknown",waumaimonisaac3528.xml,80444/xv29702,4,6,9,19
"Unknown",waukaiserethelchaikenlippman3040.xml,80444/xv06268,6,5,8,19
"Greene (Richard)",waugreenerichardac1412_1427.xml,80444/xv25933,4,9,6,19
"Fromme (Rudo) Photograph Collection",waufrommerudophcoll920.xml,80444/xv26037,6,6,7,19
"Ebey (Winfield Scott) Photograph Collection",wauebeywinfieldph2004_051.xml,80444/xv55456,10,8,1,19
"King County (Wash.). Dept. of Public Works.",waukingcountypublicworks1375.xml,80444/xv81579,4,4,11,19
"Degginger (Craig,)",waudeggingercraig5462.xml,80444/xv32250,5,7,7,19
"Ruch (Theodore Cedric) Papers",wauruchtheodorecedricua2599.xml,80444/xv69342,12,6,1,19
"Unknown",waustudentsforademocraticsocietyus1080.xml,80444/xv72317,7,5,7,19
"Unknown",waulevyregina2780.xml,80444/xv33163,5,4,10,19
"Fitzpatrick (Joan,)",waufitzpatrickjoanua5348.xml,80444/xv20089,5,6,8,19
"Hartson (Nelson T.) Photograph Collection",wauhartsonnelsphcoll406.xml,80444/xv21145,6,6,7,19
"<emph> Klondike: A Manual for Goldseekers </emph> Collection",wauklondikemanualphcoll597.xml,80444/xv01377,8,6,5,19
"Fiedler (Fred)",waufiedlerfrededwardua4176.xml,80444/xv09362,4,5,10,19
"Seattle Jewish Youth Council.",wauseattlejewishyouthcouncil5499.xml,80444/xv48651,6,5,8,19
"Unknown",wauuwresource06079.xml,80444/xv44143,4,5,10,19
"Unknown",wautemplebethamseattlewash1917.xml,80444/xv59579,8,6,5,19
"Yukon Territory Photograph Album",wauyukonterritoryphcoll041.xml,80444/xv39971,7,2,10,19
"Unknown",waujosephstephen5221.xml,80444/xv53829,2,5,12,19
"Ruth and Louis Kirk moving images",waukirkruthlouismovingimagecollectionphcoll1000.xml,80444/xv83395,10,1,8,19
"Unknown",wauseagravemabel4551.xml,80444/xv32437,5,7,7,19
"Benditt (Earl)",waubendittearlpua4574.xml,80444/xv73895,2,6,11,19
"Hyman (David) Photograph Collection",wauhymandavidphcoll905.xml,80444/xv87332,9,5,5,19
"Meitzler (Neil) Papers",waumeitzlerneil2571_2637_2761.xml,80444/xv70129,5,6,8,19
"Coombs (Howard)",waucoombshowardaua4458.xml,80444/xv77929,5,7,7,19
"Unknown",wauleagueoffringetheaters5359.xml,80444/xv53364,6,3,10,19
"Blankinship (Donna)",waublankinshipdonnagordon5471.xml,80444/xv62127,5,3,11,19
"Unknown",wauobrienrobertw2420.xml,80444/xv11260,5,4,10,19
"Ellingsen (Erling Olav) Photograph Collection",wauellingsenerlingolavphcoll303.xml,80444/xv38543,7,8,4,19
"Unknown",wausalzerlisel2672.xml,80444/xv28219,2,11,6,19
"Haynes (F. Jay & Brothers) Photograph Album",waufjayhaynesandbrophcoll614.xml,80444/xv60885,2,10,7,19
"Skagit County Public Utility District No. 1 (Wash.).",wauskagitcountypublicutilitydistrictno1_0403.xml,80444/xv46810,6,4,9,19
"Egypt",wauegyptphotographsphcoll1200.xml,80444/xv16018,12,6,1,19
"China Club of Seattle.",wauchinaclubofseattle1093_1364.xml,80444/xv15017,5,7,7,19
"Wright (Vim) Papers",wauwrightvimua4106.xml,80444/xv72778,10,4,5,19
"Delta Chi Fraternity, University of Washington Chapter Records",waudeltachifraternityua5724.xml,80444/xv10250,6,2,11,19
"Unknown",waujacksonstreetregradephcoll1319.xml,80444/xv50460,5,6,8,19
"University of Washington, Center on Human Development and Disability, Experimental Education Unit records",wauuwresource00271.xml,80444/xv73452,5,7,7,19
"Unknown",waurabinowitzalan3689.xml,80444/xv70419,3,5,11,19
"Simon (Phil) Oral History",wausimonphilip5608.xml,80444/xv09875,6,6,7,19
"Unknown",waustarkovichgeorge0305.xml,80444/xv48828,8,5,6,19
"Unknown",waujewishdayschoolofmetropolitanseattle3806.xml,80444/xv52575,4,7,8,19
"Unknown",wauthompsonnile2552.xml,80444/xv36044,6,8,5,19
"Cross (Paul)",waucrosspaulcua2928.xml,80444/xv43246,4,6,9,19
"Bonica (John)",waubonicajohnjua2917.xml,80444/xv84802,5,2,12,19
"Unknown",wauknappdillischarles2902.xml,80444/xv08596,5,6,8,19
"Unknown",waubarkloisimogene3564.xml,80444/xv99636,3,6,10,19
"Unknown",waubilimoriaeleanordanner3748.xml,80444/xv58175,5,5,9,19
"Remick (Helen) Papers",wauremickhelenua5225.xml,80444/xv11465,5,7,7,19
"Sprincin (Helen Rogers Waldbaum) photograph collection",wausprincinhelenrogerswaldbaumphcoll1166.xml,80444/xv78567,6,8,5,19
"Savery (William,)",wausaverywilliamua0608.xml,80444/xv97274,5,5,9,19
"Unknown",wauolsonronaldl2506.xml,80444/xv05981,4,11,4,19
"Root (Colleen) Photograph Collection",waurootcolleenphcoll555.xml,80444/xv62899,6,5,8,19
"Unknown",wauhumphreywilliame0902.xml,80444/xv46157,5,6,8,19
"Hewitt (Edwin,)",wauhewittedwinua4112.xml,80444/xv05380,4,9,6,19
"Unknown",wauworldwithoutwarcouncilofgreaterseattle2754.xml,80444/xv94046,7,8,4,19
"Book of SOYP Photograph Collection",waubookofsoypphcoll370.xml,80444/xv51993,14,4,1,19
"Unknown",waucohnmerled3705.xml,80444/xv97912,6,7,6,19
"Unknown",wauclarket3548.xml,80444/xv12530,9,6,4,19
"Collectors Club of Seattle Ephemera Collection",waucollectorsclubofseattlephcoll656.xml,80444/xv82432,11,5,3,19
"Unknown",waumcconnellgrant4325.xml,80444/xv11041,2,11,6,19
"Denton (Denice) papers",waudentondeniceua5716.xml,80444/xv49832,7,6,6,19
"Unknown",waujohnsonainae2962.xml,80444/xv49838,1,6,12,19
"Kittitas Gold Mining Company correspondence and other material",waukittitasgoldminingcompany5549.xml,80444/xv48117,8,3,8,19
"Unknown",wauwhitejamest4966.xml,80444/xv61840,4,6,9,19
"Unknown",wauseattlerepertoryplayhouse1556.xml,80444/xv74606,6,7,6,19
"Unknown",wauwashingtonstatejewishhistoricalsocietylandmarkscommittee3128.xml,80444/xv72039,2,5,12,19
"Unknown",waufeinbergjacob1550.xml,80444/xv48413,6,6,7,19
"Unknown",waugilmorehughp0690.xml,80444/xv44039,9,5,5,19
"Unknown",wauharstineislandcommunityclub5882.xml,80444/xv06372,7,5,7,19
"Norouzi (Fereydoon,)",waunorouzifereydoon5455.xml,80444/xv01867,4,7,8,19
"Swanstrom (Mrs. Frederick) collection of South Canal photographs",wauswanstromcanalphotographsphcoll1177.xml,80444/xv81793,13,2,4,19
"Black (Deirdre)",waublackdeirdre2696-101.xml,80444/xv35833,3,7,9,19
"Ajax Builders Photograph Collection",wauajaxbuildersphcoll1357.xml,80444/xv63900,3,5,11,19
"Bronowski (Jacob,)",waubronowskijacob5087.xml,80444/xv96237,5,7,7,19
"Bradley (Robert) Photographs",waubradleyrobertphcoll179.xml,80444/xv71630,4,6,9,19
"Gilman (Herman) Collection on Farmworker Organizing in Washington State",waugilmanherman5951.xml,80444/xv56228,7,7,5,19
"Unknown",waufukudafranktokichi1474.xml,80444/xv44927,6,5,8,19
"Unknown",wauflaksflorence2519.xml,80444/xv12057,4,8,7,19
"Erickson (Dick,)",wauericksondickua3387.xml,80444/xv50823,6,2,11,19
"KCMU (Radio station : Seattle, Wash.).",wauuwresource00141.xml,80444/xv16519,4,5,10,19
"Unknown",wauchristensengeorgefrancis0609.xml,80444/xv73162,6,6,7,19
"Barr (Jacqueline) Photograph Collection",waubarrjacquelinephcoll1055.xml,80444/xv67330,4,4,11,19
"Griffin (Eldon,)",waugriffineldonua1401.xml,80444/xv86102,5,6,8,19
"Unknown",wauwashingtoncommitteeforacademicfreedom5120.xml,80444/xv84680,9,3,7,19
"Fletcher (Rillie) Photograph Collection",waufletcherrilliephcoll680.xml,80444/xv11294,7,8,4,19
"Unknown",waubaileygeorgec1990.xml,80444/xv56567,3,6,10,19
"Mattina (Anthony)",waumattinaanthony1835_2696-003.xml,80444/xv92733,4,6,9,19
"Ritchie (W. A.) Papers",wauritchiewa5713.xml,80444/xv50152,8,7,4,19
"Katims (Milton) collection of music scores",waukatimsmilton5530.xml,80444/xv60833,7,4,8,19
"Washington State Localities Postcard Collection",wauwashingtonlocalitiespostcardsphcoll799.xml,80444/xv20559,9,7,3,19
"Unknown",waujassencharles2877.xml,80444/xv64718,4,1,14,19
"Landes (Henry,)",waulandeshenryua0075.xml,80444/xv40930,6,8,5,19
"Cooper (Harriet)",waucooperharriet3416-001.xml,80444/xv07708,6,6,7,19
"Swedish American Church Archives.",wauswedishamericanchurcharchives2529.xml,80444/xv13525,4,3,12,19
"Unknown",waupricerutha5004.xml,80444/xv94473,4,8,7,19
"Unknown",wauwherrettewilliamcarnes2942.xml,80444/xv36337,7,3,9,19
"Thompson (Laurence)",wauthompsonlaurencec1835.xml,80444/xv70220,4,5,10,19
"Block (Dorothy)",waublockdorothy2782.xml,80444/xv69491,7,7,5,19
"Unknown",wauphillipsnikkidawn3750.xml,80444/xv75750,3,5,11,19
"McLean (Mildred Evans) papers",waumcleanmildredevans5810.xml,80444/xv16159,6,4,9,19
"Gorbman (Aubrey) Papers",waugorbmanaubreyua4582.xml,80444/xv28207,2,1,16,19
"Unknown",waudavisgeorgina2326.xml,80444/xv41110,5,7,7,19
"Unknown",wauuwresource00333.xml,80444/xv53845,9,5,5,19
"Poole (Jessie) Photograph Album",waupoolejessiephcoll785.xml,80444/xv43850,11,6,2,19
"Alexander (Ira) papers",waualexanderira5870.xml,80444/xv04357,5,5,9,19
"Seattle Federation of Women's Clubs",wauseattlefederationwomensclubsphcoll897.xml,80444/xv30627,6,8,5,19
"Willatsen (Andrew) Family Photograph Album",wauwillatsenandrewfamilyphotographalbumphcoll044.xml,80444/xv97213,6,7,6,19
"Unknown",wautrowbridgefamily1980.xml,80444/xv08160,2,7,10,19
"Unknown",waucongregationbethshalomseattlewash5398.xml,80444/xv62155,7,5,7,19
"Jennings (Arlene)",waujenningsarlenevirginia5302.xml,80444/xv78091,7,4,8,19
"Unknown",wauuwresource07390.xml,80444/xv71487,4,6,9,19
"Doran (Hazel)",waudoranhazelhelenpreston3416-001.xml,80444/xv03479,1,8,10,19
"Unknown",wauremingtonarthur0220.xml,80444/xv74154,5,8,6,19
"Hoffman (Katherine,)",wauhoffmankatherineua2455.xml,80444/xv94192,7,6,6,19
"Unknown",waumiyagawadaishod1175.xml,80444/xv02618,6,8,5,19
"Spokane Indian tintype collection",wauspokaneindiantintypephcoll1102.xml,80444/xv92141,7,2,10,19
"Unknown",waujorgensenalfhild4078.xml,80444/xv57275,6,6,7,19
"University of Washington School of Law Associate Dean Records",wauuwresource05709.xml,80444/xv56423,8,5,6,19
"Silver Family Photograph Collection",wausilverfamilyphcoll1086.xml,80444/xv48858,6,5,8,19
"Johnson (Walter)",waujohnsonwaltergilbertua3326.xml,80444/xv19714,5,8,6,19
"Gray (Maxine Cushing) Photograph Collection",waugraymaxineph2005_067.xml,80444/xv15289,3,7,9,19
"Unknown",waubridgebenjaminm2314.xml,80444/xv16275,7,5,7,19
"Taylor (Fannie E.) Photographs",wautaylorfannieephcoll678.xml,80444/xv16226,6,7,6,19
"Unknown",wauuwresource07247.xml,80444/xv05413,7,7,5,19
"Congregation Bikur Cholim (Seattle, Wash.). Yavneh Branch.",waucongregationbikurcholim2878.xml,80444/xv00790,6,6,7,19
"Scheingold (Stuart)",wauscheingoldstuartaua5247.xml,80444/xv87915,3,7,9,19
"Yockey (Roger)",wauyockeyroger5825.xml,80444/xv41186,7,7,5,19
"Unknown",waujosendalvictor4263.xml,80444/xv11300,7,6,6,19
"Haag (Richard)",wauhaagrichardua3774.xml,80444/xv19827,5,6,8,19
"Magnuson (Warren G.) Photographs",waumagnusonwarrengphcoll638.xml,80444/xv97964,4,4,11,19
"University of Washington. Office of Financial Management.",wauuwresource00188.xml,80444/xv91723,8,5,6,19
"Stub family",waustubfamily2376.xml,80444/xv57342,4,9,6,19
"Unknown",waupacificnorthwestriverbasinscommission2760.xml,80444/xv44265,2,7,10,19
"Lawson (Ellen)",waulawsonellennickenzieua4993.xml,80444/xv08532,3,10,6,19
"Bainbridge (Clark N.) Research Files",waubainbridgeclarkn5898.xml,80444/xv56503,3,5,10,18
"Evans (George Watkin) Gold Mining Photographs",wauevansgeorgephcoll636.xml,80444/xv56097,7,6,5,18
"Unknown",wauokrentrichardt3695.xml,80444/xv53216,3,7,8,18
"Galbraith (Victor) AYPE Photograph Collection",waugalbraithvictoraypephcoll369.xml,80444/xv05059,4,7,7,18
"Fir Tree (University of Washington).",waufirtree3340.xml,80444/xv16436,6,5,7,18
"Bosworth (Thomas L.) papers",waubosworththomasl4508.xml,80444/xv18554,6,2,10,18
"Isaacs (Walter) Paintings Color Transparency Photographs",wauisaacswalterph2015_019.xml,80444/xv81576,6,5,7,18
"Collie (Ross F.)",waucollierossfua5824.xml,80444/xv50256,7,4,7,18
"Unknown",wauredingtonjohnw0125.xml,80444/xv73110,5,5,8,18
"Johanson (Joel)",waujohansonjoelmua0363.xml,80444/xv33166,6,4,8,18
"Unknown",wauvaronlaura4017.xml,80444/xv70315,6,3,9,18
"Husky Marching Band Photographs",wauuwresource05657.xml,80444/xv37490,5,5,8,18
"Jewish Family Service Photograph Collection",waujewishfamilyserviceph2015_006.xml,80444/xv45498,8,4,6,18
"Unknown",wauthomasonthomas0978.xml,80444/xv43032,9,6,3,18
"Unknown",wauhowarddavidch2433.xml,80444/xv82666,10,3,5,18
"Sonia Spear Oral History",wauspearsonia5606.xml,80444/xv63232,5,5,8,18
"Smith (George)",wausmithgeorgeotis1662_2321.xml,80444/xv90753,3,8,7,18
"Battson (Glenn Edwin) film collection",waubattsonglennephcoll923.xml,80444/xv79135,6,4,8,18
"Lyon (John) Papers",waulyonjohn2696.xml,80444/xv17453,5,4,9,18
"Hildeman (Karl-Ivar)",wauhildemankarlivar2524.xml,80444/xv18496,5,7,6,18
"Harsch (Alfred)",wauharschalfredeua1275.xml,80444/xv63806,5,4,9,18
"Unknown",wauroederhenry4869.xml,80444/xv87686,3,11,4,18
"Winkenwerder, Hugo, b. 1878.",wauwinkenwerderhugoua0906.xml,80444/xv83535,7,6,5,18
"Hotel Olympian Photograph Collection",wauhotelolympianphcoll396.xml,80444/xv43371,14,0,4,18
"Unknown",waujassensonia2906.xml,80444/xv26168,4,7,7,18
"Kahan (Isidore) Photograph Collection",waukahanisidorephcoll1073.xml,80444/xv03005,3,3,12,18
"University of Washington Northwest Center for Occupational Health and Safety Records",wauuwresource07412.xml,80444/xv33438,3,5,10,18
"Davis (Robert)",waudavisrobertlua5267.xml,80444/xv66226,6,6,6,18
"Unknown",wausvaretrygveo2421.xml,80444/xv22897,12,3,3,18
"Unknown",wauwachtinsonia3139.xml,80444/xv60122,7,7,4,18
"Condon (John)",waucondonjohnthomasua5107.xml,80444/xv30541,3,7,8,18
"Zema (Gene) Photograph Collection",wauzemagenephcoll401.xml,80444/xv78640,6,6,6,18
"Pride Foundation Ephemera Collection",waupridefoundationseattlewash5664.xml,80444/xv91601,7,3,8,18
"Unknown",wauhainespackingcompany1135.xml,80444/xv84436,7,8,3,18
"Savage (George Milton) Photograph Collection",wausavagegeorgemphcoll229.xml,80444/xv03579,5,4,9,18
"Harborview Medical Center (Seattle, Wash.). Social Work Dept.",wauuwresource07364.xml,80444/xv61865,5,5,8,18
"Miller (Pendleton) Photograph Collection",waumillerpendletonphcoll344.xml,80444/xv40866,4,7,7,18
"Miller (Pleasant A.) Native American Photographs",waumillerphcoll717.xml,80444/xv60928,7,5,6,18
"Unknown",wausilverfamily1826.xml,80444/xv33035,3,4,11,18
"Oppenheimer (Marcus)",wauoppenheimermarcus1447_1507.xml,80444/xv65521,4,4,10,18
"Jenkins (Mark)",waujenkinsmarkfua5180.xml,80444/xv79022,8,5,5,18
"Unknown",waudanzfamily2688.xml,80444/xv80349,2,5,11,18
"Unknown",wauwolfegertrudepearl2417.xml,80444/xv56832,2,9,7,18
"Unknown",waulesterevelyn1784.xml,80444/xv12438,2,6,10,18
"Unknown",waumillikinwilliamearl0219.xml,80444/xv07348,5,4,9,18
"Randlett (Mary) Photographs of Seattle Artists",waurandlettmaryphcoll127.xml,80444/xv53564,10,3,5,18
"B'nai B'rith. Lodge 757 (Aberdeen, Wash.).",waubnaibrithlodge757_2362.xml,80444/xv06515,4,5,9,18
"University of Washington, Department of Women Studies Records",wauuwresource00323.xml,80444/xv48400,7,7,4,18
"Guthrie (Edwin)",wauguthrieedwinr1433.xml,80444/xv21603,6,5,7,18
"Compton (Brian)",waucomptonbriandouglas2696_2696-089.xml,80444/xv64605,3,3,12,18
"Layman (Earl) papers",waulaymanearld5791.xml,80444/xv02529,5,7,6,18
"Priestly (W.E.) Views of Alaska Photograph Album",waupriestlywephcoll373.xml,80444/xv89071,6,6,6,18
"Unknown",wauspencerralph2635.xml,80444/xv11233,1,5,12,18
"Belvin (Robert)",waubelvinroberts2696-069.xml,80444/xv35888,3,6,9,18
"Health and Welfare Council of Seattle and King County.",wauhealthandwelfarecouncilofseattleandkingcounty2258.xml,80444/xv45339,2,6,10,18
"Unknown",wauhopgrowersassociationofsnoqualmiewashington4757.xml,80444/xv74148,10,3,5,18
"Huntington (Virginia) Photograph Collection",wauhuntingtonvirginiaphcoll90.xml,80444/xv95669,5,5,8,18
"Israel Bonds Photograph Collection",wauisraelbondsphcoll1131.xml,80444/xv38003,2,6,10,18
"Unknown",wauskowronskihella2735.xml,80444/xv83859,8,5,5,18
"Unknown",waukosinlouis2603.xml,80444/xv19116,6,5,7,18
"Unknown",waucarlsonann0493.xml,80444/xv66116,12,2,4,18
"Thompson (Edwin C.) Seattle's World's Fair Home Movie",wauthompsonedwincphcoll821.xml,80444/xv51129,7,5,6,18
"Unknown",waustoppseleanor4563.xml,80444/xv52911,9,4,5,18
"Perryman (Charles)",wauperrymancharlesfilmsphcoll1288.xml,80444/xv08734,8,3,7,18
"No Oilport",waunooilport3614.xml,80444/xv23681,5,4,9,18
"Harbor Properties Photograph Collection",wauharborpropertiesph2013_002.xml,80444/xv37115,6,6,6,18
"Rieder (Ross) Audio and Video Collection",wauriederross5930.xml,80444/xv96939,5,7,6,18
"Baar (Edward J.) photograph and slide collection",waubaaredwardjph2014_011.xml,80444/xv17523,6,8,4,18
"Carbaugh (Donal)",waucarbaughdonala2696-124.xml,80444/xv67813,5,5,8,18
"Henry M. Jackson School of International Studies. Jewish Studies Program.",wauuwresource00282.xml,80444/xv31542,7,5,6,18
"Unknown",wauwhetzeljonathanf2095.xml,80444/xv41531,6,2,10,18
"Ludden (A.) photographs",wauluddenaphcoll1128.xml,80444/xv12380,3,8,7,18
"Unknown",waucaminitibenella4021.xml,80444/xv14523,12,3,3,18
"Souvenir of Mazama Outing 1902",waumazamasoutingphcoll1041.xml,80444/xv02951,5,4,9,18
"PONCHO (Organization : Seattle, Wash.).",wauponcho4228.xml,80444/xv59545,4,5,9,18
"Unknown",wauwilsonanddunlap4973.xml,80444/xv71542,2,6,10,18
"Whitworth (George F.) Family Photograph Collection",wauwhitworthfamilyph2010_014.xml,80444/xv90545,4,4,10,18
"Capeluto (Ralph)",waucapelutoralph3690.xml,80444/xv04620,3,6,9,18
"Boyden (Edward)",wauboydenedwardaua2592.xml,80444/xv44204,4,6,8,18
"Unknown",waubirdjohnl2130.xml,80444/xv98269,8,3,7,18
"Unknown",waurobertsmilnor0563_1682.xml,80444/xv55389,3,2,13,18
"Unknown",wauoconnorharvey3799.xml,80444/xv50836,7,5,6,18
"Unknown",wauclancyjoseph2218.xml,80444/xv47265,6,5,7,18
"Unknown",wauwilsonfamily4974.xml,80444/xv14044,11,2,5,18
"Unknown",waufriedmansusiem2115.xml,80444/xv95156,4,5,9,18
"Kunstadter (Peter) Photograph and Moving Image Collection",waukunstadterpeterphcoll1139.xml,80444/xv42349,8,4,6,18
"Bocker Photograph Collection",waubockerphcoll243.xml,80444/xv18533,4,8,6,18
"Pearce (J.)",waupearcejkennethua1718.xml,80444/xv17721,4,7,7,18
"Dental Wives' Club (University of Washington).",waudentalwivesclub4153.xml,80444/xv22216,3,5,10,18
"Weingarten (Marianne)",wauweingartenmarianne5820.xml,80444/xv71261,6,5,7,18
"Peden (Irene)",waupedenirenecarswellua2595.xml,80444/xv16882,4,6,8,18
"University of Washington Recreational Sports Programs Records",wauuwresource00156.xml,80444/xv44478,5,9,4,18
"Regional Music",wauregionalmusic5523.xml,80444/xv51962,5,4,9,18
"Carlson (Dale)",waucarlsondaleaua4505.xml,80444/xv25125,5,6,7,18
"Unknown",waujonesclarenceh0597.xml,80444/xv23175,7,3,8,18
"Unknown",waufriendsofdiscoveryparkseattlewash2755.xml,80444/xv75039,5,6,7,18
"University of Washington. School of Social Work. Continuing Education Office.",wauuwresource00435.xml,80444/xv06698,6,4,8,18
"Unknown",wauflashphilipnathan5143.xml,80444/xv65789,6,4,8,18
"Kim (Eun-Sook,)",waukimeunsook2696-127.xml,80444/xv39492,5,5,8,18
"Unknown",wauharrisrose3532.xml,80444/xv14617,3,9,6,18
"Unknown",wausteinhardthenry2766.xml,80444/xv41503,9,5,4,18
"Unknown",waubrotmandarylm3161.xml,80444/xv82620,2,6,10,18
"Unknown",waudarringtonpioneersexchange0285.xml,80444/xv30532,2,4,12,18
"Booker (Karen)",waubookerkarenm2696-040.xml,80444/xv45864,3,7,8,18
"Unknown",wauoslerwilliam5220.xml,80444/xv84710,5,7,6,18
"Clifford (Bill) Audiocassettes of Ottilie Markholt's Memorial",waucliffordbill5949.xml,80444/xv30169,5,6,7,18
"Unknown",wauyarbrougharlinej5263.xml,80444/xv17559,6,8,4,18
"Unknown",wausteinben1916.xml,80444/xv15936,0,9,9,18
"Unknown",waubehmfranklinf0848.xml,80444/xv51593,2,7,9,18
"Unknown",waudicomesdeanna3201.xml,80444/xv64920,6,4,8,18
"Unknown",waurobertsjosephdana2280.xml,80444/xv94720,6,7,5,18
"Haworth (Harold) Photographs",wauhaworthharoldphcoll899.xml,80444/xv82934,5,4,9,18
"Unknown",wausteeleen0555.xml,80444/xv57879,5,4,9,18
"Unknown",waugrahamlukek3933.xml,80444/xv77694,4,6,8,18
"Tacher (Morris) Photograph Collection",wautachermorrisphcoll1088.xml,80444/xv53210,1,8,9,18
"Association for Asian American Studies records",wauassociationasianamericanstudies5747.xml,80444/xv54699,5,5,8,18
"Setsuda (Kiichi)",wausetsudakiichi1380_1532.xml,80444/xv10809,11,4,3,18
"Unknown",wauathenaeasnohomishcountywash4601.xml,80444/xv00753,3,7,8,18
"Altabet (Nissim and Rachel) papers",waualtabetnissimrachel5860.xml,80444/xv87194,9,2,7,18
"Republican Party (U.S. : 1854- ).",waurepublicanparty1443_4988.xml,80444/xv50268,3,7,8,18
"Unknown",wauuwresource00357.xml,80444/xv66918,7,6,5,18
"Unknown",wauflynnleof1540.xml,80444/xv81854,6,7,5,18
"Twin City Central Labor Union Minutes",wautwincitycentrallaborunion5727.xml,80444/xv39468,8,7,3,18
"Holcenberg family",wauholcenbergfamily3087.xml,80444/xv90405,6,6,6,18
"Institute For Environmental Mediation.",wauinstituteforenvironmentalmediation3737.xml,80444/xv99053,2,7,9,18
"Unknown",wauscatesshelby5166.xml,80444/xv23889,3,9,6,18
"Feigl (Eric)",waufeiglericoua2324.xml,80444/xv91464,3,4,11,18
"Unknown",waucoopersuehamilton1152.xml,80444/xv07003,2,10,6,18
"Unknown",wauarchivesofamericanartnorthwestoralhistoryproject3620.xml,80444/xv05102,4,5,9,18
"Alaska (Nome) Photograph Album",waunomealaskaalbumphcoll1213.xml,80444/xv57086,0,7,11,18
"Berns (John)",waubernsjohnemmett0586_0740.xml,80444/xv53973,5,7,6,18
"Unknown",wauhalfonsol5328.xml,80444/xv54971,6,6,6,18
"Unknown",wauburtonphilipl0530.xml,80444/xv21026,4,4,10,18
"Rivera (Guillermo)",wauriveraguillermo5893.xml,80444/xv12652,7,6,5,18
"Irvin (Karen) Photograph Collection",wauirvinkarenph2004_029.xml,80444/xv00238,6,5,7,18
"Cohn (John) Oral History",waucohnjohn5696.xml,80444/xv68399,4,5,9,18
"Locke (Hubert)",waulockehubertgua3344.xml,80444/xv88973,5,8,5,18
"Unknown",waushefelmanharolds2219.xml,80444/xv89642,3,5,10,18
"Unknown",waueconomicdevelopmentcouncilofpugetsound3424.xml,80444/xv45321,4,7,7,18
"Unknown",wauoregoncountycourtjacksoncounty3132.xml,80444/xv60736,7,4,7,18
"Unknown",waumountaineerssocietyoutingscoordinatingcommittee3494.xml,80444/xv50408,6,7,5,18
"Scheier (Phil) Oral History",wauscheierphil5649.xml,80444/xv07247,6,7,5,18
"Unknown",waufirthlilahannah4729.xml,80444/xv15997,3,8,7,18
"Unknown",wauwashingtonstateoralauralhistoryprogram2808.xml,80444/xv63214,7,3,8,18
"Baillargeon (J.)",waubaillargeonjc4221.xml,80444/xv75717,4,8,6,18
"Rushmer (Robert)",waurushmerrobertfua4313.xml,80444/xv42568,4,10,4,18
"Nostrand (Howard)",waunostrandhowardleeua1870.xml,80444/xv59927,5,4,9,18
"United States. Forest Service.",wauunitedstatesforestservice3010.xml,80444/xv81210,4,6,8,18
"Unknown",waudiscoverdance5277.xml,80444/xv17608,5,5,8,18
"Unknown",waurogersalbertluther0641.xml,80444/xv51611,5,3,10,18
"Unknown",waucaldwellharrisonl0556.xml,80444/xv02850,7,2,9,18
"Merrick (Jessie) photograph collection",waumerrickjessiephcoll1109.xml,80444/xv13375,4,6,8,18
"Unknown",waulindeberglytle1727.xml,80444/xv92782,3,5,10,18
"Unknown",waudegenhardtwilliama5372.xml,80444/xv31921,6,8,4,18
"University of Washington. Senior Vice President for Finance and Facilities.",wauuwresource00195.xml,80444/xv97036,6,5,7,18
"Unknown",wauwoodhousephilipr2330.xml,80444/xv07611,5,6,7,18
"Unknown",wauisraelrachelcohen2383.xml,80444/xv10015,7,4,7,18
"Alaska Railroad Photograph Album",waualaskarailroadphcoll240.xml,80444/xv90692,3,6,9,18
"Sherwood (K.)",wausherwoodkk4143.xml,80444/xv74703,8,4,6,18
"Hillel (Reva Twersky) Hillel Photograph Collection",wautwerskyrevaphcoll911.xml,80444/xv14453,1,6,11,18
"Narver (Betty)",waunarverbettyjaneua5732.xml,80444/xv33547,9,4,5,18
"Unknown",wauamericaninstituteofarchitectswashingtonstatechapter4277.xml,80444/xv91149,8,3,7,18
"Unknown",wauamonleonj5442.xml,80444/xv92459,3,5,10,18
"Unknown",waukorsneslaura4437.xml,80444/xv99111,2,11,5,18
"Unknown",wauhaavikol2245.xml,80444/xv08285,3,8,7,18
"Unknown",waugreaterseattlehousingcouncil2067.xml,80444/xv03857,3,6,9,18
"Unknown",waunetworkofexecutivewomenseattlewash3829.xml,80444/xv12335,4,6,8,18
"Unknown",wauwashingtonforestprotectionassociation1311.xml,80444/xv22784,5,6,7,18
"DeBow (Samuel)",waudebowsamuelp1103.xml,80444/xv11660,7,4,7,18
"Couture (Marilyn)",waucouturemarilyn2696-005.xml,80444/xv53106,2,7,9,18
"Unknown",wauisraelrebecca2058.xml,80444/xv59182,4,6,8,18
"Gonzales (Boyer) drawing and watercolor album",waugonzalesboyerphcoll902.xml,80444/xv32763,8,5,5,18
"Benaroya (Jack)",waubenaroyajacka5487.xml,80444/xv09460,4,4,10,18
"Parker (Edwin)",wauparkeredwins1320_1332_1705.xml,80444/xv31353,6,1,11,18
"Unknown",waucarrollap1365.xml,80444/xv31079,7,5,6,18
"University of Washington Rules Coordination Office Records",wauuwresource04188.xml,80444/xv41734,16,1,0,17
"Modelski (George) papers",waumodelskigeorgeua5862.xml,80444/xv93792,4,7,6,17
"Unknown",waujordanharrye3775.xml,80444/xv34432,11,5,1,17
"Smith (David and Hazel) Photograph Albums",wausmithdavidandhazelphcoll124.xml,80444/xv88464,6,5,6,17
"Miller (Joe and Margaret)",waumillerjosephw3596.xml,80444/xv59686,4,2,11,17
"Lake Union Improvement Company Photograph Album",waulakeunionimprovementphcoll33.xml,80444/xv22152,7,5,5,17
"Unknown",waulynchtimothy0619.xml,80444/xv17239,4,4,9,17
"Unknown",waunorthcascadeshistoryproject2161.xml,80444/xv20083,1,1,15,17
"Stevens (Carolyn)",waustevenscarolyn3624.xml,80444/xv44824,5,8,4,17
"Unknown",wauwaxshirley2627.xml,80444/xv78134,13,2,2,17
"Moore (Susan)",waumooresusancain3416-001.xml,80444/xv56408,4,5,8,17
"Sloat (Clarence,)",wausloatclarence1835.xml,80444/xv22229,2,5,10,17
"Stimson Bullitt family photograph and motion picture collection",waustimsonbullittfamilyph2010_017.xml,80444/xv54028,5,4,8,17
"Pifer (Drury)",waupiferdruryaugustusua1929.xml,80444/xv99002,4,3,10,17
"Unknown",wauterryfamily0270.xml,80444/xv14437,6,5,6,17
"Stirling Postcard Albums",waustirlingpostcardalbumsphcoll575.xml,80444/xv85964,6,5,6,17
"KOMO Photograph Collection",waukomophcoll176.xml,80444/xv37988,10,2,5,17
"Dobie (Edith,)",waudobieedithcaua2411.xml,80444/xv22070,5,4,8,17
"Fox (Bernard) Oral History",waufoxbernard5697.xml,80444/xv52371,7,5,5,17
"Unknown",waumountaineerssocietyalpinescramblerscommittee2215.xml,80444/xv32397,6,6,5,17
"Martin (Jack)",waumartinjackb2696-071.xml,80444/xv00451,6,5,6,17
"Marine Environmental Consortium records",waumarineenvironmentalconsortium5580.xml,80444/xv30416,9,4,4,17
"Michelson (Barbara Laufer) papers",waumichelsonbarbara5881.xml,80444/xv85812,6,3,8,17
"Beder (Oscar)",waubederoscaredwardua3329.xml,80444/xv26321,8,5,4,17
"Photographs of the View Ridge Neighborhood",wauviewridgeneighborhoodphcoll1118.xml,80444/xv40179,6,2,9,17
"Unknown",waupatrickjosephine0820.xml,80444/xv89633,3,2,12,17
"Unknown",waukinseyclarkphcoll516.xml,80444/xv57156,4,10,3,17
"University of Washington Tacoma, Office of Academic Affairs records",wauuwresource06702.xml,80444/xv04705,7,5,5,17
"Unknown",waugraypanthersseattlewash2815.xml,80444/xv09686,3,6,8,17
"Unknown",wausunnmorslagetavseattle3745.xml,80444/xv78775,2,7,8,17
"University of Washington Office of the Vice Provost for Planning and Budgeting Records",wauuwresource00098.xml,80444/xv30001,3,6,8,17
"Unknown",waumountaineerssocietytrailsadvisorycommittee3642.xml,80444/xv22097,6,2,9,17
"Anderson (Clarence)",wauandersonclarencelua3407.xml,80444/xv62677,2,5,10,17
"University of Washington Album 2",wauuniversityofwashingtonalbum2phcoll114.xml,80444/xv18362,5,4,8,17
"Clein (Lillian) Photograph Collection",waucleinlillianphcoll1061.xml,80444/xv37445,5,6,6,17
"Kincaid (Trevor) Photograph Collection",waukincaidtrevorphcoll355.xml,80444/xv25463,3,6,8,17
"Unknown",wauniederbailey3861.xml,80444/xv52188,4,8,5,17
"Unknown",waukleinberglester3198.xml,80444/xv02511,9,3,5,17
"University of Washington. Capital Projects Office. Construction Office.",wauuwresource00127.xml,80444/xv17251,8,5,4,17
"Chapman (Hazle) Photograph Collection",wauchapmanhazlephcoll265.xml,80444/xv09231,8,5,4,17
"Unknown",wauniederann2541.xml,80444/xv29690,4,7,6,17
"Unknown",waumclaughlingeorge4807.xml,80444/xv70773,6,8,3,17
"Unknown",waumetzonmartind3856.xml,80444/xv92065,7,6,4,17
"Unknown",waueyerjohnh3932.xml,80444/xv03054,2,9,6,17
"Archie (Steve) Photograph Collection",wauarchiestevephcoll559.xml,80444/xv41430,7,4,6,17
"Unknown",waubramanjamesdorma1142.xml,80444/xv72042,4,4,9,17
"Raff (Douglass)",wauraffdouglassa3704.xml,80444/xv36340,4,8,5,17
"Unknown",wauuwresource07407.xml,80444/xv17544,3,6,8,17
"Havurat Ee Shalom records",wauhavurateeshalom5729.xml,80444/xv91790,8,3,6,17
"Unknown",waumaltbyestherstark3419.xml,80444/xv13293,5,6,6,17
"Genji Mihara scrapbook",waumiharagenji5560.xml,80444/xv83294,4,7,6,17
"Unknown",wauuwresource06072.xml,80444/xv50735,3,8,6,17
"Unknown",wauemersonpatriciah4156.xml,80444/xv41210,5,5,7,17
"Gutmann (Addis,)",waugutmannaddisjr5322.xml,80444/xv24398,5,5,7,17
"Unknown",wauhenryjohnfrazier5104.xml,80444/xv94036,4,5,8,17
"Unknown",waumountaineerssocietypublicationdivision2889.xml,80444/xv03948,6,8,3,17
"Unknown",wauholcenbergsamuelg3079.xml,80444/xv57229,3,5,9,17
"Graham (John) Architectural Drawings and Photograph Collection",waugrahamjohnphcoll339.xml,80444/xv66635,6,9,2,17
"Unknown",wauringoldsoliem1891.xml,80444/xv50262,5,3,9,17
"Kelley (Vincent)",waukelleyvincentcua3364.xml,80444/xv61251,6,6,5,17
"Unknown",wauevansllewellyn1741.xml,80444/xv24160,8,4,5,17
"Van Soelen (Anton C.) Photograph Collection",wauvansoelenphcoll605.xml,80444/xv98504,8,6,3,17
"Warren (Felix,)",wauwarrenfelix0066.xml,80444/xv23977,4,4,9,17
"Hinkson (Mercedes)",wauhinksonmercedesq2696-104.xml,80444/xv67071,6,6,5,17
"Berman (Judith,)",waubermanjudith2696-079.xml,80444/xv87429,4,3,10,17
"Sanford (Rollin) Photograph Collection",wausanfordrollinphcoll494.xml,80444/xv83697,6,7,4,17
"Unknown",waulewisbrianj1652.xml,80444/xv36035,3,4,10,17
"Unknown",waukeilwilliam4480.xml,80444/xv12277,3,3,11,17
"Unknown",waukilgrenminnie2606.xml,80444/xv66790,7,2,8,17
"Kaplan (Jacob,)",waukaplanjacob0936_1960.xml,80444/xv69192,5,3,9,17
"Unknown",wauroysterhornjuanaracquel3031.xml,80444/xv27529,7,6,4,17
"Unknown",waucohensarina2667.xml,80444/xv76748,4,6,7,17
"University of Washington. Archives of Northwest Art.",wauuwresource03128.xml,80444/xv67935,4,7,6,17
"University of Washington Women's Council Records",wauuwresource07691.xml,80444/xv08904,4,3,10,17
"B'nai B'rith. Tacoma Lodge No. 741 (Tacoma, Wash.).",waubnaibrithtacomalodgeno741_5119.xml,80444/xv21185,6,4,7,17
"Mapes (Lynda) papers: the Tse-whit-zen Project",waumapeslynda5742.xml,80444/xv03262,2,5,10,17
"Unknown",wauhelfgottestheraltshul2675.xml,80444/xv37374,5,6,6,17
"Boeing Airplane Company.",wauboeingairplanecompany3618.xml,80444/xv11386,3,7,7,17
"Unknown",waunationalleagueofamericanpenwomenseattlebranch2478.xml,80444/xv61157,12,5,0,17
"Unknown",wauwaresarahamelia5350.xml,80444/xv50018,5,5,7,17
"Rappaport (Ruth) papers",waurappaportruth5797.xml,80444/xv44100,4,8,5,17
"Bacharach (Ruth) Photograph Collection",waubacharachruthphcoll849.xml,80444/xv12921,4,5,8,17
"Unknown",wauhittmansuzanne4366.xml,80444/xv13516,9,2,6,17
"Viretta Chambers (Mrs. C. L.) Denny Photographs and Albums",waudennyvirettaph2008_032.xml,80444/xv51950,10,5,2,17
"Ferrill (Arther)",wauferrillartherua2594.xml,80444/xv56457,6,3,8,17
"Kline (Adam) Oral History",wauklineadam5654.xml,80444/xv81607,5,5,7,17
"Unknown",waucharlesal3547.xml,80444/xv14257,0,14,3,17
"U.S. Army Signal Corps Photographs of the Mount Rainier Ordnance Depot Collection",waumountrainierordnancedepotphcoll1248.xml,80444/xv25476,5,6,6,17
"Unknown",wauspearmanvivian4905.xml,80444/xv50357,3,3,11,17
"Black (Beatrice)",waublackbeatricepullen3416-001.xml,80444/xv92385,3,6,8,17
"Unknown",waurosenbergdishmanmarieb1708.xml,80444/xv36538,6,9,2,17
"Krasnowsky (Frank) Papers",waukrasnowskyfrank5876.xml,80444/xv34790,3,2,12,17
"Marchioro (Thomas)",waumarchiorothomaslua4503.xml,80444/xv25469,5,7,5,17
"Lipstadt (Deborah)",waulipstadtdeborahe2979.xml,80444/xv36059,5,5,7,17
"Unknown",waupacificcoastbankingschool3983.xml,80444/xv00488,3,5,9,17
"Unknown",wautiffencc0973.xml,80444/xv17202,8,5,4,17
"Unknown",wauperkinswilliamthomas1118.xml,80444/xv54025,7,3,7,17
"Unknown",waucrossirab1319.xml,80444/xv90908,7,3,7,17
"Mattina (Nancy)",waumattinanancy2696-093.xml,80444/xv53158,6,5,6,17
"Unknown",wauzednickvictor0541.xml,80444/xv74172,3,3,11,17
"Unknown",waupalmerfamily4385.xml,80444/xv91427,3,7,7,17
"Unknown",waumulliganbriano2705.xml,80444/xv74066,5,5,7,17
"Our Trip to Seattle Album",wauourtriptoseattlephcoll432.xml,80444/xv96051,6,5,6,17
"Dodge (Harold)",waudodgeharoldtua4554.xml,80444/xv62771,5,5,7,17
"King County Nurses Association Photograph Collection",waukingcountynursesphcoll91.xml,80444/xv76274,4,7,6,17
"McMahon (Edward)",waumcmahonedwardmua0141.xml,80444/xv49240,2,3,12,17
"Unknown",waumackaymackiedefensecommitteeus4804.xml,80444/xv34683,2,6,9,17
"Coachman (Lawrence)",waucoachmanlawrencekua4442.xml,80444/xv25378,4,3,10,17
"Unknown",waucallbreathjohnc4498.xml,80444/xv56210,7,3,7,17
"Miller (Alfred)",waumilleralfredlawrenceua0561.xml,80444/xv32739,11,2,4,17
"Unknown",waukeislerhermani2743.xml,80444/xv63989,3,3,11,17
"Unknown",waugatesalicea2159.xml,80444/xv74868,5,5,7,17
"Mature Friends records",waumaturefriends5623.xml,80444/xv20446,4,2,11,17
"Gessel (Stanley)",waugesselstanleypua4147.xml,80444/xv57308,7,1,9,17
"Blackman (Margaret)",waublackmanmargaretb2696-032.xml,80444/xv75210,4,6,7,17
"Hammer (Enid) papers",wauhammerenid5771.xml,80444/xv06231,3,6,8,17
"Heller (Amos)",wauhelleramosarthur0108.xml,80444/xv73248,4,5,8,17
"Unknown",waudejaenlilly2880.xml,80444/xv39651,4,5,8,17
"Towne (Paul B.) Family Papers",wautownepaul5897.xml,80444/xv18353,5,2,10,17
"Unknown",wauschulzepaul4884.xml,80444/xv05529,6,4,7,17
"University of Washington. Dept. of Zoology.",wauuwresource00308.xml,80444/xv12887,6,4,7,17
"Unknown",wauschermerjenniedavis1534.xml,80444/xv14135,6,7,4,17
"Radinsky (Lillian)",wauradinskylillian5822.xml,80444/xv55471,3,5,9,17
"Unknown",wauuwresource09073.xml,80444/xv07467,2,6,9,17
"Harris (Florence)",wauharrisflorencerua1684.xml,80444/xv69006,3,6,8,17
"Evans (Charles)",wauevanscharlesalbertua2598.xml,80444/xv36630,4,5,8,17
"Unknown",waupacificnorthwesthistoriansguild3703.xml,80444/xv62820,8,4,5,17
"Garrett (Robert)",waugarrettrobertmaxua1868.xml,80444/xv19836,8,4,5,17
"Birnbaum (Hilde)",waubirnbaumhilde5477.xml,80444/xv73657,2,7,8,17
"University of Washington. Hospital. Administration.",wauuwresource00210.xml,80444/xv26730,1,12,4,17
"Unknown",waulyonseleanor3793.xml,80444/xv61340,4,7,6,17
"Unknown",waunishiikyuhachi5148.xml,80444/xv38986,4,3,10,17
"Treadgold (Donald)",wautreadgolddonaldwua1845.xml,80444/xv07040,5,4,8,17
"Henry (Horace C.) Photograph Collection",wauhenryhcphcoll473.xml,80444/xv93869,2,3,12,17
"Harris (Jimmy)",wauharrisjimmyg1835.xml,80444/xv24542,5,7,5,17
"Unknown",wauspadajohn0490.xml,80444/xv66461,8,4,5,17
"Horiuchi (Paul) Papers",wauhoriuchipaul5643.xml,80444/xv85357,1,8,8,17
"Pressly (Thomas J.) papers",waupresslythomasjua5816.xml,80444/xv98236,7,3,7,17
"Thompson (Guy William) scrapbook",wauthompsonguywilliam5850.xml,80444/xv86968,6,5,6,17
"University of Washington. School of Medicine.",wauuwresource00370.xml,80444/xv00579,7,4,6,17
"Smith (Cecil Haven) Photograph Album",wausmithcecilhavenphcoll414.xml,80444/xv76422,5,2,10,17
"Price (John R.) Papers",waupricejohnrua4999.xml,80444/xv84988,2,7,8,17
"Unknown",waugenauerben1750.xml,80444/xv48120,4,6,7,17
"School of Medicine, Curriculum Office Records",wauuwresource00374.xml,80444/xv83624,5,6,6,17
"Kadima (Organization : Seattle, Wash.).",waukadima4328.xml,80444/xv00799,8,4,5,17
"Bodine (John)",waubodinejohnj2696.xml,80444/xv76007,5,4,8,17
"Dudley (Patrcia L.) Papers",waududleypatriciaua5385.xml,80444/xv84738,2,3,12,17
"Washington State Jewish Historical Society Landmarks Committee Photograph Collection",wauwsjhslandmarksphcoll1090.xml,80444/xv17440,6,4,7,17
"Osborn (Bartie E.) Photograph Collection",wauosbornbartieephcoll271.xml,80444/xv49002,3,6,8,17
"Unknown",waublalocknelsongales4612.xml,80444/xv01733,6,6,5,17
"University of Washington. Distance Learning Office.",wauuwresource00144.xml,80444/xv84201,3,4,10,17
"Unknown",wauspaldinghenryharmon4903.xml,80444/xv31076,5,5,7,17
"Campbell (Robert)",waucampbellrobert4700.xml,80444/xv41619,7,5,5,17
"Unknown",waushermangerald5397.xml,80444/xv61901,2,2,13,17
"Unknown",wauhuntjohnm1411.xml,80444/xv09378,3,5,9,17
"Unknown",waulevyruthjacobs3803.xml,80444/xv52804,3,7,7,17
"Bolotin (Ruth) papers",waubolotinruth4046.xml,80444/xv00125,6,3,8,17
"Bates (Ann)",waubatesannm2696.xml,80444/xv00967,4,6,7,17
"Tyler (Jerry) Papers",wautylerjerry5553.xml,80444/xv02502,5,5,7,17
"Unknown",wausteinbrecherrosaliesidell3608.xml,80444/xv43151,8,4,5,17
"Burd (Henry)",wauburdhenryaua4626.xml,80444/xv08648,5,5,7,17
"Unknown",waulyovinanatole2000.xml,80444/xv24356,5,5,7,17
"Mt. Rainier Photograph Album",waumtrainierphotoalbumphcoll1330.xml,80444/xv78302,9,7,1,17
"Strong (Tracy)",waustrongtracyb3476.xml,80444/xv77749,2,2,13,17
"Unknown",wauwyckoffambrosebarkley4984.xml,80444/xv70086,5,6,6,17
"Ships Photograph Collection",waushipsphcoll584.xml,80444/xv39339,9,5,3,17
"Unknown",wauaphiliprandolphinstitute5903.xml,80444/xv09692,5,7,5,17
"Hubbell (Charles S.) Photograph Collection",wauhubbellcharlesph2005_020.xml,80444/xv70477,5,4,8,17
"Unknown",waurostonjamesa1161.xml,80444/xv80120,8,4,5,17
"University of Washington. Dept. of Physiological Nursing.",wauuwresource06077.xml,80444/xv64691,6,4,7,17
"Unknown",wautinglegeorgeh4925.xml,80444/xv90194,4,6,7,17
"Lane (Joseph,)",waulanejoseph1259.xml,80444/xv18731,3,7,7,17
"Coombs (Raphael) Drawings Reproductions of",waucoombsraphaelphcoll535.xml,80444/xv60366,2,9,6,17
"Skarstedt (Ernst) Photographs",wauskarstedternestphcoll533.xml,80444/xv01315,7,6,4,17
"Seattle Worker Center Records",wauseattleworkercenter5570.xml,80444/xv13766,6,7,4,17
"Strother (Charles)",waustrothercharlesrua2372.xml,80444/xv54183,5,4,8,17
"Unknown",waujohansonjeanlp3913.xml,80444/xv43536,4,5,8,17
"Truman (Harry S.)",wautrumanwashingtonstatepatrolfilmphcoll825.xml,80444/xv09570,6,5,6,17
"Unknown",waukleinermorris2392.xml,80444/xv25857,3,4,10,17
"Ketchikan Alaska Photograph Album",wauketchikanalaskaphotoalbumphcoll1331.xml,80444/xv55944,7,7,3,17
"Unknown",wauashershirley4065.xml,80444/xv15325,4,7,6,17
"Stone (Harold)",waustoneharoldotho0801.xml,80444/xv87960,6,4,7,17
"Coordinating Center for Collaborative Studies in Coronary Artery Surgery.",wauuwresource00396.xml,80444/xv26589,4,4,8,16
"Unknown",waufosshenry2367.xml,80444/xv18722,5,3,8,16
"Unknown",wauglendalecountryclub4202.xml,80444/xv15179,5,4,7,16
"Unknown",wauokudahenryheiji2345.xml,80444/xv52972,2,3,11,16
"University of Washington. Dept. of Civil Engineering.",wauuwresource00335.xml,80444/xv64230,6,2,8,16
"University of Washington Ethnic Cultural Center Records",wauuwresource00107.xml,80444/xv28796,5,8,3,16
"Edwards (Allen)",wauedwardsallenlouisua4470.xml,80444/xv45196,3,9,4,16
"Mercer Family",waumercerfamily1882.xml,80444/xv15292,5,3,8,16
"Bentley (G.)",waubentleygcarterua4515.xml,80444/xv00051,4,5,7,16
"University of Washington, School of Medicine, Associate Dean for Regional Affairs and Rural Health Records",wauuwresource00376.xml,80444/xv37158,3,7,6,16
"Unknown",waulowingerruth3931.xml,80444/xv97833,4,4,8,16
"Scott (George W.) Papers",wauscottgeorge1803.xml,80444/xv82559,6,5,5,16
"Unknown",wauensleygroverw3669.xml,80444/xv10922,5,6,5,16
"Unknown",waualiyahbet3880.xml,80444/xv62057,3,6,7,16
"De Tornyay (Rheba)",waudetornyayrhebaua4304.xml,80444/xv81274,3,5,8,16
"Friday Harbor Laboratories (Wash.).",wauuwresource00187.xml,80444/xv83462,5,8,3,16
"Unknown",waualexanderrichard3812.xml,80444/xv88638,5,5,6,16
"University of Washington. Dept. of Environmental Health.",wauuwresource00462.xml,80444/xv49826,3,6,7,16
"Gardiner (Dwight)",waugardinerdwight2696-043.xml,80444/xv20236,3,6,7,16
"Unknown",waucolumbiawinerybellevuewash3863.xml,80444/xv91494,5,5,6,16
"Meany Hall for the Performing Arts.",wauuwresource00327.xml,80444/xv96182,3,6,7,16
"Unknown",waugutmannleatricedeleon5327.xml,80444/xv99810,1,8,7,16
"Hartman (Harry), Bookseller, Photograph Collection",wauhartmanharryphcoll603.xml,80444/xv83457,3,8,5,16
"Unknown",wausteinbergreuben1945.xml,80444/xv50061,9,3,4,16
"Morrill (Frank) Jr. Photograph Collection",waumorrillfrankphcoll010.xml,80444/xv60671,5,7,4,16
"Unknown",wauquinnhelenkoleman2521.xml,80444/xv20806,4,8,4,16
"Unknown",waugerberanne2849.xml,80444/xv41223,1,6,9,16
"Putnam (Marguerite)",wauputnammargueriteeua0873.xml,80444/xv97119,3,4,9,16
"Unknown",waukanetamiyoko5367.xml,80444/xv72647,6,4,6,16
"Tyler (Richard)",wautylerrichardgainesua1888.xml,80444/xv38687,4,6,6,16
"Eichlin (Almyra Weiss) Photograph Album",waueichlinalmyraweissphcoll438.xml,80444/xv24490,5,1,10,16
"Unknown",wauuniversitybaptistchurch5346.xml,80444/xv10612,7,6,3,16
"Unknown",waunorthwestnuclearxchange5788.xml,80444/xv49917,5,6,5,16
"Baker (Ethel Burdett) Letters",waubakerethelburdett5900.xml,80444/xv76730,6,5,5,16
"Unknown",waustimsontd4793.xml,80444/xv79986,2,4,10,16
"Pi Sigma Alpha. Chapter Nu (University of Washington).",waupisigmaalphachapternu5068.xml,80444/xv13037,4,8,4,16
"Waterman (T.T.) Photograph Collection",wauwatermanttphcoll434.xml,80444/xv50924,1,10,5,16
"Kelso (Lee) Alaska Photograph Album",waukelsoleeph2009_034.xml,80444/xv35501,3,5,8,16
"Nelson (Emma)",waunelsonemmaginsberg1757_1762.xml,80444/xv63198,7,3,6,16
"Unknown",waulevinenaomi2237.xml,80444/xv90200,3,3,10,16
"Unknown",waubarrjc3098.xml,80444/xv65109,3,4,9,16
"Kennedy (Thelma)",waukennedythelmaua2908.xml,80444/xv54067,6,7,3,16
"Daughters of the American Revolution, Chief Whatcom Chapter Album on the",waudarchiefwhatcomph2009_052.xml,80444/xv48718,3,4,9,16
"Steinberg (Irene)",wausteinbergirenemohrer4015.xml,80444/xv13195,7,4,5,16
"Positions Records",wauuwresource05683.xml,80444/xv45806,3,1,12,16
"Carter (Dudley)",waucarterdudley2665.xml,80444/xv09326,6,3,7,16
"Varon (Harry) Papers and Oral History Interview",wauvaronharry5624.xml,80444/xv87615,6,3,7,16
"Allendoerfer (Carl)",wauallendoerfercarlbua2356.xml,80444/xv53686,2,5,9,16
"Unknown",wauparksdonaldl2986.xml,80444/xv49328,3,8,5,16
"Dille (James)",waudillejamesmua5032.xml,80444/xv32922,4,6,6,16
"Clift (Ray)",waucliftrayphcoll1267.xml,80444/xv88619,3,6,7,16
"Unknown",waurubymichaelg2656.xml,80444/xv47131,1,8,7,16
"Photographs of Northeast Document Conservation Center School for Scanning Class",waunedccschoolforscanningph2015_024.xml,80444/xv94946,2,7,7,16
"Unknown",waudanishbrotherhoodinamericapacificnorthwestlodges2750.xml,80444/xv33670,1,6,9,16
"Unknown",waulampherephyllis2528.xml,80444/xv57144,6,6,4,16
"Ryan (James)",wauryanjamesfua4248.xml,80444/xv30438,4,6,6,16
"Schwarz (Heinz)",wauschwarzheinz5728.xml,80444/xv70562,6,2,8,16
"Grey (Arthur L. ) Papers",waugreyarthurlua5769.xml,80444/xv25631,5,5,6,16
"Weldon (Virginia) Photograph Collection",wauweldonvirginiaph2015_016.xml,80444/xv24612,5,5,6,16
"Fetters (Lueree and Mildred) Scrapbooks",waufettersluereemildred5886.xml,80444/xv28277,5,7,4,16
"Unknown",wauposkittedward3692.xml,80444/xv78149,5,4,7,16
"Cohen (Cookie) Photograph Collection",waucohencookiephcoll1063.xml,80444/xv64849,2,7,7,16
"Unknown",waukrahlrobertb4034.xml,80444/xv22827,2,7,7,16
"Wendy Marcus Oral History Interview",waumarcuswendy5702.xml,80444/xv72271,4,4,8,16
"Raser Family Photograph Collection",wauraserphcoll444.xml,80444/xv68817,4,5,7,16
"Unknown",waujohnsondorothyjean3125.xml,80444/xv70916,5,5,6,16
"Liquor sales book (Seattle, WT )",wauliquorsalesbook5636.xml,80444/xv48944,4,4,8,16
"Hutchison (Margaret)",wauhutchisonmargaret5879.xml,80444/xv21505,4,5,7,16
"Unknown",waurepublicanpartyyoungrepublicansofkingcounty3687.xml,80444/xv37756,7,5,4,16
"Kelley (John)",waukelleyjohnf5511.xml,80444/xv68267,9,3,4,16
"Unknown",wauboltonjean4461.xml,80444/xv43994,4,5,7,16
"Graves (Morris,)",waugravesmorris0669.xml,80444/xv25604,9,3,4,16
"Gehrig (John)",waugehrigjohn4265.xml,80444/xv19995,3,5,8,16
"Holcenberg (Samuel G.) photograph collection",wauholcenbergsamuelphcoll1160.xml,80444/xv50201,6,2,8,16
"Budway (Kathleen)",waubudwaykathleen2696-055.xml,80444/xv23342,2,7,7,16
"Unknown",wauhebrewladiesfreeloansocietyseattlewash1568.xml,80444/xv71255,3,8,5,16
"Unknown",wauseattlesymphonyorchestra3430.xml,80444/xv35382,12,2,2,16
"Crystal Pool Building Architectural Drawings",waucrystalpoolphcoll833.xml,80444/xv90817,4,7,5,16
"Unknown",wauseattlejuniortheatre3821.xml,80444/xv69168,4,7,5,16
"Service Employees International Union, Local 120 Records",wauserviceemployeesinternationalunionlocal120everettwash5576.xml,80444/xv42092,7,2,7,16
"University of Washington. School of Medicine. Friends.",wauuwresource07731.xml,80444/xv19638,5,5,6,16
"Little School of Seattle",waulittleschool1176.xml,80444/xv91314,4,6,6,16
"Leigh (Edward O.) Photograph Album",wauleigheophcoll039.xml,80444/xv34671,7,7,2,16
"Yesler Terrace, Photographs of",wauyeslerterracephcoll915.xml,80444/xv48791,4,8,4,16
"Dooley (Donald)",waudooleydonald2169.xml,80444/xv35144,4,5,7,16
"Shale (Irene)",waushaleirenecharley3416-001.xml,80444/xv42745,5,4,7,16
"Unknown",wauclarkstephencutter5311.xml,80444/xv36087,3,5,8,16
"Unknown",wauspencerarthurc2483.xml,80444/xv74340,5,6,5,16
"Unknown",wauseattlebuddhistchurchseattlewash1630.xml,80444/xv71493,15,0,1,16
"Unknown",wauwatanabetaul1131.xml,80444/xv03067,4,3,9,16
"George (Louisa)",waugeorgelouisa3416-001.xml,80444/xv82638,3,8,5,16
"Love (Ruth Leeds) papers",wauloveruthleeds5751.xml,80444/xv46420,8,3,5,16
"Unknown",wauthomasjoank2630.xml,80444/xv44674,8,3,5,16
"B'nai B'rith. Greater Seattle Lodge 3003.",waubnaibrithgreaterseattlelodge3003_3622.xml,80444/xv29373,6,6,4,16
"Cantwell (George G.) Photographs",waucantwellgeorgegphcoll298.xml,80444/xv57058,4,5,7,16
"Unknown",waumendeldouglasheusted4548.xml,80444/xv39270,4,4,8,16
"Unknown",waupearsonjohnv4987.xml,80444/xv45416,4,6,6,16
"Unknown",wauvantrumpphilemonbeecher0499.xml,80444/xv95755,6,3,7,16
"Dark (Alx)",waudarkalx2696-102.xml,80444/xv76092,5,3,8,16
"Whiteley (Arthur H.) Papers",wauwhiteleyarthurua5777.xml,80444/xv11264,5,3,8,16
"Harrison (Arthur)",wauharrisonarthurelliotua2373.xml,80444/xv25500,5,6,5,16
"University of Washington. Dept. of Political Science.",wauuwresource00286.xml,80444/xv18115,5,4,7,16
"Siegal (Art) photograph collection",wausiegalartphcoll1141.xml,80444/xv99627,7,5,4,16
"Unknown",wautimpejoyce2224.xml,80444/xv67340,2,5,9,16
"Puget Sound Machinery Depot Photograph Collection",waupugetsoundmachinerydepotphcoll917.xml,80444/xv02157,5,3,8,16
"University of Washington, Inner Asia Colloquium Records",wauuwresource09285.xml,80444/xv86657,0,15,1,16
"Kricun (Elizabeth)",waukricunelizabeth3416-001.xml,80444/xv51412,3,6,7,16
"Expo '74. Art exhibition.",wauexpo74artexhibition2428.xml,80444/xv18792,4,4,8,16
"Unknown",waulamarcheleni3452.xml,80444/xv39041,2,4,10,16
"Aleutian Islands in World War II Photograph Collection",waualeutianislandsinwwiiphcoll604.xml,80444/xv65673,7,3,6,16
"James (Florence Bean) Photograph Collection",waujamesflorencebeanphcoll1208.xml,80444/xv07302,5,5,6,16
"Olympic National Park Album",wauolympicnationalparkphcoll030.xml,80444/xv76657,6,5,5,16
"Kelley (John)",waukelleyjohnf5510.xml,80444/xv92056,4,7,5,16
"Tacoma Motorcycle Race Film",wautacomamotorcycleracephcoll830.xml,80444/xv82717,2,3,11,16
"Miller (William) Cyanotypes of Dyea Trail to Dawson",waumillerwilliamdyeatrailcyanotypesphcoll1311.xml,80444/xv97027,7,3,6,16
"Unknown",waukingcountyartscommission5182.xml,80444/xv02301,4,5,7,16
"Leahy (Kathleen)",wauleahykathleenmua0179.xml,80444/xv06567,4,5,7,16
"Pioneer Association of the State of Washington.",waupioneerassociationofthestateofwashington1467.xml,80444/xv27188,3,4,9,16
"Gallacci (John) papers",waugallaccijohn5785.xml,80444/xv04248,7,4,5,16
"Unknown",waumetcalfveidamorrow1019.xml,80444/xv26217,3,6,7,16
"Broer (Marion)",waubroermarionruthua1788_1799.xml,80444/xv28320,4,5,7,16
"Sylvia Hamblin Collection of Century 21 Exposition Photographs",waucentury21expositionph2007_009.xml,80444/xv05612,2,2,12,16
"Yesler (Henry)",wauyeslerhenryl0668.xml,80444/xv29003,3,6,7,16
"Unknown",waupeltoricharda1189.xml,80444/xv91925,7,7,2,16
"Unknown",wauuniversityoutingclub4323.xml,80444/xv03671,2,5,9,16
"Unknown",waukahlerfamily4670.xml,80444/xv21536,8,3,5,16
"Dassow (Ethel) photograph collection",waudassowethelphcoll1119.xml,80444/xv47900,8,3,5,16
"Unknown",waufoundationforinternationalunderstandingthroughstudents4422.xml,80444/xv06341,2,7,7,16
"Butler (Debra)",waubutlerdebrajg5485.xml,80444/xv20748,4,4,8,16
"Unknown",wauarcticclubseattlewash2185.xml,80444/xv49316,2,8,6,16
"Unknown",waumartincharlesh4805.xml,80444/xv38699,4,5,7,16
"University of Washington School of Medicine, Associate Dean for Research and Graduate Education Records",wauuwresource00377.xml,80444/xv21029,5,5,6,16
"Unknown",waurobertsonwilliamo2211.xml,80444/xv44326,3,7,6,16
"Bennett (Walter R.) Nome and Fort Davis Photograph Collection",waubennettwalterrphcoll877.xml,80444/xv77944,6,3,7,16
"Unknown",waufisheredwardl3505.xml,80444/xv80972,3,4,9,16
"Unknown",wauelmendorfalicer3787.xml,80444/xv18801,2,4,10,16
"Warshal (Jerrold) Oral History",wauwarshaljerrold5669.xml,80444/xv07855,6,4,6,16
"Unknown",waubakkenoel3086.xml,80444/xv64208,5,7,4,16
"University of Washington Office of Undergraduate Academic Affairs Records",wauuwresource00116.xml,80444/xv13769,8,8,0,16
"B'nai B'rith. Anti-defamation League (Portland, Or.).",waubnaibrithantidefamationleague0535_1811.xml,80444/xv56756,5,4,7,16
"Kuramato (Satoru)",waukuramatosatoru1454.xml,80444/xv64141,6,3,7,16
"Werner (Ross) Photographs",wauwernerrossphcoll451.xml,80444/xv44329,4,6,6,16
"University of Washington Department of Sociology Records",wauuwresource00295.xml,80444/xv25549,4,2,10,16
"University of Washington. School of Business Administration",wauuwresource00262.xml,80444/xv69161,5,3,8,16
"Glisan (Rodney) Mount Rainier Photograph Collection",wauglisanrodneyphcoll368.xml,80444/xv01052,7,5,4,16
"Leopold (Estella)",wauleopoldestellabua5155.xml,80444/xv24377,5,3,8,16
"Goodspeed (George)",waugoodspeedgeorgeedwardua2375.xml,80444/xv52032,5,6,5,16
"Pacific Northwest Library Association Photograph Collection",waupacificnorthwestlibraryassociationphcoll219.xml,80444/xv39352,6,4,6,16
"Unknown",waunwlesbianandgayhistorymuseumproject5929.xml,80444/xv01058,4,3,9,16
"Luke K. Graham Photograph and Ephemera collection",waugrahamlukekph2013_003.xml,80444/xv43484,3,6,7,16
"Unknown",waumattsoncarl1187.xml,80444/xv31488,6,5,5,16
"Paulik (Gerald)",waupaulikgeraldjohnua2083.xml,80444/xv63439,4,4,8,16
"International Pacific Salmon Fisheries Commission.",wauinternationalpacificsalmonfisheriescommission1840_1841_1924.xml,80444/xv53225,4,4,8,16
"University of Washington, Dean of Women Records",wauuwresource00152.xml,80444/xv00019,3,6,7,16
"Brightman (Robert)",waubrightmanrobertalain2696-038.xml,80444/xv71682,6,3,7,16
"Knemeyer (Dee)",wauknemeyerdee3416-001.xml,80444/xv25900,6,4,6,16
"Lawson (Michael,)",waulawsonmichael3415.xml,80444/xv69934,5,3,8,16
"Unknown",wauoceanographiccommissionofwashington3204.xml,80444/xv55319,5,3,8,16
"Mortar Board (Society). Tolo Chapter (University of Washington).",waumortarboardua3335.xml,80444/xv29525,7,5,4,16
"Unknown",waukelloggjohncoe4765.xml,80444/xv94470,3,6,7,16
"Odegaard (Charles) Memorial",wauodegaardmemorial5165.xml,80444/xv76815,4,5,7,16
"Church (Philemon)",wauchurchphilemonedwardsua2911.xml,80444/xv42147,6,5,5,16
"Eastman (Minnie)",waueastmanminnielaura3416-001.xml,80444/xv38745,3,7,6,16
"Hiram M. Chittenden Locks Construction Photograph Collection",wauhirammchittendenlocksconstructionphcoll885.xml,80444/xv84664,5,5,6,16
"Young Men's Christian Association (University of Washington) Photograph Collection",wauymcauwph2004_048.xml,80444/xv72451,3,8,5,16
"Phi Beta Kappa.",wauphibetakappa0095.xml,80444/xv06051,5,4,7,16
"Uehling (Edwin)",wauuehlingedwinaua3349.xml,80444/xv92565,4,6,6,16
"White (Bernice)",wauwhitebernicecourville3416-001.xml,80444/xv47033,8,3,5,16
"Unknown",waucebriancornell2212.xml,80444/xv90008,5,6,5,16
"Iwami (Sachiko) photograph collection",wauiwamisachikophcoll1193.xml,80444/xv40908,5,3,8,16
"Unknown",waugundersenrolf2368.xml,80444/xv34356,5,5,6,16
"Bernnard (Robert) Papers",waubernnardrobert5778.xml,80444/xv72866,2,8,6,16
"Harris (Julia)",wauharrisjulia1119_1168.xml,80444/xv93289,4,7,5,16
"Nottingham (Arthur) Photograph Collection",waunottinghamphcoll007.xml,80444/xv69284,7,5,4,16
"Report from the Aleutians film",waureportfromthealeutiansfilmphcoll1283.xml,80444/xv69015,7,5,4,16
"Koleda Dance Company Photograph Collection",waukoledadancecompanyph2015_010.xml,80444/xv13806,5,4,7,16
"University of Washington Department of Nuclear Engineering Records",wauuwresource00336.xml,80444/xv00170,1,1,14,16
"Unknown",wauhigginscatherinemary3499.xml,80444/xv90686,6,2,8,16
"Unknown",wauwestmanlenus3962.xml,80444/xv03741,4,5,7,16
"Linkletter (L.G.) Photographs of the University of Washington",waulinkletteruwphcoll095.xml,80444/xv78155,5,4,7,16
"Correll (Richard) "Pacification" Linocut",waucorrellrichardphcoll759.xml,80444/xv83926,5,3,8,16
"Anches (Libby,)",wauancheslibby2074.xml,80444/xv60702,4,4,8,16
"Unknown",wauhudsonsbaycompany0640.xml,80444/xv51080,0,7,9,16
"Pocock (George) University of Washington Crew Trip to the 1948 Olympics Home Movie",wauuwcrewtrip1948olympicsphcoll1017.xml,80444/xv21224,2,7,7,16
"Transportation (Dept. of) Roadway Documentation Photograph Collection",waudepttransproadwayphcoll459.xml,80444/xv81745,3,6,7,16
"Unknown",waurosscharles4873.xml,80444/xv62728,8,4,4,16
"Bergamini (Rita)",waubergaminirita3416-001.xml,80444/xv62738,3,6,7,16
"Unknown",waugreenoughthomasl3212.xml,80444/xv78866,3,6,7,16
"Bakke (Kit) FBI Surveillance File",waubakkekit5600.xml,80444/xv16833,6,4,6,16
"Lujan (Herman)",waulujanhermandua3391.xml,80444/xv29672,4,6,6,16
"Blandau (Richard)",waublandaurichardjua5126.xml,80444/xv03189,3,6,7,16
"Unknown",wauvaronralph2100.xml,80444/xv81188,2,5,9,16
"University of Washington Dept. of Economics records",wauuwresource00315.xml,80444/xv39718,5,5,6,16
"University of Washington Dental Alumni Association Records",wauuwresource03023.xml,80444/xv97490,5,2,9,16
"Cranston (Patricia)",waucranstonpatriciaua4126.xml,80444/xv86215,4,5,7,16
"Unknown",wauellisjamesr2146.xml,80444/xv74304,5,5,6,16
"Wardall (Alonzo and Elizabeth) Diaries, Account Books and Other Materials",wauwardallalonzo0118.xml,80444/xv48410,8,4,4,16
"Unknown",waushotwellmarghareteross4060.xml,80444/xv81283,5,6,5,16
"University of Washington. Environmental Studies Advisory Committee.",wauuwresource00348.xml,80444/xv15713,5,5,6,16
"Unknown",wauhoffmanabe2744.xml,80444/xv87545,8,4,4,16
"Cox (Edward)",waucoxedwardgodfreyua0476.xml,80444/xv62164,7,7,2,16
"Unknown",waumccabeeliza1126.xml,80444/xv52117,5,5,6,16
"Anderson (Henning)",wauandersonhenninge2983.xml,80444/xv02413,8,5,3,16
"Unknown",wausamselgertrudecunningham3417.xml,80444/xv45355,5,4,6,15
"Secord (Mona)",wausecordmonak5494.xml,80444/xv58062,5,4,6,15
"Chandless (Robert H.) papers",wauchandlessroberthenry5999.xml,80444/xv37796,10,2,3,15
"Guntheroth (Warren)",wauguntherothwarrengua4101.xml,80444/xv74441,4,5,6,15
"Unknown",waukofoedthorvalda5215.xml,80444/xv10037,4,3,8,15
"Unknown",wauuwresource06984.xml,80444/xv14425,3,5,7,15
"Unknown",wauphelpsdonald2011.xml,80444/xv82946,9,3,3,15
"Harborview Medical Center (Seattle, Wash.). Pulmonary and Critical Care Medicine.",wauuwresource00477.xml,80444/xv61654,3,5,7,15
"Bodansky (David) Papers",wauua19_43_5270bodanskydavid.xml,80444/xv69777,2,4,9,15
"University Washington Academic Human Resources Records",wauuwresource00113.xml,80444/xv11303,4,3,8,15
"Oregon Trail Diary",wauoregontraildiary0514.xml,80444/xv48275,5,6,4,15
"Unknown",waukibbeelois5355.xml,80444/xv90127,4,4,7,15
"Unknown",wauleagueofwomenvotersofseattle1004.xml,80444/xv21148,10,1,4,15
"Unknown",waupritecabmarcus1746.xml,80444/xv74752,5,5,5,15
"Unknown",wauoneillaf1459.xml,80444/xv69668,2,7,6,15
"Northwood (Lawrence)",waunorthwoodlawrencekua3363.xml,80444/xv20046,2,7,6,15
"Unknown",wauhemlocksocietyofwashingtonstate4516.xml,80444/xv13494,4,6,5,15
"Dingwall (Ewen C.) Century 21 Exposition Photograph Collection",waudingwallewenphcoll463.xml,80444/xv97653,3,2,10,15
"Lynch (James)",waulynchjamesericua2468.xml,80444/xv49780,5,6,4,15
"Unknown",wauwrightclifford3876.xml,80444/xv04727,4,4,7,15
"Unknown",wauparachuteship2807.xml,80444/xv93679,3,6,6,15
"Unknown",wausummerslane0660.xml,80444/xv40045,5,1,9,15
"Unknown",wauyoungtheodosia5169.xml,80444/xv28948,5,3,7,15
"Unknown",waujacksonjohnr4668.xml,80444/xv68365,6,4,5,15
"University of Washington Environmental Health and Safety Dept. Radiation Safety Office records",wauuwresource00442.xml,80444/xv87106,4,4,7,15
"Unknown",wauballingerharry0539.xml,80444/xv32003,5,5,5,15
"Washington (State). Superior Court (Thurston County).",wauwashingtonstatesuperiorcourt2209.xml,80444/xv07614,2,6,7,15
"Buechel (Henry)",waubuechelhenrytua1976.xml,80444/xv39450,2,8,5,15
"Joseph L. Skoog Architectural Drawings of the Sigma Kappa Mu Chapter House",wausigmakappasororityph2004_073.xml,80444/xv25881,4,8,3,15
"Unknown",waubennettfreds4529.xml,80444/xv49414,2,7,6,15
"Unknown",wauleagueofwomenvotersbellevuewash1370.xml,80444/xv80578,2,6,7,15
"Unknown",waukikuchichihiro3711.xml,80444/xv56088,2,7,6,15
"Unknown",waupetersonfred1277.xml,80444/xv45074,3,3,9,15
"Ringold (Rose)",wauringoldrose1548_1728.xml,80444/xv85147,4,5,6,15
"Unknown",waurosenthalrichard4052.xml,80444/xv23706,7,5,3,15
"Federal Emergency Relief Administration/Civil Works Administration Improvements Photograph Collection",waufemacwaimprovementsphcoll272.xml,80444/xv30648,5,3,7,15
"De Leon (Tillie)",waudeleontillie3776.xml,80444/xv84771,4,3,8,15
"Unknown",waupedersenandrew3685.xml,80444/xv95532,3,4,8,15
"Sarkowsky (Herman)",wausarkowskyherman5486.xml,80444/xv64459,4,3,8,15
"Freeman (Miller) photograph album collection",waufreemanmillerphcoll1225.xml,80444/xv13528,3,6,6,15
"Unknown",wausturmanwilliam3662.xml,80444/xv91839,3,4,8,15
"Warth (John)",wauwarthjohnf1972.xml,80444/xv02871,7,3,5,15
"Marckworth (Gordon)",waumarckworthgordondua0550.xml,80444/xv42300,2,5,8,15
"Wash (Suzanne)",wauwashsuzannemaria2696-094.xml,80444/xv52102,5,3,7,15
"Unknown",waujuanitaimprovementclub3738.xml,80444/xv37551,9,2,4,15
"Pacific Coast Pensioners' Association (ILWU), Local 1 (Raymond, Wash.) Photographs",waupacificcoastpensionersassociationilwulocalraymondwash5676.xml,80444/xv48904,4,6,5,15
"Unknown",waugrunbaumhannah2231.xml,80444/xv53933,6,4,5,15
"Electrical Engineering Department Photograph Collection",wauelectricalengineeringdepartmentphcoll527.xml,80444/xv80099,3,6,6,15
"Szeftel (Marc)",wauszeftelmarcua3356.xml,80444/xv48364,3,5,7,15
"Unknown",wauhadassahthewomenszionistorganizationofamericaeverettchapter3577.xml,80444/xv72103,2,4,9,15
"Unknown",wauroderickstellavirginia0928.xml,80444/xv29901,4,7,4,15
"Willoughby (Sarah Cheney) Sketches",wauwilloughbysarahphcoll568.xml,80444/xv61181,6,3,6,15
"Unknown",wauehoferandsons4664.xml,80444/xv71771,7,5,3,15
"Partnow (Patricia)",waupartnowpatriciah2696.xml,80444/xv15768,0,3,12,15
"Unknown",waukatsmanmarian3124.xml,80444/xv03408,6,3,6,15
"Thwaites (John E.) Photographs",wauthwaitesjohnephcoll247.xml,80444/xv67483,5,4,6,15
"Steinberg (Burton) photograph collection",wausteinbergburtonphcoll1148.xml,80444/xv52749,2,5,8,15
"Schneeweiss (Ron and Diana) Oral History",wauschneeweiss5648.xml,80444/xv66003,5,5,5,15
"Unknown",wauwimmerthomaso2332.xml,80444/xv57858,3,5,7,15
"Wilsun (Don) Papers",wauwilsundon5414.xml,80444/xv83834,7,4,4,15
"de Groff (Edward) Photographs",waudegroffedwardphcoll317.xml,80444/xv72396,4,6,5,15
"Wagner (George)",wauwagnergeorgecorydon4292.xml,80444/xv58264,2,6,7,15
"Swan (Daniel)",wauswandanielc2696-095.xml,80444/xv96856,3,5,7,15
"Unknown",waurubensfamily2968.xml,80444/xv70028,7,2,6,15
"University of Washington. Dept. of Scandinavian Languages and Literature.",wauuwresource00305.xml,80444/xv29638,3,5,7,15
"Unknown",waunguyendinhhoa4533.xml,80444/xv18783,6,1,8,15
"Unknown",waufarmersunionwallawallawashingtonterritory4724.xml,80444/xv49261,3,2,10,15
"Unknown",waurathjohnc4436.xml,80444/xv47085,7,5,3,15
"Fritzberg (Olga)",waufritzbergolgaelkins3416-001.xml,80444/xv00851,3,6,6,15
"Harborview Medical Center (Seattle, Wash.). Financial Administration Office.",wauuwresource00470.xml,80444/xv46624,4,4,7,15
"Graves (Dorsett)",waugravesdorsettvua4123.xml,80444/xv55355,5,2,8,15
"Unknown",waufeigenbaumbennett2119.xml,80444/xv30172,4,4,7,15
"Pacific Northwest Booksellers Association records",waupacificnorthwestbooksellersassociation5556.xml,80444/xv89303,5,2,8,15
"University of Washington. Dept. of Linguistics.",wauuwresource00310.xml,80444/xv71862,6,6,3,15
"Mount St. Helens Eruption Photograph Collection",waumountsthelensphcoll227.xml,80444/xv14788,3,2,10,15
"Spafford (Michael,)",wauspaffordmichael2741.xml,80444/xv13180,7,5,3,15
"Unknown",waudixonaaronfloyd1422.xml,80444/xv12435,5,4,6,15
"Rothschild (E.)",waurothschildeeugeneua5195.xml,80444/xv85968,2,6,7,15
"Tancred (Douglas) Photographs",wautancreddouglasphcoll514.xml,80444/xv44015,6,6,3,15
"Chase (Doris) Film and Video Collection",wauchasedorisph2004_095.xml,80444/xv33761,5,4,6,15
"Seattle and Washington State Stereocard Collection",waugreenlakestereocardsphcoll655.xml,80444/xv49598,3,4,8,15
"Unknown",waumcandrewraymondl3850.xml,80444/xv89059,3,7,5,15
"University of Washington. Libraries. Staff Association.",wauuniversityofwashingtonlibrariesstaffassociationua4556.xml,80444/xv73214,5,3,7,15
"David (Jean,)",waudavidjeanua2936.xml,80444/xv77621,4,5,6,15
"Kritzer (Arthur B.) Oral History",waukritzerarthurb5615.xml,80444/xv76779,5,5,5,15
"Unknown",wauseattlehabimaplayers3928.xml,80444/xv15557,3,7,5,15
"Collier (B.C.) Photographs",waucollierbcphcoll358.xml,80444/xv19160,4,7,4,15
"Unknown",wauelliotthenry0955.xml,80444/xv88626,3,5,7,15
"Meisnest (Darwin)",waumeisnestdarwinua2945.xml,80444/xv02679,5,6,4,15
"Unknown",waublocherwl4616.xml,80444/xv41192,2,5,8,15
"Winston (Patrick)",wauwinstonpatrickhenryjr1062_1066.xml,80444/xv30673,3,5,7,15
"Unknown",wauliawhray5158.xml,80444/xv69052,4,6,5,15
"Unknown",waulevyjackd4324.xml,80444/xv46594,2,5,8,15
"Ward (Leona)",wauwardleona3416-001.xml,80444/xv88742,5,4,6,15
"Cornish School Photograph Collection",waucornishschoolphcoll235.xml,80444/xv67163,5,6,4,15
"Kozak (David)",waukozakdavidl2696.xml,80444/xv10879,5,4,6,15
"Unknown",wauschlesingeremmaadatto3462.xml,80444/xv11398,1,6,8,15
"Schmidt (Fred)",wauschmidtfredhenryua4278.xml,80444/xv96319,5,6,4,15
"Unknown",waujohnsonalgot3952.xml,80444/xv01098,6,3,6,15
"Unknown",waunorthwestwatercolorsociety4892.xml,80444/xv14758,9,3,3,15
"University of Washington. Graduate School of Social Work.",wauuwresource00437.xml,80444/xv02368,4,4,7,15
"Unknown",waushawrobertb3143.xml,80444/xv43997,3,4,8,15
"Unknown",waumyersguyc0764.xml,80444/xv92572,3,6,6,15
"Heiman (Jo)",wauheimanjokleiner5480.xml,80444/xv39312,3,6,6,15
"Ed Brady Photographs of Mount St. Helens Eruption",waubradyedphcoll889.xml,80444/xv30682,3,4,8,15
"Oswald (Max R.) Collection of Army Signal Corps Logging Photographs",wauoswaldmaxphcoll807.xml,80444/xv49710,5,7,3,15
"Unknown",waucollegeofosteopathicmedicineofthepacific3544.xml,80444/xv04531,5,5,5,15
"Hatton (Orin)",wauhattonorint2696.xml,80444/xv78527,3,5,7,15
"Unknown",wauvasenfamily3470.xml,80444/xv29464,3,5,7,15
"Daniels (Joseph,)",waudanielsjosephua0416.xml,80444/xv32952,5,3,7,15
"Unknown",waureinigdio2291.xml,80444/xv83148,3,5,7,15
"Davis (John)",waudavisjohnm3239_3779.xml,80444/xv40960,4,4,7,15
"Unknown",wauvinsonrobertc2679.xml,80444/xv71109,4,5,6,15
"Unknown",waurogersfrances2540.xml,80444/xv64364,2,5,8,15
"De Vries (Mary Aid) Photograph Collection",waudevriesmaryaidphcoll097.xml,80444/xv93630,3,5,7,15
"Rousso (Azario) Papers",wauroussoazario5838.xml,80444/xv59921,5,3,7,15
"Unknown",waudinkelspielfamily2814.xml,80444/xv05596,5,3,7,15
"Unknown",wausecondbaptistchurchroslynwash0883.xml,80444/xv86337,6,3,6,15
"Unknown",waupowersmichaelt0598.xml,80444/xv21282,6,5,4,15
"Cox (Edward G.) Photograph Collection",waucoxedwardphcoll1241.xml,80444/xv13290,6,4,5,15
"Leisy (Robert) Papers",wauleisyrobert5622.xml,80444/xv13537,2,4,9,15
"Phelps (Elaine)",wauphelpselainefarkas1835.xml,80444/xv72894,4,4,7,15
"Philological Association of the University of Washington.",wauphilologicalassociationoftheuniversityofwashington5067.xml,80444/xv41934,6,4,5,15
"Baker (Martin)",waubakermartinw2071_2791.xml,80444/xv99703,3,5,7,15
"Petite (Irving) Letter",waupetiteirving5642.xml,80444/xv46240,4,6,5,15
"Donald A. Schmechel Oral History Project.",waudonaldaschmecheloralhistoryproject4056.xml,80444/xv10739,3,5,7,15
"Unknown",wauniedfeltmiltona0845.xml,80444/xv16378,5,4,6,15
"Bermuda Family Glass Plate Negative Collection",waubermudafamilyph2003_013.xml,80444/xv88516,4,3,8,15
"Unknown",wauuwresource06509.xml,80444/xv31579,5,7,3,15
"Raising of the Aswan Dam Films",wauraisingoftheaswandamphcoll955.xml,80444/xv02804,8,1,6,15
"Koike (Kyo)",waukoikekyophcoll262.xml,80444/xv57546,7,4,4,15
"Unknown",wautweneygeorgeh4558.xml,80444/xv13269,6,5,4,15
"Unknown",waucurrentcenturyclub5868.xml,80444/xv95483,3,6,6,15
"Washington State Nurses Association Scrapbook",wauwashingtonstatenursesassociationphcoll523.xml,80444/xv20288,2,2,11,15
"Elite Photo Studio Collection",wauelitestudiophcoll534.xml,80444/xv79483,6,3,6,15
"Unknown",waucoxchristopher5757.xml,80444/xv51858,3,5,7,15
"Unknown",wauchasegail2559.xml,80444/xv92144,4,6,5,15
"University of Washington. Division of Marine Resources.",wauuwresource00454.xml,80444/xv75289,5,6,4,15
"Lonn (Ellen Emanuel) Photograph Collection",waulonnellenemanuelphcoll880.xml,80444/xv44830,2,8,5,15
"Williams (Robert)",wauwilliamsroberthardinua2933.xml,80444/xv57891,1,6,8,15
"Bassingthwaighte (James)",waubassingthwaightejamesbua5127.xml,80444/xv79907,5,4,6,15
"Billings (Lloyd and Ethel) movie Theater Photograph collection",waubillingslloydtheaterphcoll1189.xml,80444/xv62664,5,3,7,15
"Unknown",waubergenheimanderst3770.xml,80444/xv59472,5,5,5,15
"B'nai B'rith Youth Organization. Northern Region.",waubnaibrithyouthorganizationnorthernregion2687.xml,80444/xv46731,3,6,6,15
"Harry Bridges Center for Labor Studies Film and Videotape Collection",wauharrybridgescenterphcoll1277.xml,80444/xv32293,7,3,5,15
"Unknown",wauchelancountypublicutilitydistrictnowash5439.xml,80444/xv22113,3,7,5,15
"Northwest Linguistic Collection: Explorations in the Grammar of Kwak'wala",waulittellpatrick2696-131.xml,80444/xv61987,4,3,8,15
"Yakima and Pacific Coast Railroad Photograph Album",wauyakimaandpacificcoastrailroadphcoll016.xml,80444/xv06707,3,5,7,15
"Terry (Beatrice) Photograph Collection",wauterrybeatricephcoll1094.xml,80444/xv33380,7,4,4,15
"Jones (Judith)",waujonesjudithann2696-074.xml,80444/xv48968,2,7,6,15
"Souvenir of Port Angeles, Wash. Album",wauportangelesphcoll815.xml,80444/xv26263,6,1,8,15
"Geological Survey (U.S.).",waugeologicalsurvey2199.xml,80444/xv50207,2,4,9,15
"Huber (John)",wauhuberjohnrichardua2956.xml,80444/xv83181,3,4,8,15
"Fielde (Adele)",waufieldeadelem4800.xml,80444/xv53317,8,4,3,15
"Wilson (Ruth)",wauwilsonruthmua2317.xml,80444/xv03402,3,6,6,15
"Traver (Merton)",wautravermertonphcoll1051.xml,80444/xv21044,8,2,5,15
"Irvine (Demar)",wauirvinedemarua4129.xml,80444/xv09295,3,4,8,15
"Unknown",wauvoorheeshannah5755.xml,80444/xv54141,3,6,6,15
"Patterson (Viola,)",waupattersonviola2563.xml,80444/xv24935,2,7,6,15
"Willis (Park Weed) Photograph Collection",wauwillisparkweedphcoll566.xml,80444/xv65805,5,4,6,15
"Unknown",waugunngeorge2615.xml,80444/xv49627,4,5,6,15
"Unknown",waumccaffreemaryellen2177.xml,80444/xv06057,5,4,6,15
"University of Washington Risk Management Office Records",wauuwresource00202.xml,80444/xv37420,3,4,8,15
"Forest History Society.",wauforesthistorysociety0006.xml,80444/xv77972,6,4,5,15
"Nance HIV/AIDS scrapbooks",waunancebarbaram5641.xml,80444/xv92956,4,4,7,15
"Research Society (University of Washington).",wauresearchsociety3325.xml,80444/xv63781,5,6,4,15
"Lawrence (Geraldine)",waulawrencegeraldine1875.xml,80444/xv77337,5,4,6,15
"Craig (Marybelle) Lantern Slide Collection",waucraigmarybellephcoll193.xml,80444/xv27795,4,3,8,15
"Unknown",waumountaineerssocietyskimountaineeringcommittee3272.xml,80444/xv08926,3,2,10,15
"Israel (Norman)",wauisraelnorman4457.xml,80444/xv56933,4,3,8,15
"Petersen (Lemuel)",waupetersenlemuel4466_5228.xml,80444/xv40078,3,5,7,15
"Henning (Charles)",wauhenningcharlesnua4420.xml,80444/xv73416,3,6,6,15
"Friedman (Henry) Papers",waufriedmanhenry4403.xml,80444/xv52307,4,3,8,15
"Partridge (William H.) Alaska Photographs",waupartridgewilliamhphcoll322.xml,80444/xv44354,8,5,2,15
"Harborview Medical Center (Seattle, Wash.). Dept. of Anesthesiology.",wauuwresource00476.xml,80444/xv50942,3,5,7,15
"Unknown",waunorwegianseamenwarvetassn5787.xml,80444/xv74694,4,5,6,15
"Unknown",waufleuryalfredj5210.xml,80444/xv95193,3,5,7,15
"Patten (Robert)",wauumbrellamanphcoll868.xml,80444/xv64813,9,2,4,15
"Gottfried (Alex)",waugottfriedalexua2264.xml,80444/xv97726,6,4,5,15
"Unknown",wauhaasjessienores4990.xml,80444/xv04367,4,4,7,15
"Unknown",wauwakefieldlowell3017.xml,80444/xv96954,7,4,4,15
"B'nai B'rith International.",waubnaibrithinternational3741.xml,80444/xv80300,7,4,4,15
"Unknown",wausissonea2123.xml,80444/xv33834,5,2,8,15
"Unknown",waupadelfordfamily3359.xml,80444/xv42538,3,4,8,15
"Frank (Angeline)",waufrankangelinetobin3416-001.xml,80444/xv99472,2,7,6,15
"Shemya Air Force Base Album photographs",waushemyaafbphotographalbumphcoll1289.xml,80444/xv67596,5,4,6,15
"Unknown",wauniedererikadessauer3867.xml,80444/xv43408,2,7,6,15
"Unknown",wauphillipsww4844.xml,80444/xv30947,3,6,6,15
"Mitchell (Helen)",waumitchellhelen2790.xml,80444/xv10186,3,6,6,15
"Unknown",waulloydhenrydemarest4678.xml,80444/xv58926,4,6,5,15
"Gordon (Scott) Photograph Collection",waugordonscottphcoll775.xml,80444/xv99374,6,8,1,15
"Hasson (Eddie)",wauhassoneddie5453.xml,80444/xv76583,7,3,5,15
"Unknown",wauhawkinsonericvirgil2049.xml,80444/xv90783,6,3,6,15
"Unknown",waushiosakipauline3968.xml,80444/xv42819,4,4,7,15
"University of Washington Clarke Hall Album",wauclarkehallphcoll112.xml,80444/xv82922,2,6,7,15
"Unknown",waucoalcreekroadcompany4636.xml,80444/xv11434,12,0,3,15
"Wittfogel (Karl)",wauwittfogelkarlaugustua3361.xml,80444/xv56948,3,3,9,15
"Unknown",wauwadealexandermilton4465.xml,80444/xv14379,3,5,7,15
"Lipp (Leo)",waulippleo0898_0924.xml,80444/xv61352,3,8,4,15
"Unknown",waugrodsteins4527.xml,80444/xv58847,8,2,5,15
"Mander (Linden)",waumanderlindenaua0730.xml,80444/xv66885,3,5,7,15
"Lillis (Jack) Photograph Album",waulillisjackphcoll360.xml,80444/xv90676,5,5,5,15
"Unknown",waumercerwilliamdowe0314.xml,80444/xv45846,3,3,9,15
"Minto (Lee) papers",waumintolee5871.xml,80444/xv14627,3,7,5,15
"KAYE (Radio station : Puyallup, Wash.).",waukaye3788.xml,80444/xv56106,1,6,7,14
"Dunham (Joel)",waudunhamjoel2696-135.xml,80444/xv64120,2,4,8,14
"Unknown",wauterrycharlesc0247.xml,80444/xv94296,3,5,6,14
"University of Washington. Budget Office.",wauuwresource00101.xml,80444/xv48257,4,5,5,14
"Brinkley (Joseph)",waubrinkleyjosepharthur1190.xml,80444/xv26306,5,5,4,14
"Nelson (Ibsen)",waunelsonibsena2858_4007.xml,80444/xv76150,7,6,1,14
"Hanan (Morris)",wauhananmorrisb1743_1827.xml,80444/xv67657,3,6,5,14
"Unknown",wauedwardselizabetha4196.xml,80444/xv85644,4,4,6,14
"Unknown",waugravesfrancesa4490.xml,80444/xv69036,3,7,4,14
"Gottfried (Erika) Papers",waugottfriederika2551.xml,80444/xv75599,4,6,4,14
"Unknown",waulincolnhighschoolseattlewashassociatedclasses5194.xml,80444/xv77926,5,5,4,14
"Student Union for Peace Action.",waustudentunionforpeaceaction1911.xml,80444/xv41940,7,2,5,14
"Unknown",wauseattleanthropologicalassociation2255.xml,80444/xv73800,3,4,7,14
"Unknown",wausecularjewishcirclepugetsound5759.xml,80444/xv74487,5,4,5,14
"Payton (Charles) Photograph Album",waupaytoncharlesphcoll499.xml,80444/xv30236,2,3,9,14
"Fleagle (Robert)",waufleaglerobertguthrie19ua5276.xml,80444/xv80993,5,4,5,14
"Bone (Hugh)",waubonehughalvinua2066.xml,80444/xv51123,3,3,8,14
"Holmes (Thomas)",wauholmesthomashua3334.xml,80444/xv17858,3,6,5,14
"Farr (Sheila)",waufarrsheila5513.xml,80444/xv41918,4,5,5,14
"Edwards (Harlan) Photograph Collection",wauedwardsharlanphcoll1031.xml,80444/xv20779,2,5,7,14
"Unknown",wausmailjohn4486.xml,80444/xv08172,8,2,4,14
"Lenfest (Mrs. Elmer) Photograph Collection",waulenfestmrselmerphcoll1022.xml,80444/xv95553,2,5,7,14
"Pamela Schubert Oral History",wauschubertpamela5613.xml,80444/xv80157,4,4,6,14
"Miller (William T.) home movie films",waumillerwilliamtphcoll954.xml,80444/xv78475,8,6,0,14
"Last Salmon Feast",waulastsalmonfeastfilmphcoll970.xml,80444/xv64602,7,4,3,14
"Unknown",waubermangizel2993.xml,80444/xv96075,3,5,6,14
"University of Washington. Dept. of Atmospheric Sciences.",wauuwresource00293.xml,80444/xv59033,4,8,2,14
"Lange (Greg)",waulangegreg2202.xml,80444/xv21005,5,5,4,14
"Unknown",waupitteredwarda1723.xml,80444/xv02084,1,7,6,14
"Monsen (R.)",waumonsenrjosephua2857.xml,80444/xv98721,4,4,6,14
"Josenhaus (Sarah)",waujosenhaussarahcharlotte3416-001.xml,80444/xv77313,2,4,8,14
"Durand (Joël-François)",waudurandjoelfrancoisua4592.xml,80444/xv80334,3,5,6,14
"Cole (Thomas)",waucolethomasrua0852.xml,80444/xv39886,3,5,6,14
"Zimmerman (Robert) Oral History",wauzimmermanrobert5667.xml,80444/xv97885,8,2,4,14
"University of Washington. College of Forest Resources. Dean.",wauuwresource00341.xml,80444/xv03112,6,4,4,14
"Northwest and Western Canada Postcard Collection",waunorthwestwesterncanadapostcardphcoll801.xml,80444/xv75964,3,4,7,14
"Unknown",waubinnsarchie4297.xml,80444/xv76379,1,6,7,14
"Peizer (Ruth)",waupeizerruth5481.xml,80444/xv71408,4,4,6,14
"Unknown",waumasonlouisehurlbut4023.xml,80444/xv18344,3,3,8,14
"Poll Family Photograph Collection",waupollfamilyphcoll1079.xml,80444/xv27713,1,7,6,14
"Unknown",waulonnellenemanuel4051.xml,80444/xv06362,3,4,7,14
"Unknown",wauholmesharlanb2614.xml,80444/xv98413,6,4,4,14
"Unknown",waufroehlichlola3802.xml,80444/xv42227,1,3,10,14
"Richards (Francis)",waurichardsfrancisaua4111.xml,80444/xv37579,4,2,8,14
"Efrat (Barbara)",wauefratbarbaras1835-018.xml,80444/xv21582,3,4,7,14
"Unknown",waunorwegian17thofmaycommitteeseattlewash3569.xml,80444/xv21142,4,6,4,14
"Unknown",wauhanohcharles2547.xml,80444/xv48931,10,1,3,14
"Unknown",waumackeyvivian3032.xml,80444/xv70281,1,3,10,14
"Unknown",wautsukamakik1453.xml,80444/xv38238,1,5,8,14
"Wells Fargo Bank (University Branch) Photograph Collection",wauwellsfargobankuniversitybranchphcoll537.xml,80444/xv59292,7,4,3,14
"Condon (Herbert)",waucondonherberttua1969_2931.xml,80444/xv47305,4,8,2,14
"Liston (John)",waulistonjohnua4252.xml,80444/xv08526,5,4,5,14
"Unknown",waupugetsoundchehalisrailroadcompany4855.xml,80444/xv97006,4,6,4,14
"Unknown",waukittredgecharlesb4542.xml,80444/xv88775,5,4,5,14
"Copeland (Tom)",waucopelandtom2021.xml,80444/xv31320,5,3,6,14
"TLN Discover America Series Videotapes",wautlnvideotapephcoll888.xml,80444/xv31384,5,4,5,14
"Unknown",wauhebrewfreeloanassociationseattlewash3986.xml,80444/xv56033,1,6,7,14
"Tollefson (James W.) Papers",wautollefsonjameswua5922.xml,80444/xv45327,10,1,3,14
"Unknown",waushannonwilliamd1167.xml,80444/xv39724,2,5,7,14
"MacDonald Family Album",waumacdonaldfamilyphcoll057.xml,80444/xv57611,3,5,6,14
"Unknown",waublackpantherparty1389.xml,80444/xv77322,3,4,7,14
"Seattle Jewish Primary School photograph collection",wauseattlejewishprimaryschoolphcoll1165.xml,80444/xv17172,4,6,4,14
"Unknown",wauremsbergcharlese4024.xml,80444/xv63604,3,3,8,14
"Unknown",wautemplebetheltacomawash3858.xml,80444/xv91223,3,4,7,14
"Gwendolyn May Meader Scrapbook",waumeadergwendolynmay5594.xml,80444/xv20809,8,3,3,14
"Unknown",wauklukkeniverj4766.xml,80444/xv96173,2,4,8,14
"Unknown",wauepsteinsylvia4787.xml,80444/xv27178,5,4,5,14
"Anderson (James)",wauandersonjamesr4311.xml,80444/xv99282,2,6,6,14
"Unknown",wauthomasjamespjamespatrick5433.xml,80444/xv40213,4,4,6,14
"Seattle Repertory Theatre Portraits Photograph Collection",wauseattlerepertorytheaterphcoll199.xml,80444/xv05508,4,3,7,14
"Osborne (J.K.)",wauosbornejk4043.xml,80444/xv46588,2,6,6,14
"Congress of Industrial Organizations (U.S.).",waucongressofindustrialorganizations0722.xml,80444/xv50872,4,4,6,14
"Unknown",waucommitteeforanindependentpostintelligencerseattlewash3674.xml,80444/xv45520,2,6,6,14
"Unknown",wautrafirm5198.xml,80444/xv41488,4,7,3,14
"Knudsen (Andrew)",wauknudsenandrew4568.xml,80444/xv81213,5,5,4,14
"Unknown",wauelizaandersonship2736.xml,80444/xv12677,4,3,7,14
"Sperling (Scott)",wausperlingscott5482.xml,80444/xv59704,3,5,6,14
"Kono (J.)",waukonojc1553.xml,80444/xv06915,3,3,8,14
"Milczewski (Marion)",waumilczewskimarionaua2707.xml,80444/xv66195,3,4,7,14
"Denny (Grace)",waudennygracegua1871.xml,80444/xv53286,3,5,6,14
"Unknown",wauedelmaym0639.xml,80444/xv87490,5,6,3,14
"Fant (Karen)",waufantkarenm3416-001.xml,80444/xv91555,3,3,8,14
"Unknown",wauwrightgildowhartmanandteegardenarchitectsseattle2703.xml,80444/xv52264,6,3,5,14
"Wiburg (Martha) University of Washington Photograph Album",wauwiburgmarthaphcoll119.xml,80444/xv60330,6,0,8,14
"Julia Colleen Miller Linguistic Field Research on Doig River and Blueberry River dialects of Beaver (Athabaskan)",waumillerjuliacolleen2696-138.xml,80444/xv25650,6,4,4,14
"Paul (Helen)",waupaulhelen3416-001.xml,80444/xv13922,5,6,3,14
"Bothwell (Alice)",waubothwellalice2451.xml,80444/xv50564,3,4,7,14
"Unknown",waumcgrewjamese3285.xml,80444/xv56018,2,3,9,14
"Unknown",waukimballleea4367.xml,80444/xv46249,2,5,7,14
"Nelson (H. G.) Photograph Collection",waunelsonhgphcoll1320.xml,80444/xv27661,5,2,7,14
"Unknown",wauleagueofwomenvotersoflakewashingtoneastbellevuewash1822.xml,80444/xv51516,3,6,5,14
"Dorsaz and Schwerin Photographs",waudorsazandschwerinphcoll279.xml,80444/xv20678,2,3,9,14
"Unknown",waugoodwinterenz4657.xml,80444/xv68045,6,4,4,14
"Wessman (Harold)",wauwessmanharoldeverettua1162.xml,80444/xv41040,1,4,9,14
"Hogle (Katherine)",wauhoglekatherine4381.xml,80444/xv87524,4,5,5,14
"Daniels (Roger)",waudanielsroger3561.xml,80444/xv26208,3,6,5,14
"Washington State Forestry Conference.",wauwashingtonstateforestryconference0893_3025.xml,80444/xv87197,5,2,7,14
"Lucas (Ann)",waulucasanndavenport2696-109.xml,80444/xv01638,2,6,6,14
"Lambert (George) Recordings",waulambertgeorge5830.xml,80444/xv31069,5,5,4,14
"Pruzan (Lucy)",waupruzanlucy5472.xml,80444/xv08801,6,4,4,14
"Meeds (Lloyd)",waumeedslloyd2900.xml,80444/xv27389,5,3,6,14
"Leach (Rick) photographs of railroad stations",wauleachrailroadstationsphcoll1302.xml,80444/xv20635,6,2,6,14
"Unknown",wauobazawayoshitani3498.xml,80444/xv87356,1,3,10,14
"Brown (Greg)",waubrowngreg2696-116.xml,80444/xv36981,4,5,5,14
"Unknown",waurosenzweignorman4299.xml,80444/xv27993,2,6,6,14
"Durning (Marvin) Photograph Collection",waudurningmarvinph2015_009.xml,80444/xv89456,5,3,6,14
"Unknown",wausweenseverna0378.xml,80444/xv59481,3,4,7,14
"Conway (Dorothy) photographs",wauconwaydorothyph2012_009.xml,80444/xv06024,4,3,7,14
"Czaykowski-Higgins (Ewa)",wauczaykowskihigginsewa2696-066.xml,80444/xv76217,2,7,5,14
"Unknown",wauwillsonfredericka0395.xml,80444/xv68148,2,4,8,14
"Moisio (Wayne)",waumoisiowayne5726.xml,80444/xv08972,5,5,4,14
"Metzger (Wendell) papers",waumetzgerwendell5375.xml,80444/xv78680,2,4,8,14
"Unknown",wautunstallroberte0588.xml,80444/xv92239,4,5,5,14
"Taff (Alice)",wautaffalice2696-111.xml,80444/xv24716,7,4,3,14
"Unknown",wauglicksteindonaldw3698.xml,80444/xv03027,3,4,7,14
"Murray (Lorman G.) Photograph Albums",waumurraylormangph2015_002.xml,80444/xv75720,4,4,6,14
"Unknown",waunorthwestpublicpowerassociation0214_1674.xml,80444/xv65911,2,4,8,14
"Harborview Medical Center (Seattle, Wash.). Accounts Receivable Dept.",wauuwresource00473.xml,80444/xv35189,6,6,2,14
"Unknown",waumuscateldorothyfranco4208.xml,80444/xv69174,2,1,11,14
"Unknown",waumillerwilliamwinlock4795.xml,80444/xv77676,5,5,4,14
"Artist Trust (Wash.).",wauartisttrust4198.xml,80444/xv35244,3,6,5,14
"Unknown",waumetropolitantheatrecompanyseattlewash5256.xml,80444/xv77703,4,5,5,14
"Warner & Randolph Puget Sound Series Photographs",wauwarnerrandolphphcoll720.xml,80444/xv64608,4,5,5,14
"Kan (Sergei)",waukansergei2696-030.xml,80444/xv31250,4,5,5,14
"University of Washington. Public Exercises Office.",wauuwresource00104.xml,80444/xv61337,2,5,7,14
"Liddle (Alan) Architectural Drawing and Photograph Collection",wauliddlealanphcoll1321.xml,80444/xv93392,0,0,14,14
"Unknown",wauchapmanhazlem3241.xml,80444/xv28167,5,6,3,14
"Washington State Labor Council Photograph Collection",wauwashingtonstatelaborcouncilphcoll146.xml,80444/xv80169,6,3,5,14
"Oulet (George)",wauouletgeorge1043.xml,80444/xv35830,2,4,8,14
"Edmundson (Clarence)",wauedmundsonclarenceua0355.xml,80444/xv58941,5,4,5,14
"Unknown",wauhartmanmea3236.xml,80444/xv79611,3,6,5,14
"Gould (Howard)",waugouldhowardua4510.xml,80444/xv34829,4,6,4,14
"Creager (Joe)",waucreagerjoesua4274.xml,80444/xv59948,3,5,6,14
"Leis (George)",wauleisgeorgeua4108.xml,80444/xv50701,6,3,5,14
"Unknown",wauredferndonaldverne0573.xml,80444/xv07647,5,3,6,14
"Unknown",waumunicipalleagueofseattleandkingcountybuildingsandgroundscommittee3746.xml,80444/xv78839,9,2,3,14
"Unknown",wauhasegawawilliam2063.xml,80444/xv59933,2,7,5,14
"Day (George)",waudaygeorgeeh0082.xml,80444/xv59231,4,3,7,14
"San Juan County Album",wausanjuancountyphcoll048.xml,80444/xv02291,4,4,6,14
"Van de Water (R.R.) Photograph Album",wauvandewaterrrph2009_038.xml,80444/xv06491,5,5,4,14
"Chandler (Mr. and Mrs. John Hassett) Cabinet Card",wauchandlerjohnhassettphcoll469.xml,80444/xv44827,2,1,11,14
"Pacific Northwest Historians Guild Photograph Collection",waupnwhistoriansguildph2015_014.xml,80444/xv93215,4,6,4,14
"Unknown",wauuwresource01434.xml,80444/xv31558,4,5,5,14
"Unknown",waunorthwestprintmakers4302.xml,80444/xv13330,3,4,7,14
"Unknown",waujapanesebaptistchurchseattlewash2223.xml,80444/xv22268,3,6,5,14
"Larson (Eric)",waularsonericbua3343.xml,80444/xv45724,3,3,8,14
"Burstein (Paul)",waubursteinpaul4054.xml,80444/xv00909,3,6,5,14
"Unknown",wautacomawashdeptofpublicutilities4920.xml,80444/xv43652,5,2,7,14
"Unknown",wausocietyofamericanforesterswashingtonstatesociety3646.xml,80444/xv74472,2,6,6,14
"Unknown",wauuwresource00346.xml,80444/xv12689,5,1,8,14
"Trail Blazers Club Photograph Collection",wautrailblazersphcoll620.xml,80444/xv59174,5,5,4,14
"Unknown",wauswansonaliceeleanor3563.xml,80444/xv11145,2,3,9,14
"Unknown",wauoneilgriffith4777.xml,80444/xv18826,2,4,8,14
"Irmscher (William)",wauirmscherwilliamfua4790.xml,80444/xv78558,4,4,6,14
"Gill (Hiram C.) Masonry Dam Construction Photograph Album",waugillhiramcphcoll046.xml,80444/xv99850,6,5,3,14
"University of Washington, School of Social Work, Social Development Research Group Records",wauuwresource05735.xml,80444/xv71273,4,3,7,14
"Children's Drawings from Nome, Alaska Collection of",wauchildrensdrawingsnomephcoll872.xml,80444/xv94760,2,6,6,14
"Rice (Charles M.) Slide Collection",wauricephcoll388.xml,80444/xv94876,2,5,7,14
"Unknown",wauberrorosascharhon2386.xml,80444/xv37820,3,3,8,14
"Unknown",waunorwegiancommercialclubseattlewash2394.xml,80444/xv24798,3,3,8,14
"Unknown",wauquadaartclub2758.xml,80444/xv25848,4,6,4,14
"Unknown",wauwilloughbyoliverl4772.xml,80444/xv42376,2,3,9,14
"University of Washington. College of Mines.",wauuwresource00337.xml,80444/xv65286,7,3,4,14
"Blair (Karen J.) papers",waublairkarenj3376.xml,80444/xv57687,6,6,2,14
"Unknown",waurileyedwardf0638.xml,80444/xv94671,2,5,7,14
"Unknown",waudulienlouis5016.xml,80444/xv31759,6,4,4,14
"Nelson (Emma)",waunelsonemmaanderson2499.xml,80444/xv08721,2,4,8,14
"Johnston (Jay) Papers",waujohnstonjay4214.xml,80444/xv29229,4,3,7,14
"Condon (Donald)",waucondondonaldua4131.xml,80444/xv41763,3,3,8,14
"Kingsbury (Chester H.) North Seattle Printing Company Photograph Collection",waunorthseattleprintingcompanyphcoll682.xml,80444/xv12295,2,4,8,14
"Lowry (Mike) Photograph Collection",waulowrymikeph2005_040.xml,80444/xv99465,6,3,5,14
"Timmons (Jerry) Tacoma Pantages Theater photograph collection",wautacomapantagestheaterphcoll1276.xml,80444/xv64089,3,6,5,14
"University of Washington Office of Student Financial Aid Records",wauuwresource00153.xml,80444/xv76049,4,4,6,14
"Davis (Dan) climbing journals",waudavisdan5854.xml,80444/xv82449,3,3,8,14
"Unknown",waumcclungmildred5351.xml,80444/xv36688,6,3,5,14
"Unknown",waucasselprattseattlewash4703.xml,80444/xv30197,2,5,7,14
"Russian Islands and Unalaska, Alaska Photograph Collection",waurussianislandsunalaskaphcoll839.xml,80444/xv14202,3,3,8,14
"Clark (Barrett)",wauclarkbarretth0650.xml,80444/xv32754,2,2,10,14
"Duffy (Lucille)",wauduffylucilleua2509.xml,80444/xv24255,2,4,8,14
"Bridge (Herbert)",waubridgeherbertm5458.xml,80444/xv73782,3,7,4,14
"Unknown",wauplumbherbertl1480.xml,80444/xv67761,3,6,5,14
"Franseen family",waufranseenfamily1733.xml,80444/xv63031,2,3,9,14
"Unknown",waurosenhauptharry1494.xml,80444/xv08944,3,3,8,14
"Goodwill Games Sites Photograph Collection",waugoodwillgamesph2010_015.xml,80444/xv98114,5,3,6,14
"Unknown",wauhardyww0714.xml,80444/xv59234,3,3,8,14
"Wheeler (Donald)",wauwheelerdonaldnivenua1783.xml,80444/xv23394,4,4,6,14
"Unknown",wausundborgvilma2253.xml,80444/xv45550,3,4,7,14
"Baksi (Shila)",waubaksishila2696.xml,80444/xv53878,2,5,7,14
"University of Washington. Dept. of Restorative Dentistry",wauuwresource00363.xml,80444/xv53906,3,7,4,14
"Ash (Ada,)",wauashada5474.xml,80444/xv25442,2,6,6,14
"Seattle Fire Photograph Collection",wauseattlefirephcoll684.xml,80444/xv85079,5,2,7,14
"Shulman (Julius) papers",waushulmanjulius5738.xml,80444/xv44635,7,4,3,14
"Unknown",wauassociationforretardedcitizensofwashingtontrustfund5128.xml,80444/xv97100,2,4,8,14
"Unknown",wauwhitworthjamesedwin4967.xml,80444/xv82135,6,4,4,14
"Reifler (Erwin,)",waureiflererwinua0644.xml,80444/xv86822,4,3,7,14
"University of Washington. Asian Arts Center.",wauuwresource00278.xml,80444/xv20407,7,3,4,14
"Central Pamphlet File",waucentralpamphletfile5110.xml,80444/xv25820,6,3,5,14
"Washington Roadside Council Photograph Collection",wauwashingtonroadsidecouncilphcoll528.xml,80444/xv85977,4,3,7,14
"Works Progress Administration Photograph Collection",wauworksprogressadministrationphcoll268.xml,80444/xv39923,4,5,5,14
"Unknown",wauwoodwardwardw2298.xml,80444/xv74618,4,4,6,14
"Puget Sound Governmental Conference.",waupugetsoundgovernmentalconference1041_2575.xml,80444/xv26785,2,8,4,14
"Unknown",waupowell-tourtellottefilmsphcoll977.xml,80444/xv06607,7,1,6,14
"Pacific Northwest Conservationists",waupacificnorthwestconservationists3874.xml,80444/xv85260,4,5,5,14
"Unknown",wausnivelyhenryj3095.xml,80444/xv24472,4,2,8,14
"Unknown",waukaufmanpaul0567.xml,80444/xv47015,8,0,6,14
"Unknown",wauwhitakerferdinandg4962.xml,80444/xv72921,2,3,9,14
"Unknown",wauclydesiegfried1551.xml,80444/xv03134,5,3,6,14
"Unknown",waupugetsoundfurniturecompany4857.xml,80444/xv76620,9,3,2,14
"Otto Reinert papers",waureinertottoua5723.xml,80444/xv10430,5,3,6,14
"Unknown",wausingletonburr2188.xml,80444/xv72409,3,3,7,13
"United States. Works Progress Administration.",wauunitedstatesworksprogressadministration0582_3327_5432.xml,80444/xv49203,3,5,5,13
"Unknown",wauhoffmanfergus0274.xml,80444/xv63183,3,3,7,13
"University of Washington Libraries Photograph Collection",wauuniversityofwashingtonlibrariesphcoll493.xml,80444/xv85745,6,1,6,13
"McKernan (Donald)",waumckernandonaldlua2912.xml,80444/xv81509,2,4,7,13
"Steel (W.)",wausteelwg4387.xml,80444/xv33300,2,5,6,13
"Gilbert (Kenneth,)",waugilbertkenneth0552_1302.xml,80444/xv97396,3,5,5,13
"Smith (Margaret)",wausmithmargaretbayard0115.xml,80444/xv65945,3,5,5,13
"Unknown",waucatlettfredwayne0216.xml,80444/xv04928,1,6,6,13
"Kruckeberg (Arthur)",waukruckebergarthurrua2946.xml,80444/xv37091,4,3,6,13
"Bader Architecture",waubaderarchitectureph2013_007.xml,80444/xv57730,0,0,13,13
"Washington Territory District Court Records of the 2nd Judicial District",wauwaterritorydistrictcourtrecords2ndjudicialdistrict6017.xml,80444/xv57736,0,0,13,13
"University of Washington Department of Geography Records",wauuwresource00304.xml,80444/xv95883,1,3,9,13
"Rogers Family Papers",waurogersfamily4871.xml,80444/xv20534,5,3,5,13
"Horn (Werner)",wauhornwerner5446.xml,80444/xv56378,4,4,5,13
"Unknown",wauseattlerumorcenterseattlewash2085.xml,80444/xv03494,5,4,4,13
"University of Washington, Department of Pharmacy records",wauuwresource00369.xml,80444/xv32077,5,2,6,13
"Unknown",wauseattleaidsmemorialvigil5282.xml,80444/xv00820,5,1,7,13
"University of Washington. Dept. of Psychology.",wauuwresource00317.xml,80444/xv72741,4,5,4,13
"Esper (Erwin)",wauespererwinaua0823.xml,80444/xv12161,3,6,4,13
"Unknown",waunicholsrobertl0734.xml,80444/xv55679,7,1,5,13
"Unknown",wauturnerkatherine5041.xml,80444/xv36199,2,5,6,13
"Unknown",waugenssfanniekaplan2279.xml,80444/xv98876,3,5,5,13
"Transportation -- Railroads Subject File Photograph Collection",waurailroadssubjectfilephcoll1297.xml,80444/xv74121,2,4,7,13
"Unknown",waumiyamotosfrank2485_1.xml,80444/xv95084,5,3,5,13
"University of Washington. College of Ocean and Fishery Sciences. Dean.",wauuwresource00449.xml,80444/xv85971,3,3,7,13
"E.A. Swift and Company (Seattle, Wash.).",waueaswiftandcompany1333.xml,80444/xv38595,4,4,5,13
"Unknown",wauwolfekatharinea5252.xml,80444/xv29269,1,4,8,13
"Summer Arts Festival (University of Washington) Records",wauuwresource07379.xml,80444/xv86639,3,5,5,13
"Lincoln (Leslie)",waulincolnlesliej2696-057.xml,80444/xv32876,4,3,6,13
"Unknown",waunorthwestrenewableresourcescenter5092.xml,80444/xv38931,9,1,3,13
"Unknown",waukwanlamahresortfridayharborwash0212.xml,80444/xv53280,2,5,6,13
"Mason (Alden,)",waumasonaldenua2662.xml,80444/xv48107,2,4,7,13
"Unknown",wausmithcharlesw4390.xml,80444/xv60394,3,5,5,13
"Unknown",waufortsteilacoomwash4733.xml,80444/xv96261,4,3,6,13
"University of Washington Center for Urban Horticulture Records",wauuwresource07652.xml,80444/xv19808,3,5,5,13
"Unknown",waurindbernice3714.xml,80444/xv14688,7,3,3,13
"Unknown",wauwirkkalaoscara0105.xml,80444/xv14620,7,2,4,13
"Randall (Byron) Artwork and Photographs",waurandallbyronph2016_016.xml,80444/xv21612,2,2,9,13
"Businger (Joost)",waubusingerjoostaloisua4783.xml,80444/xv04965,1,4,8,13
"Chateau Ste. Michelle Winery Photograph Collection",wauchateaustemichellephcoll1387.xml,80444/xv99990,10,0,3,13
"Unknown",waufriendsofthecrafts3885.xml,80444/xv51046,4,4,5,13
"University of Washington Campus Photograph Albums",wauwashingtonstateuniversityphcoll117.xml,80444/xv65435,1,5,7,13
"Unknown",waujacobsonjohnb3808.xml,80444/xv63739,3,4,6,13
"Unknown",waunezperceaffadavit4495.xml,80444/xv39929,3,4,6,13
"University of Washington. Student Bar Association.",wauuniversityofwashingtonstudentbarassociation5062.xml,80444/xv72442,4,5,4,13
"Lindblom (Roy)",waulindblomroyericua1791.xml,80444/xv63012,2,7,4,13
"Pacific Telephone and Telegraph Company Cable Laying Photographs",waupacifictelephonetelegraphphcoll1366.xml,80444/xv44351,0,9,4,13
"Dunthorne (Stephen) papers",waudunthornestephen5852.xml,80444/xv43664,4,3,6,13
"University of Washington. Dept. of Immunology.",wauuwresource00416.xml,80444/xv84927,3,3,7,13
"Unknown",wauleggettglennh4434.xml,80444/xv04818,2,5,6,13
"Unknown",waupotjesedouard2753.xml,80444/xv06228,4,1,8,13
"University of Washington. Dept. of Anthropology.",wauuwresource00297.xml,80444/xv94329,6,3,4,13
"University of Washington. Dept. of Psychiatry and Behavioral Sciences.",wauuwresource00408.xml,80444/xv18664,4,6,3,13
"Van Cleve (Richard,)",wauvancleverichardua1683_1715.xml,80444/xv87637,3,5,5,13
"Conway (Dorothy) Photographs",wauconwaydorothyphcoll424.xml,80444/xv53543,3,4,6,13
"Baker (Harriette)",waubakerharriettelaurie3588.xml,80444/xv85488,5,3,5,13
"University of Washington Extension, Academic Programs Office Records",wauuwresource00143.xml,80444/xv96923,0,3,10,13
"Anderson (Carl Lawrence)",wauandersoncarllawrence5937.xml,80444/xv08538,0,5,8,13
"Kantor (Alvin)",waukantoralvinrobert5465.xml,80444/xv16009,4,1,8,13
"Hobbs (Peter)",wauhobbspeterua5752.xml,80444/xv03854,4,5,4,13
"Unknown",wauleagueofwomenvotersofwashington1716.xml,80444/xv04840,3,3,7,13
"Unknown",waujohansenolea4763.xml,80444/xv26290,9,3,1,13
"Sherrard (William)",wausherrardwilliamrobert0366.xml,80444/xv40164,2,6,5,13
"Unknown",waubrownchurchseattlewash1280.xml,80444/xv52465,3,3,7,13
"Olympia Earthquake Photograph Collection",wauolympiaearthquakeph2009_051.xml,80444/xv18991,2,6,5,13
"Unknown",waupickeringwilliamt4224.xml,80444/xv28973,5,4,4,13
"Unknown",waukewdella2585.xml,80444/xv51171,5,2,6,13
"Unknown",wauiwamisachiko5188.xml,80444/xv27395,6,2,5,13
"Ekroth (Nels)",wauekrothnelss0689.xml,80444/xv39224,3,2,8,13
"Unknown",waurobertseve5199.xml,80444/xv23910,3,5,5,13
"University of Washington. Capital Projects Office. Design Division.",wauuwresource00128.xml,80444/xv18756,5,4,4,13
"Unknown",waubostelmanncarljohn5005.xml,80444/xv50183,3,2,8,13
"University of Washington. Libraries. Gifts and Exchanges Section.",wauuwresource07252.xml,80444/xv40356,4,4,5,13
"Unknown",wautachermorris3188.xml,80444/xv46221,7,2,4,13
"Unknown",wauamericanassociationofsocialworkerspugetsoundchapter4514.xml,80444/xv60507,1,3,9,13
"Unknown",waupacificnorthwestconferenceonhighereducation3321.xml,80444/xv21246,5,4,4,13
"Dodson (Kenneth,)",waudodsonkenneth0713.xml,80444/xv48709,4,5,4,13
"Unknown",waujohnsonelvinr2175.xml,80444/xv92602,3,4,6,13
"Unknown",wautilleyernaspannagel1899.xml,80444/xv87411,3,4,6,13
"Stever (Robert C.) Papers",wausteverrobert5112_1.xml,80444/xv40021,3,1,9,13
"Logging (Webster and Stevens) Photograph Collection",wauwebsterstevensloggingphcoll1032.xml,80444/xv51824,3,3,7,13
"Fukushima (Toshiyuki) Correspondence and Papers",waufukushimatoshiyuki5554.xml,80444/xv53790,5,2,6,13
"Cain (Lodoen Purdy) Photograph Collection",waucainlodoenphcoll615.xml,80444/xv93716,4,2,7,13
"Washington Land Title Association",waumjeldemichaeljay5592.xml,80444/xv98013,0,6,7,13
"Unknown",wauvannesselmere3663.xml,80444/xv09573,3,4,6,13
"Naramore, Bain, Brady and Johanson",waunbbjphcoll366.xml,80444/xv88885,4,2,7,13
"Ridley (John) and Albert Balch Entry Albums for Homes for Better Living Award",wauridleybalchentryalbumsphcoll1122.xml,80444/xv20803,8,0,5,13
"Lew (Willon)",waulewwillon1644_1654.xml,80444/xv45172,3,4,6,13
"Unknown",waujohnstonandrewl0868.xml,80444/xv15402,2,6,5,13
"Tallmadge Hamilton House Photograph Collection",wautallmadgehamiltonhouseph2016_032.xml,80444/xv51074,7,0,6,13
"Crosby (Richard)",waucrosbyrichardm0264.xml,80444/xv19686,4,4,5,13
"Roosevelt (Franklin Delano) Photographs of",waurooseveltfranklindphcoll739.xml,80444/xv88287,4,3,6,13
"Hallsten (Pehr,)",wauhallstenpehr5376.xml,80444/xv72463,2,4,7,13
"Columbia Valley Lumber Company Records",waucolumbiavalleylumberco6018.xml,80444/xv47061,0,7,6,13
"Unknown",wausteinbergjack3246.xml,80444/xv02828,1,4,8,13
"Unknown",wauuwresource00277.xml,80444/xv21292,5,5,3,13
"Gerber (Sidney) Photograph Collection",waugerbersidneyph2014_008.xml,80444/xv24191,4,5,4,13
"Sieg (Lee)",wausiegleepaulua2919.xml,80444/xv58670,3,5,5,13
"Unknown",waubarkerpiercew3491.xml,80444/xv41339,1,5,7,13
"Unknown",waustroumjewishcomctrgoldenageclub5763.xml,80444/xv94140,10,2,1,13
"Unknown",waupaulfrances1554.xml,80444/xv97863,3,5,5,13
"Unknown",wautonninggerard0557.xml,80444/xv16796,5,5,3,13
"Unknown",waurobinsonjames4184.xml,80444/xv57412,7,2,4,13
"Fay (Jean Bradford) Engraving Collection",waufayjeanbradfordphcoll099.xml,80444/xv42999,4,4,5,13
"University of Washington. College of Education. Office of Teacher Education.",wauuwresource00267.xml,80444/xv56127,3,4,6,13
"Unknown",waunationalassociationofsocialworkerswashingtonstatechapter3013.xml,80444/xv74780,2,5,6,13
"Butow (Robert J.C.) Papers",waubutowrobertua5978.xml,80444/xv24597,3,4,6,13
"Crist (B.Wayne)",waucristbwaynephcoll1301.xml,80444/xv77658,3,6,4,13
"Saxberg (Börje)",wausaxbergborjeua4597.xml,80444/xv66864,5,4,4,13
"Russak (Harry)",waurussakharry3055.xml,80444/xv26983,2,4,7,13
"Unknown",wautacomarecallcommittee1537.xml,80444/xv00439,5,2,6,13
"Unknown",waudevelopmentcorporationforisraelstateofisraelbonds3807.xml,80444/xv68496,3,3,7,13
"Phillips (Herbert)",wauphillipsherbertj5309.xml,80444/xv73904,6,4,3,13
"Havens (Mareta) Photograph Album",wauhavensmaretaphcoll120.xml,80444/xv30090,5,5,3,13
"Unknown",waubriskeremanuel4389.xml,80444/xv81973,6,4,3,13
"Unknown",wauweedinfamily3158.xml,80444/xv11111,3,4,6,13
"Unknown",waucadburyolivec4285.xml,80444/xv19909,4,3,6,13
"Unknown",waucitypanhellenicassociationseattlewash4634.xml,80444/xv08587,4,3,6,13
"Bragdon (Kathleen)",waubragdonkathleenjoan2696.xml,80444/xv06033,3,5,5,13
"Burwell & Morford (Seattle, Wash.).",wauburwellmorford4798.xml,80444/xv07901,3,3,7,13
"Hall (Wayne) Photograph Album",wauhallwaynephcoll362.xml,80444/xv91702,4,2,7,13
"Mosher family",waumosherfamily0136.xml,80444/xv65246,3,5,5,13
"University of Washington. Medical Center. Accounting Department.",wauuwresource00223.xml,80444/xv14871,3,5,5,13
"Unknown",waugohawleycitymarketmarysvillewash1451.xml,80444/xv69760,2,3,8,13
"Dick (Wesley)",waudickwesleyarden1613.xml,80444/xv06454,4,6,3,13
"Unknown",wauwhidbeyislandjewishcommunity5842.xml,80444/xv05392,3,3,7,13
"Heick (Sally)",wauheicksallyann1154.xml,80444/xv07922,7,2,4,13
"Dvorak (August,)",waudvorakaugust0857.xml,80444/xv71664,4,4,5,13
"Anderson (Frederick)",wauandersonfrederickn2838.xml,80444/xv66085,3,5,5,13
"Unknown",waupacificcoastcoalcompany0810.xml,80444/xv40667,1,8,4,13
"Unknown",waukarshlucille5395.xml,80444/xv85565,2,5,6,13
"Thompson (R.H.) lantern slide collection",wauthompsonrhph2015_005.xml,80444/xv11621,4,5,4,13
"Haviland (James)",wauhavilandjamesw3947.xml,80444/xv35418,2,5,6,13
"Bollman (Dean)",waubollmandeans4479.xml,80444/xv23574,7,4,2,13
"Di Biase (Linda,)",waudibiaselinda3664.xml,80444/xv36276,1,5,7,13
"Mount Hood Climb Photographs",waumthoodclimbph2008_041.xml,80444/xv78045,4,2,7,13
"Duwamish Valley School and Pioneer Association.",wauduwamishvalleyschoolandpioneerassociation0154.xml,80444/xv36380,4,4,5,13
"Unknown",waucommunitymethodistchurchontariooregonwomensassociation1635.xml,80444/xv68627,4,4,5,13
"Unknown",wauwareflorestine1438.xml,80444/xv98764,1,6,6,13
"Leber Family Photograph Collection",wauleberfamilyphcoll489.xml,80444/xv21951,5,3,5,13
"Parrington (Vernon)",wauparringtonvernonlouisua5014.xml,80444/xv34130,4,5,4,13
"Unknown",wauwalshhelenjuliamason4947.xml,80444/xv53857,5,6,2,13
"University of Washington. American Ethnic Studies Department.",wauuwresource00325.xml,80444/xv41665,1,7,5,13
"Unknown",wauyoungmenshebrewassociationseattlewash2104.xml,80444/xv18527,3,3,7,13
"Dahlin (Ebba) Papers",waudahlinebbaua5996.xml,80444/xv00061,7,0,6,13
"Murphy (Sheldon)",waumurphysheldondouglasua4134.xml,80444/xv69384,2,4,7,13
"University of Washington. Office for Nursing Research Facilitation.",wauuwresource06090.xml,80444/xv91653,3,5,5,13
"Butterworth (Joseph)",waubutterworthjosephua1359.xml,80444/xv91107,5,4,4,13
"Eisdorfer (Carl)",waueisdorfercarlua3320.xml,80444/xv28079,2,2,9,13
"Unknown",wauskinnerfamilyfilmsphcoll887.xml,80444/xv90274,12,1,0,13
"Unknown",waujohnwoodsandcompany4980.xml,80444/xv56152,3,6,4,13
"Thompson's Drugs Photograph Collection",wauthompsondrugsphcoll521.xml,80444/xv51994,1,2,10,13
"Trippel (Dorothy)",wautrippeldorothyb5561.xml,80444/xv27978,3,3,7,13
"American Society of International Law. Regional Meeting (1958 : University of Washington).",wauamericansocietyofinternationallawregionalmeeting5007.xml,80444/xv33578,3,5,5,13
"Unknown",wauunitedstatesarmydivision91st4929.xml,80444/xv93331,9,2,2,13
"Joint Center for Graduate Study.",wauuwresource06104.xml,80444/xv87039,2,5,6,13
"Unknown",waurabbittthomasc0753.xml,80444/xv24151,3,4,6,13
"Levin (Max)",waulevinmaxj1748_1754.xml,80444/xv66601,1,5,7,13
"Unknown",wauiveywilliam2852.xml,80444/xv78240,3,4,6,13
"Macbride (Thomas Huston)",waumacbridethomashustonphcoll161.xml,80444/xv23721,4,2,7,13
"Unknown",wauboswellfelix0947.xml,80444/xv78997,3,2,8,13
"Unknown",waukolloeningasjolseth2764.xml,80444/xv37045,1,6,6,13
"Reiley (Eldon) Home Movies",waureileyeldonphcoll946.xml,80444/xv94165,2,3,8,13
"Unknown",wauscharhonazaria4370.xml,80444/xv48776,4,3,6,13
"United States. District Court (Washington : Western District : Northern Division).",wauunitedstatesdistrictcourt4940.xml,80444/xv39828,2,5,6,13
"Patterson (Ambrose,)",waupattersonambrose2563.xml,80444/xv95822,4,6,3,13
"Unknown",wauuwresource00399.xml,80444/xv20629,2,4,7,13
"Aronson (Marion) Papers",wauaronsonmarion5954.xml,80444/xv85983,2,6,5,13
"University of Washington Department of Oral Medicine Records",wauuwresource00360.xml,80444/xv05969,2,6,5,13
"Meldrum (S.E.) Alaska-Yukon-Pacific Exposition Photograph Album",waumeldrumseaypephcoll61.xml,80444/xv12271,5,2,6,13
"Wylie (Turrell V.) Papers",wauwylieturrellvua3375.xml,80444/xv07244,3,2,8,13
"Unknown",waunorthwestassociationofthefirstsouthdakotavolunteerinfantry3179.xml,80444/xv57434,1,5,7,13
"Temple Sinai (Bellevue, Wash.).",wautemplesinai2370.xml,80444/xv19531,4,3,6,13
"Unknown",wauhenslejudithr4090.xml,80444/xv18014,3,5,5,13
"Goto (Dolores)",wauuwresource02764.xml,80444/xv08120,1,6,6,13
"Harborview Medical Center (Seattle, Wash.). Nursing Services Dept.",wauuwresource00481.xml,80444/xv90844,5,2,6,13
"Unknown",waudellarmoses1539.xml,80444/xv31155,0,8,5,13
"United States. Army. Corps of Engineers. Seattle District.",wauunitedstatesarmycorpsofengineersseattledistrict5159.xml,80444/xv64263,2,3,8,13
"Jensen (John H.) Photograph Collection",waujensenjohnhph2009_028.xml,80444/xv89328,4,3,6,13
"Unknown",waulandesberthaknight0076.xml,80444/xv28884,3,4,6,13
"Root (Virginia Taylor) Photograph Collection",waurootvirginiataylorphcoll087.xml,80444/xv37322,4,5,4,13
"Anderson (Arthur)",wauandersonarthurgua4136.xml,80444/xv73635,3,4,6,13
"Harry Bridges Center for Labor Studies photograph collection",wauharrybridgescenterlaborstudiesph2012_001.xml,80444/xv85473,5,2,6,13
"Kirkland (Burt)",waukirklandburtp4460.xml,80444/xv93960,2,5,6,13
"Silverstein (Fred)",wausilversteinfredeua4137.xml,80444/xv84558,4,4,5,13
"Unknown",waurankinjeannette2274.xml,80444/xv42947,3,4,6,13
"Warner (Charles)",wauwarnercharlesdudley0425.xml,80444/xv80242,1,9,3,13
"University of Washington. Medical Center. Dentistry Department.",wauuwresource00221.xml,80444/xv93838,0,3,10,13
"McCausland (Norman)",waumccauslandnorman2165.xml,80444/xv61740,5,3,5,13
"Northern State Hospital Photographs of",waunorthernstatehospitalphcoll231.xml,80444/xv03936,3,3,7,13
"Molitor (R.)",waumolitorrfrank0602.xml,80444/xv34835,5,2,6,13
"University of Washington. Dept. of Mechanical Engineering.",wauuwresource00334.xml,80444/xv15667,3,3,7,13
"Schomaker (Verner)",wauschomakervernerua5292.xml,80444/xv71563,5,3,5,13
"Roberts (W.)",waurobertswmilnor4866.xml,80444/xv28353,4,4,5,13
"Ober (Caroline)",wauobercarolinehavenua0775.xml,80444/xv46722,5,3,5,13
"University of Washington. Hospital Dentistry Dept.",wauuwresource00358.xml,80444/xv88461,5,2,6,13
"Unknown",wauericksonalvinl2686.xml,80444/xv71020,9,2,2,13
"Washington Emergency Relief Adminstration Photograph Collection",wauweraph2006_006.xml,80444/xv04809,6,2,5,13
"Washington State Psychological Association Records",wauwashingtonstatepsychologicalassociation5531.xml,80444/xv76806,4,4,5,13
"Hatch (Marshall) Papers",wauhatchmarshall5581.xml,80444/xv45605,6,2,5,13
"Felmley (Adeline E.) Correspondence",waufelmleyadelinee5915.xml,80444/xv44570,4,1,8,13
"Unknown",waunoslerjamesmilo0068.xml,80444/xv67495,2,6,5,13
"Unknown",waumontefiorecongregationeverettwash3574.xml,80444/xv24169,5,3,5,13
"Unknown",waupiriemeta3960.xml,80444/xv02807,1,3,9,13
"Unknown",wauwatsonrduke5275.xml,80444/xv29000,2,2,9,13
"Unknown",wauportblakelymillcompany0001.xml,80444/xv54632,12,1,0,13
"Unknown",wauwiltclaramccarty3509.xml,80444/xv52493,3,3,7,13
"Stenzel (George)",waustenzelgeorgeua2704.xml,80444/xv34536,3,4,6,13
"A.V. Love Dry Goods and Loft Building Photograph Collection",wauavlovephcoll639.xml,80444/xv47206,9,1,3,13
"Unknown",wausternklaus3693.xml,80444/xv01132,4,6,3,13
"Harborview Medical Center (Seattle, Wash.). Endocrinology Division.",wauuwresource00479.xml,80444/xv77960,6,3,4,13
"Hungary. Orszaggyules. Projectum Articuli. De administranda Institia subdecursu.",wauhungaryorszaggyulesprojectumarticulideadministrandainstitiasubdecursu2059.xml,80444/xv91754,3,3,7,13
"Unknown",waukingleettas1178.xml,80444/xv91488,2,5,6,13
"Hopkins (William)",wauhopkinswilliamstephenua1872.xml,80444/xv97467,4,4,5,13
"University of Washington Arboretum Photograph Collection",wauarboretumphcoll379.xml,80444/xv99322,3,4,6,13
"Sigelmann (Rubens)",wausigelmannrubensaua4594.xml,80444/xv51019,4,3,6,13
"Unknown",wauspringfamily4094.xml,80444/xv15939,4,2,7,13
"Gauld (Charles)",waugauldcharlesanderson0488.xml,80444/xv38143,3,5,5,13
"Randlett (Mary)",waurandlettmaryphcoll065.xml,80444/xv85327,3,4,6,13
"Andrew Gronholdt Unga Island, Alaska Petrified Forest photograph collection",waugronholdtandrewphcoll890.xml,80444/xv72558,5,5,3,13
"Unknown",wauleeflorence4675.xml,80444/xv50915,4,4,5,13
"Hale (Eleanor) Scrapbook",wauhaleeleanor5631.xml,80444/xv72009,4,3,6,13
"Sundberg (Edward)",wausundbergedwardf2763.xml,80444/xv32867,5,6,2,13
"Brazeau (Wendell,)",waubrazeauwendellua5113.xml,80444/xv03469,3,3,7,13
"Unknown",waumclaughlinfrank4234.xml,80444/xv55364,2,3,8,13
"Unknown",waufederalartprojectwash4935.xml,80444/xv49639,4,4,5,13
"Norris (Bernice W.) Alaska Photographs Collection",waunorrisbernicephcoll881.xml,80444/xv37478,2,4,7,13
"Unknown",wauwilliamswwalter2577.xml,80444/xv22885,2,3,8,13
"Sherwood (David)",wausherwooddavid2696-014.xml,80444/xv65844,2,4,7,13
"Unknown",wauunitedsynagogueofamericapacificnorthwestregion4493.xml,80444/xv35369,2,4,6,12
"Unknown",waufunkjudgearthur2229.xml,80444/xv85247,1,3,8,12
"Neve Salom Congregation (Altona, N.Y.).",waunevesalomcongregation3220.xml,80444/xv83862,2,6,4,12
"Unknown",waufranknancyw4391.xml,80444/xv48861,3,4,5,12
"Magonegil-Wontoch (Robin)",waumagonegilwontochrobin3416-007.xml,80444/xv16589,1,4,7,12
"Moss (Carlton)",waumosscarltonphcoll933.xml,80444/xv40509,3,4,5,12
"Gilman (Daniel H.) Papers",waugilmandaniel2730.xml,80444/xv60543,4,3,5,12
"Unknown",wauketzlachmicheln1763.xml,80444/xv50311,1,4,7,12
"Unknown",waupacificrimassociationforhighereducation5034.xml,80444/xv37606,3,4,5,12
"Allyear SnacKit Photograph Collection",wauallyearsnackitph2016_014.xml,80444/xv74960,0,5,7,12
"Harborview Medical Center (Seattle, Wash.). Utilization Review Office.",wauuwresource00466.xml,80444/xv28085,3,2,7,12
"Unknown",wauwoodruffsamuelnelson4979.xml,80444/xv66201,4,6,2,12
"Health and Welfare Council of Seattle and King County. Alcoholism Committee.",wauhealthandwelfarecouncilofseattleandkingcountyalcoholismcommittee4027.xml,80444/xv23239,3,3,6,12
"Y.W.C.A. Seattle-King County Photograph Collection",wauywcaphcoll377.xml,80444/xv46072,1,6,5,12
"Unknown",wauwalleralvanf4944.xml,80444/xv58706,2,4,6,12
"Sperling (Otto) Photographs",wausperlingottophcoll101.xml,80444/xv29891,7,0,5,12
"University of Washington. Legal Aid Office.",wauuwresource00352.xml,80444/xv87817,4,4,4,12
"Brownson (Horace)",waubrownsonhorace4625.xml,80444/xv66146,2,4,6,12
"Unknown",waucommitteethirtythree5259.xml,80444/xv69435,10,0,2,12
"United States. War Dept.",wauunitedstateswardept4941.xml,80444/xv40551,4,2,6,12
"Martin (Arthur)",waumartinarthurwua5145.xml,80444/xv85314,4,3,5,12
"Mann (Hilde)",waumannhilde5484.xml,80444/xv93432,2,4,6,12
"Cady (George)",waucadygeorgehua3338.xml,80444/xv43551,2,4,6,12
"Lockridge (Shirley)",waulockridgeshirley5521.xml,80444/xv78201,3,3,6,12
"Unknown",waumetcalfevernon1600.xml,80444/xv07656,2,4,6,12
"Eastwood (E.)",waueastwoodeo1513.xml,80444/xv80603,2,6,4,12
"Mason (Lucile)",waumasonlucile3416-001.xml,80444/xv41921,3,3,6,12
"Unknown",wauwilloughbycharles4972.xml,80444/xv93765,4,4,4,12
"Kellogg (David,)",waukelloggdavidpioneer2436.xml,80444/xv59136,3,4,5,12
"Unknown",wauseatacseattleminimumwageproject6025.xml,80444/xv00650,0,0,12,12
"Danish American Heritage Society Records",waudanishamericanheritagesociety5584.xml,80444/xv70700,3,3,6,12
"Eulenberg (Julia)",waueulenbergjulianiebuhrua3638.xml,80444/xv63357,4,3,5,12
"Dunning (Vernon)",waudunningvernonh1143.xml,80444/xv40066,2,5,5,12
"Trott (Otto) Mountain Climbing Photograph Collection",wautrottottoindexphcoll1187.xml,80444/xv51901,0,2,10,12
"Munro (Kathleen,)",waumunrokathleenua1895.xml,80444/xv76425,3,7,2,12
"Harborview Medical Center (Seattle, Wash.). Respiratory Therapy Service.",wauuwresource00478.xml,80444/xv04824,2,4,6,12
"Chlosta (Robert J.) Photographs",wauchlostarobertjph2015_021.xml,80444/xv96273,3,3,6,12
"Unknown",waumannheimfamily3870.xml,80444/xv01330,2,4,6,12
"Collins (James,)",waucollinsjames2696.xml,80444/xv36749,1,6,5,12
"Unknown",waupigottwilliam4846.xml,80444/xv07403,4,4,4,12
"McKay (Linnette)",waumckaylinnettesheldon3416-001.xml,80444/xv83361,3,4,5,12
"Nishitani (Martha) Photograph and Film Collection",waunishitanimarthaph2016_004.xml,80444/xv74020,6,4,2,12
"Unknown",wauhubbspaulk3107.xml,80444/xv23776,2,5,5,12
"Unknown",waurosenejohn4206.xml,80444/xv25204,3,5,4,12
"Busing (J.)",waubusingjh2435.xml,80444/xv11718,2,5,5,12
"Rubin (Cyrus)",waurubincyrusua3385.xml,80444/xv11874,2,2,8,12
"Unknown",waupacificnorthwestforestandrangeexperimentstationportlandor3837.xml,80444/xv57604,2,3,7,12
"University of Washington. Student Services Division.",wauuwresource00150.xml,80444/xv57034,2,5,5,12
"MacKenzie Family Photograph Collection",waumackenziefamilyphcoll032.xml,80444/xv94076,2,3,7,12
"Lieberman (Irving)",wauliebermanirvingua3366.xml,80444/xv08950,1,4,7,12
"Unknown",waulewiscountypublicutilitydistrictno1wash0308.xml,80444/xv36334,1,5,6,12
"Seko Family Photograph Collection",wausekofamilyphcoll226.xml,80444/xv21685,6,2,4,12
"Smith (Charles)",wausmithcharleszua3306.xml,80444/xv90539,3,5,4,12
"Unknown",wauturnertheodores2222.xml,80444/xv64266,2,5,5,12
"Unknown",waunorthwestplaywrightsguild5114.xml,80444/xv66400,2,3,7,12
"Unknown",waumcleodjohn4809.xml,80444/xv36117,2,5,5,12
"Kunde (Norman)",waukundenormanfrederick2507.xml,80444/xv56158,3,2,7,12
"Unknown",wauhopelutheranchurchenumclawwash2904.xml,80444/xv41491,9,3,0,12
"Wagner (Betty)",wauwagnerbettyua2938.xml,80444/xv28433,1,6,5,12
"Ogle (Stephanie)",wauoglestephaniefrancine4018.xml,80444/xv20977,3,4,5,12
"Unknown",wauperrinportergale4843.xml,80444/xv14312,2,4,6,12
"Pacific Improvement Company.",waupacificimprovementcompany0593.xml,80444/xv24810,3,5,4,12
"Hellstrom (Karl)",wauhellstromkarlerikua2500.xml,80444/xv57357,2,5,5,12
"Snohomish County (Wash.). Citizens.",wausnohomishcounty4900.xml,80444/xv80358,1,2,9,12
"Logging Safety Institute (1964 : University of Washington).",wauloggingsafetyinstitute3034.xml,80444/xv50762,3,4,5,12
"Seattle (Wash.). Dept. of Parks",wauseattleparksdept3154.xml,80444/xv01104,1,6,5,12
"Unknown",wauhensonharryf3601.xml,80444/xv13296,5,2,5,12
"Moriarty (Charles)",waumoriartycharlesp3009.xml,80444/xv97570,5,3,4,12
"Unknown",wautechnocracyinc0605.xml,80444/xv91796,6,2,4,12
"Wheeler (Bayard)",wauwheelerbayardoua4116.xml,80444/xv79531,4,4,4,12
"Unknown",wauinternationalsourdoughreunion5125.xml,80444/xv43518,4,3,5,12
"Unknown",wauappersonjohnt0171.xml,80444/xv25906,4,2,6,12
"Maimon (Albert S.)",waumaimonalberts5701.xml,80444/xv50637,1,3,8,12
"Gallagher (Marian)",waugallaghermarianua2204.xml,80444/xv62207,3,4,5,12
"University of Washington. School of Medicine. Assistant Dean for Admissions.",wauuwresource00373.xml,80444/xv20822,3,5,4,12
"Volchok (Zollie) Oral History interviews",wauvolchokzollie5619.xml,80444/xv08404,1,4,7,12
"Unknown",wauhagenharryw4008.xml,80444/xv03341,4,2,6,12
"Andrews (Ralph)",wauandrewsralphw0935_1756.xml,80444/xv14208,5,2,5,12
"Klondyke Photograph Album",wauklondykephcoll397.xml,80444/xv62240,3,2,7,12
"Unknown",wauconfederatestatesofamericadistrictofvirginia4706.xml,80444/xv12908,3,2,7,12
"University of Washington Album 1",wauuniversityofwashingtonalbum1phcoll113.xml,80444/xv04306,3,4,5,12
"Americans for Democratic Action. Washington State Chapter.",wauamericansfordemocraticactionwashingtonstatechapter4039.xml,80444/xv60900,4,4,4,12
"Cohn (Annette) Papers",waucohnannette5877.xml,80444/xv16177,5,6,1,12
"McCaffree (Kenneth)",waumccaffreekennethmua3238.xml,80444/xv01968,5,2,5,12
"Larsen (Kirsten)",waularsenkirstenua2256.xml,80444/xv74044,1,4,7,12
"Unknown",waukershmildrede3177.xml,80444/xv82693,1,5,6,12
"Attneave (Carolyn)",wauattneavecarolynlua3308.xml,80444/xv55648,1,3,8,12
"Peterson (Helen,)",waupetersonhelen3416-001.xml,80444/xv01742,1,4,7,12
"Phi Alpha Theta. Delta Iota Chapter (University of Washington).",wauphialphathetadeltaiotachapter3353.xml,80444/xv35461,6,4,2,12
"Unknown",waufallsjeanburch4218.xml,80444/xv02862,2,4,6,12
"Strouthes (Daniel)",waustrouthesdanielp2696-068.xml,80444/xv57626,1,5,6,12
"Steinbrueck (Victor) Photograph Collection",wausteinbrueckvictorphcoll241.xml,80444/xv04507,3,1,8,12
"Klein (Laura)",waukleinlauraf2696.xml,80444/xv01287,3,3,6,12
"Puget Sound Power and Light Company Photograph Collection",waupugetsoundpowerandlightcompanyphcoll269.xml,80444/xv45111,3,2,7,12
"Unknown",waukromsophia3645.xml,80444/xv80664,3,2,7,12
"Unknown",waupacificcoasthistoryofeducationsociety3007.xml,80444/xv69833,3,4,5,12
"Unknown",waugreatnorthernrailwaycompanyus3041.xml,80444/xv60040,7,4,1,12
"Wickwire (Wendy)",wauwickwirewendyc2696-016.xml,80444/xv90957,2,3,7,12
"Bailey (Elizabeth)",waubaileyelizabeth3416-001.xml,80444/xv18670,5,2,5,12
"Phi Sigma Society. Psi Chapter (University of Washington).",wauphisigmasocietypsichapter5008.xml,80444/xv82080,4,4,4,12
"Neumann (Frank,)",wauneumannfrankua0481.xml,80444/xv62356,2,6,4,12
"Unknown",waupugetsoundcouncilretiredcitizens5803.xml,80444/xv27801,4,5,3,12
"Unknown",wauhurstlucillefeist4053.xml,80444/xv52276,2,3,7,12
"McMurtrey (Margaret)",waumcmurtreymargaret3416-001.xml,80444/xv44940,2,5,5,12
"Geballe (Ronald)",waugeballeronaldua2205.xml,80444/xv52780,3,3,6,12
"Davis (Philip)",waudavisphilipw2696-023.xml,80444/xv26205,3,5,4,12
"Martin (R.)",waumartinrormsby2025.xml,80444/xv37255,3,2,7,12
"Royce (William)",wauroycewilliamfua1855.xml,80444/xv47137,3,5,4,12
"Historic American Building Survey No. WA-150 (Fort Lawton) and other HABS/HAER research collection",wauwastatehabsftlawtonph2015_004.xml,80444/xv77301,3,4,5,12
"Winter and Brown Photographs",wauwinterandbrownphcoll307.xml,80444/xv31494,2,5,5,12
"Unknown",waumassenetjules1186.xml,80444/xv79302,3,5,4,12
"Unknown",waurobinsonesther3203.xml,80444/xv30136,2,4,6,12
"Unknown",wausmithfamily3275.xml,80444/xv30041,1,5,6,12
"Weinberg (Kenneth)",wauweinbergkenneth5457.xml,80444/xv94204,3,3,6,12
"Tippett (Tom) Manuscript",wautippetttom5618.xml,80444/xv79800,4,4,4,12
"Proulx (Paul)",wauproulxpaul2696-029.xml,80444/xv96398,4,4,4,12
"Faculty Reprints.",waufacultyreprints4443.xml,80444/xv92913,1,2,9,12
"Unknown",waufaghintimmie2457.xml,80444/xv52349,4,5,3,12
"Unknown",waushapiroidaseitzick2452.xml,80444/xv43389,1,5,6,12
"University of Washington. South Asian Studies Program.",wauuwresource00281.xml,80444/xv22821,3,5,4,12
"Unknown",waublyrobert3127.xml,80444/xv98757,2,4,6,12
"Unknown",wauhubbarddanielj4665.xml,80444/xv58605,3,4,5,12
"Port Townsend Photograph Album",wauporttownsendphotographalbumphcoll1179.xml,80444/xv60131,4,3,5,12
"Broyles (Julie)",waubroylesjulieanne2696-047.xml,80444/xv61044,1,6,5,12
"Frost (Dorothy)",waufrostdorothy4003.xml,80444/xv24636,2,5,5,12
"Becker (Ethel)",waubeckerethelanderson0438_0846.xml,80444/xv29888,3,5,4,12
"University of Washington. Quaternary Research Center.",wauuwresource00186.xml,80444/xv33593,4,4,4,12
"University of Washington College of Engineering Records",wauuwresource07421.xml,80444/xv68319,8,0,4,12
"University of Washington Architecture Photograph Collection",waueverittphcoll149.xml,80444/xv30447,5,3,4,12
"Herre (Albert)",wauherrealbertwua2711.xml,80444/xv84155,1,3,8,12
"Unknown",waurareplantconsortium5365.xml,80444/xv67413,4,3,5,12
"Marvin Reiner Oral History",waureinermarvin5609.xml,80444/xv13531,3,4,5,12
"Unknown",wauseattlerangersfootballclubseattlewash3291.xml,80444/xv56573,4,3,5,12
"Smith (Thomas)",wausmiththomas4899.xml,80444/xv60501,4,3,5,12
"McManus (Dean)",waumcmanusdeanaua4583.xml,80444/xv70370,3,3,6,12
"Irish (Donald) papers",wauirishdonald5859.xml,80444/xv92263,3,4,5,12
"Unknown",waumatterandfamily3486.xml,80444/xv11776,1,2,9,12
"Unknown",waupiercefrankrichardson0594.xml,80444/xv37646,6,1,5,12
"Kibrik (A.)",waukibrikaa2696-077.xml,80444/xv88714,2,4,6,12
"Mulcahy (Joanne)",waumulcahyjoanneb2696-045.xml,80444/xv68090,3,5,4,12
"Unknown",wauwhitcombdavid4963.xml,80444/xv06130,6,2,4,12
"Thomas (Maybelle)",wauthomasmaybellecultee3416-001.xml,80444/xv68386,1,4,7,12
"Westerman (William)",wauwestermanwilliamedward0152.xml,80444/xv55099,2,2,8,12
"Pacific Northwest Asian American Writers Conference Photograph Collection",waupacificnwasianamericanwritersphcoll135.xml,80444/xv40814,3,3,6,12
"Unknown",waufredericjamesgrantmemorialassociation4283.xml,80444/xv36718,8,2,2,12
"Laboff (Jean)",waulaboffjean5492.xml,80444/xv55441,4,3,5,12
"Unknown",wauwallgrenmonradc4945.xml,80444/xv71160,1,6,5,12
"Unknown",waugoodeelizabethvirginia2964.xml,80444/xv05236,2,2,8,12
"Unknown",wautsujis3231.xml,80444/xv73001,4,3,5,12
"Unknown",waubateskatestevens3795.xml,80444/xv42990,2,4,6,12
"Unknown",waulevyzelma2091.xml,80444/xv04385,4,3,5,12
"Unknown",wauuniversitydistrictmovement4454.xml,80444/xv10021,2,4,6,12
"University of Washington. Dental Education in Care of the Disabled.",wauuwresource00361.xml,80444/xv95831,4,3,5,12
"Unknown",wauuwresource07772.xml,80444/xv30200,4,5,3,12
"Unknown",wauthomasbertramp2803.xml,80444/xv88796,1,4,7,12
"Dan (Bertha)",waudanbertha3416-001.xml,80444/xv75384,1,6,5,12
"Palmer (Andie)",waupalmerandiediane2696-064.xml,80444/xv79660,3,5,4,12
"Pennell (Joseph)",waupennelljosephstanley1392_1413.xml,80444/xv14102,4,2,6,12
"Unknown",waunorthwestinternationalchristianmissionconference5102.xml,80444/xv08062,0,5,7,12
"Unknown",waurobeleugene3481.xml,80444/xv47674,1,5,6,12
"Naramore (Floyd A.) Photograph Collection",waunaramorefloydaphcoll167.xml,80444/xv93511,5,2,5,12
"University of Washington. Office of Lectures and Concerts.",wauuwresource07264.xml,80444/xv64755,3,4,5,12
"George (Doris Manington) Papers",waugeorgedorismanington5509.xml,80444/xv17904,3,4,5,12
"Sullivan (John)",wausullivanjohnj3112.xml,80444/xv22030,3,5,4,12
"Fuyo Kai (University of Washington).",waufuyokai4363.xml,80444/xv75180,1,2,9,12
"University of Washington Office of News and Information Miscellaneous Photograph Collection",wauuwofficenewsinformationph2016_047.xml,80444/xv43713,0,8,4,12
"University of Washington. Dept. of Oral Biology.",wauuwresource00359.xml,80444/xv23815,3,5,4,12
"Unknown",waualhadeffmorrisj2555.xml,80444/xv02853,2,3,7,12
"Unknown",waudaggettemerson3977.xml,80444/xv11831,3,4,5,12
"Unknown",wauzelikovskyfamily3636.xml,80444/xv06008,6,3,3,12
"Rogers (Millard)",waurogersmillardb2861.xml,80444/xv83728,1,6,5,12
"Unknown",waukingcountymedicalsocietyseattlewash1338.xml,80444/xv11685,3,4,5,12
"Sunday School Photograph Collection",wausundayschoolphcoll086.xml,80444/xv94069,6,4,2,12
"Unknown",waukazamasallys2587.xml,80444/xv93536,0,10,2,12
"Jacobs (Frank) Alaska Photographs",waujacobsfrankalaskaphcoll382.xml,80444/xv22351,2,4,6,12
"Unknown",waukushitanejirofamilyfilmsphcoll1149.xml,80444/xv67807,5,4,3,12
"Lannge (Nils)",waulanngenilsevelyn5828.xml,80444/xv56430,4,3,5,12
"Unknown",wauyoungmensrepublicanclubofkingcountywash0576.xml,80444/xv82009,2,6,4,12
"Benezra (Joseph A.) Papers",waubenezrajosepha5737.xml,80444/xv23901,5,4,3,12
"Lutey (William)",wauluteywilliamglenua2954.xml,80444/xv52114,2,7,3,12
"Unknown",waufossharold2351.xml,80444/xv03878,2,3,7,12
"Unknown",waurainierclubseattlewash2891.xml,80444/xv78561,3,5,4,12
"Unknown",wauhildtmichael3263.xml,80444/xv04208,4,2,6,12
"Bishop (James)",waubishopjameswofskykomishwash1557_1928.xml,80444/xv93597,4,5,3,12
"Shank (Scott)",waushankscott2696-129.xml,80444/xv12307,2,5,5,12
"Goldmark (John)",waugoldmarkjohn3077.xml,80444/xv51998,7,3,2,12
"Unknown",waubloedeldonovanlumbermillsbellinghamwash1935.xml,80444/xv26373,4,5,3,12
"Korg (Jacob)",waukorgjacobua2922.xml,80444/xv38159,4,4,4,12
"Unknown",wauhaytianrepublicship3781.xml,80444/xv08380,3,3,6,12
"Heck (Edith)",wauheckedith3416-001.xml,80444/xv09878,4,3,5,12
"Ensinck (John)",wauensinckjohnwua3355.xml,80444/xv20065,1,4,7,12
"Unknown",waukinnearroyjohn0102.xml,80444/xv32183,3,4,5,12
"Washington State League for Nursing.",wauwashingtonstateleaguefornursing0549_0682.xml,80444/xv05767,2,5,5,12
"Unknown",waucohenannette2536.xml,80444/xv49661,3,1,8,12
"Unknown",waupresidentsforum4327.xml,80444/xv38925,4,4,4,12
"Unknown",waumarkelhazel4487.xml,80444/xv74459,4,4,4,12
"Gibaldi (Milo)",waugibaldimiloua4109.xml,80444/xv81640,2,5,5,12
"Unknown",wauhoffmanoline2270.xml,80444/xv83917,3,5,4,12
"University of Washington. Fisheries Research Institute.",wauuwresource00456.xml,80444/xv76135,5,2,5,12
"McCutchen (Lydia)",waumccutchenlydiam1671.xml,80444/xv68698,5,3,4,12
"DeKay (George)",waudekaygeorgeh0114.xml,80444/xv65841,2,5,5,12
"Dinwoodie (David)",waudinwoodiedavidw2696-070.xml,80444/xv83734,0,6,6,12
"Moulton (Ralph)",waumoultonralphwellsua4584.xml,80444/xv94244,3,4,5,12
"Unknown",wauscrivenedwardbaker1562.xml,80444/xv87979,3,5,4,12
"Unknown",wauuniversitykiwanisclubseattlewash5360.xml,80444/xv39810,2,5,5,12
"Unknown",wauwillnerbernard4376.xml,80444/xv98318,3,3,6,12
"Ericksen (Bud)",wauericksenbud4566.xml,80444/xv72338,2,3,7,12
"Unknown",waubrashenbetty4373.xml,80444/xv99392,4,6,2,12
"Reaber (Margaret)",waureabermargarettaylor3416-001.xml,80444/xv79528,2,4,6,12
"Hajda (Yvonne)",wauhajdayvonnep2696-022.xml,80444/xv23751,1,7,4,12
"Unknown",wauunitedstatesbureauoflandmanagementportlandservicecenter2184.xml,80444/xv68463,1,4,7,12
"Kjaer (Jens)",waukjaerjenschristian0439.xml,80444/xv08767,1,4,7,12
"Unknown",waurussianveteranssocietyoftheworldwar3953.xml,80444/xv37341,4,4,4,12
"Loew (Edgar)",wauloewedgarallanua2950.xml,80444/xv52908,2,5,5,12
"Washington State Federation of Teachers Photograph Collection",wauwashingtonstatefederationofteachersphcoll212.xml,80444/xv00659,1,5,6,12
"Unknown",wauboglegates5205.xml,80444/xv32785,2,5,5,12
"Unknown",wauharrisiral3605.xml,80444/xv71807,3,4,4,11
"Geoghegan (Richard)",waugeogheganrichardhenry0718.xml,80444/xv10549,1,6,4,11
"University of Washington. Dept. of Psychosocial Nursing.",wauuwresource00423.xml,80444/xv28430,3,3,5,11
"Unknown",waufreeporttelephoneandtelegraphcofreeportcalif4650.xml,80444/xv06460,6,3,2,11
"Unknown",waupacificnorthwestbibliographiccenterseattlewash3046.xml,80444/xv51452,2,4,5,11
"Howard (Edward,)",wauhowardedward2868.xml,80444/xv17889,5,3,3,11
"Witte (Beverly)",wauwittebeverlyua4100.xml,80444/xv16119,1,4,6,11
"Joseph (Frida)",waujosephfridastark3766.xml,80444/xv75546,2,4,5,11
"Unknown",wauuwresource07287.xml,80444/xv46987,5,2,4,11
"Unknown",wauhamleycharlesl0951.xml,80444/xv92523,3,3,5,11
"Selig (Martin) Oral History",wauseligmartin5607.xml,80444/xv81604,4,1,6,11
"Carpenter (Edward)",waucarpenteredwardl0599.xml,80444/xv74673,2,3,6,11
"Priest Rapids Dam Concrete Pouring Ceremony and Dedication Film",waupriestrapidsdamopeningphcoll802.xml,80444/xv26464,3,4,4,11
"University of Washington. School of Medicine. Medical Student Research Training Program.",wauuwresource00383.xml,80444/xv72683,1,4,6,11
"Unknown",waugenauercelia2618.xml,80444/xv17187,5,2,4,11
"Higbee (Blanche)",wauhigbeeblanche1108.xml,80444/xv69451,3,4,4,11
"Washington Sea Grant Marine Advisory Services.",wauuwresource00451.xml,80444/xv03170,5,1,5,11
"Unknown",wauuwresource07362.xml,80444/xv69873,4,3,4,11
"Soule (Elizabeth)",wausouleelizabethsterlingua2914.xml,80444/xv45568,2,3,6,11
"Great Britain. Vice Consul (Port Townsend, Wash.).",waugreatbritainviceconsul3609.xml,80444/xv50219,3,5,3,11
"Unknown",waumapelelib3194.xml,80444/xv24908,3,3,5,11
"Garfield (Charles)",waugarfieldcharlesd0241.xml,80444/xv38574,5,3,3,11
"Stucki (Curtis)",waustuckicurtiswua2943.xml,80444/xv29846,3,3,5,11
"Washington State Ferry Photograph Album",wauwashingtonstateferryboatalbumphcoll1322.xml,80444/xv94531,5,0,6,11
"Port Townsend Cargoes.",wauporttownsendcargoes0161.xml,80444/xv11135,2,3,6,11
"Unknown",waugluckjoseph2818.xml,80444/xv06396,2,3,6,11
"Curtis (Elizabeth)",waucurtiselizabethlongua5021.xml,80444/xv07723,1,5,5,11
"Seihoku Nippo",wauseihokunippo1897.xml,80444/xv40261,5,2,4,11
"Unknown",waumacgregornelllewis1714.xml,80444/xv72906,2,4,5,11
"Kyoto, Japan Photograph Album",waukyotojapanphcoll838.xml,80444/xv29925,2,5,4,11
"Whittlesey (Walter)",wauwhittleseywalterb0892.xml,80444/xv09298,4,3,4,11
"Unknown",wauseattlejewishcoalitionhomelesspeople5834.xml,80444/xv66873,1,3,7,11
"Lozovsky (Jeanette) Oral History",waulozovskyjeanette5655.xml,80444/xv93753,3,2,6,11
"Pacific Northwest Asian-American Writers Conference (1976 : Seattle, Wash.).",waupacificnorthwestasianamericanwritersconference2768.xml,80444/xv40493,1,5,5,11
"Levey (I.)",wauleveyij1725.xml,80444/xv03347,2,4,5,11
"Morgan (Millie) Photograph Collection",waumorganmilliephcoll088.xml,80444/xv83938,3,1,7,11
"Unknown",waumorriswilliamw4828.xml,80444/xv95034,2,3,6,11
"National Archives (U.S.).",waunationalarchives0922.xml,80444/xv81491,2,5,4,11
"Unknown",wauuwresource07400.xml,80444/xv48965,4,2,5,11
"Worcester (Dean)",wauworcesterdeanaua3374.xml,80444/xv43786,4,2,5,11
"Ribe (Fred L.) Papers",wauribefredlua5161.xml,80444/xv22079,6,2,3,11
"Unknown",wausupremetempleorderpythiansisterstempleno32hoquiamwash3956.xml,80444/xv61325,1,3,7,11
"Stern (Edward)",wausternedwarda5002.xml,80444/xv05297,3,4,4,11
"Lake (Sandra Glazer)",waulakesandraglazer5764.xml,80444/xv32247,7,0,4,11
"Unknown",wauweldmartin4959.xml,80444/xv99807,1,4,6,11
"McMurry (J. M. ) Photograph Album of the University of Washington",wauuwalbumphcoll118.xml,80444/xv47048,1,2,8,11
"Washington and Oregon Photograph Album",wauwashingtonoregonphotographalbumphcoll184.xml,80444/xv80950,1,4,6,11
"Great Britain. Board of Trade.",waugreatbritainboardoftrade4738.xml,80444/xv30310,1,4,6,11
"Basye (Joseph)",waubasyejosephi0680.xml,80444/xv37994,1,4,6,11
"Unknown",wauuwresource06987.xml,80444/xv38070,3,3,5,11
"Gavett (Irving)",waugavettirving2318.xml,80444/xv25677,6,4,1,11
"Unknown",waureniaginsha1360.xml,80444/xv03604,3,4,4,11
"Weil (Charles F.) Grand Coulee Dam Photograph Collection",wauweilcharlesfphcoll237.xml,80444/xv79940,2,1,8,11
"Wilson (William)",wauwilsonwilliameua3121_3398.xml,80444/xv09555,2,5,4,11
"USDA Soil Conservation Service Photo Collection",wauusdasoilconservationservicephcoll659.xml,80444/xv17828,3,2,6,11
"Wojdak (Rachel)",wauwojdakrachel2696-126.xml,80444/xv16244,2,2,7,11
"Unknown",waurevellerandy3784.xml,80444/xv77349,7,1,3,11
"Van Eaton (Harold)",wauvaneatonharoldd0156.xml,80444/xv78399,1,5,5,11
"Great Alaska Earthquake Photograph Collection",waugreatalaskaearthquakephcoll847.xml,80444/xv77841,3,3,5,11
"Unknown",waumillermarya1404.xml,80444/xv50698,3,4,4,11
"Unknown",wauweissmimi5296.xml,80444/xv88223,1,3,7,11
"University of Washington. Office of the Vice Provost for Research.",wauuwresource00181.xml,80444/xv31323,1,4,6,11
"Norwood (Jean)",waunorwoodjean0768_1995.xml,80444/xv64373,4,4,3,11
"Physical Education Club (University of Washington).",wauphysicaleducationclub5066.xml,80444/xv06759,1,6,4,11
"Unknown",waukochjoan1764.xml,80444/xv07604,2,1,8,11
"Unknown",wauekrothnelsphcoll601.xml,80444/xv00009,4,5,2,11
"Theodore Roethke Memorial Foundation (Saginaw, Mich.).",wautheodoreroethkememorialfoundation4870.xml,80444/xv63946,4,2,5,11
"National Student League (University of Washington).",waunationalstudentleague5139.xml,80444/xv59536,2,5,4,11
"Crawford (Ailsa)",waucrawfordailsa2696.xml,80444/xv02200,0,6,5,11
"University of Washington. Medical Center. Social Work Department.",wauuwresource00227.xml,80444/xv98892,2,3,6,11
"Ichihara (Hiroyuki) Papers",wauichiharahiroyuki4761_1.xml,80444/xv08558,6,4,1,11
"Morley Studio Photographs of the Seattle World's Fair",waumorleystudiophcoll1385.xml,80444/xv84732,0,6,5,11
"University of Washington Medical Center Fertility and Endocrine Center Records",wauuwresource02071.xml,80444/xv63824,2,3,6,11
"Unknown",wauwolffjoel2387.xml,80444/xv66424,3,3,5,11
"Unknown",waustokeskatharinemartin1780.xml,80444/xv23632,2,4,5,11
"Misch (Peter) Photograph Collection",waumischpeterph2007_022.xml,80444/xv15097,1,6,4,11
"Unknown",waupiercemiriam2694.xml,80444/xv57928,5,2,4,11
"Unknown",waushafronjenniekraff3224.xml,80444/xv45050,2,3,6,11
"McLauchlan (John D.) photograph collection",waumclauchlanjohndph2014_003.xml,80444/xv52624,2,7,2,11
"Bank Robbers",waubankrobbersoutlawsphcoll1406.xml,80444/xv86355,0,11,0,11
"Harkins (Henry)",wauharkinshenrynua2501.xml,80444/xv60800,2,4,5,11
"Instructors' Association",wauinstructorsassociation5065.xml,80444/xv14047,2,2,7,11
"Unknown",wauamosspamela3716.xml,80444/xv53314,7,0,4,11
"Unknown",waurakestrawlawrence3814.xml,80444/xv27230,4,1,6,11
"Sluicing Work of Lewis Construction",waulewisconstructioncophcoll21.xml,80444/xv22582,7,2,2,11
"Unknown",wauneighborhoodhouseincseattlewash3857.xml,80444/xv39773,1,2,8,11
"Unknown",wauclitherojoann5083.xml,80444/xv87695,2,3,6,11
"Maltby (Harold E. and Esther Stark) photographs",waumaltbyphotographsphcoll1133.xml,80444/xv67309,3,2,6,11
"Unknown",wauwashingtonnewscouncil5837.xml,80444/xv64270,4,2,5,11
"Whitebrook (Robert)",wauwhitebrookrobertballard0414.xml,80444/xv79727,3,3,5,11
"Tarrasch (Hanna)",wautarraschhanna3804.xml,80444/xv14086,1,4,6,11
"Unknown",wausteptoeedwardjenner4908.xml,80444/xv20281,7,2,2,11
"Wood (Francis)",wauwoodfranciscua4509.xml,80444/xv84127,2,2,7,11
"Harborview Medical Center (Seattle, Wash). Parking and Commuter Services.",wauuwresource00487.xml,80444/xv80023,4,4,3,11
"University of Washington Committee On Tenure and Academic Freedom Records",wauuwresource09281.xml,80444/xv35769,0,6,5,11
"Franck (Joanne)",waufranckjoanne2584.xml,80444/xv63394,3,2,6,11
"Jones, (Lynds) Photograph Collection",waujonesgeorgephcoll001.xml,80444/xv75357,4,3,4,11
"Maloney (John)",waumaloneyjohn2163.xml,80444/xv51251,2,3,6,11
"Unknown",waurosszolah0148.xml,80444/xv52236,1,3,7,11
"Pioneer Square District Study Photograph Collection",waupioneersquaredistrictstudyphcoll450.xml,80444/xv95178,3,3,5,11
"Unknown",wauwaxmanrebeccaschneider5022.xml,80444/xv21121,2,2,7,11
"Unknown",wauwashingtonstatepoetryfoundation1836.xml,80444/xv90960,2,4,5,11
"Unknown",waukirkendallrichardua5720-001.xml,80444/xv67218,4,3,4,11
"Workmen's Circle/Der Arbeter Ring Branch 304 Photograph Collection",wauworkmenscirclephcoll769.xml,80444/xv64758,0,6,5,11
"Unknown",waujohnsonlyndonb5298.xml,80444/xv18685,2,3,6,11
"Welander (Arthur)",wauwelanderarthurdua3346.xml,80444/xv16705,3,3,5,11
"Unknown",wausternoffcarl2276.xml,80444/xv65573,1,3,7,11
"Harrison Community Council.",wauharrisoncommunitycouncil3496.xml,80444/xv12225,1,5,5,11
"Unknown",waustarrearl5454.xml,80444/xv20251,2,4,5,11
"Phi Lambda Upsilon. Epsilon Chapter (University of Washington).",wauphilambdaupsilonepsilonchapter4482.xml,80444/xv13623,3,4,4,11
"Stearns (Josiah) Photograph Collection",waustearnsjosiahphcoll181.xml,80444/xv53775,4,3,4,11
"Waldman (Selma) Papers",wauwaldmanselma5888.xml,80444/xv51507,2,5,4,11
"English Cathedral and Church Photograph Collection",wauenglishcathedralandchurchphotosphcoll1198.xml,80444/xv29879,2,4,5,11
"Unknown",waumakinobill5423.xml,80444/xv56588,1,4,6,11
"Osborn (Edward T.) Architectural Drawing Collection",wauosbornedwardph2004_042.xml,80444/xv15908,1,4,6,11
"Maxson (Margaret) Photograph Collection",waumaxsonmargaretphcoll1345.xml,80444/xv83776,4,3,4,11
"Sheehan (Florence)",wausheehanflorenceua4121.xml,80444/xv80255,3,3,5,11
"Roberts (Alexander)",waurobertsalexandercrippenua2719.xml,80444/xv40322,3,4,4,11
"Ehlert (Charles E.) case files",wauehlertcharlese5602.xml,80444/xv00485,4,4,3,11
"Unknown",waumapesmiltonc2438.xml,80444/xv21646,2,2,7,11
"University of Washington, Department of Chemistry Records",wauuwresource00302.xml,80444/xv40615,2,3,6,11
"Unknown",wauwennerstromaugust1709.xml,80444/xv35559,4,1,6,11
"Kroskrity (Paul)",waukroskritypaulv2696-018.xml,80444/xv58587,3,1,7,11
"Unknown",wauzeevefamily2799.xml,80444/xv85803,3,2,6,11
"Katsman (Louis)",waukatsmanlouis1660_2589.xml,80444/xv66094,6,5,0,11
"University of Washington. Dept. of Medicine. Nephrology Division.",wauuwresource00393.xml,80444/xv54867,3,4,4,11
"Unknown",waugroveflorence3553.xml,80444/xv87292,2,2,7,11
"Vacation Trips",wauroadtripalbumsphcoll771.xml,80444/xv14480,3,2,6,11
"Unknown",wauhoggsonnoblefoster2566.xml,80444/xv46664,1,5,5,11
"Unknown",wauleavittmelbournel3221.xml,80444/xv75479,5,2,4,11
"Panama-Pacific International Exposition (1915 : San Francisco, Calif.).",waupanamapacificinternationalexposition4083.xml,80444/xv65029,4,3,4,11
"Snyder (Warren)",wausnyderwarrenarthur1835.xml,80444/xv90802,1,2,8,11
"Meyer (E. L.) Photographs",waumeyerelphcoll1186.xml,80444/xv38818,2,3,6,11
"Ontarions scrapbooks",wauontarions5692.xml,80444/xv26034,5,1,5,11
"New York (State).",waunewyork0207.xml,80444/xv11044,3,3,5,11
"Campbell (Lillian)",waucampbelllilliann1835.xml,80444/xv44244,4,2,5,11
"Unknown",wauschoenfeldmax2150.xml,80444/xv43350,3,3,5,11
"Unknown",wauhansonkennetho5286.xml,80444/xv08609,1,4,6,11
"Brooks (Richard E.) Photograph Collection",waubrooksrichardephcoll543.xml,80444/xv07357,5,5,1,11
"University of Washington. Registrar's Office.",wauuwresource00148.xml,80444/xv66998,5,3,3,11
"McClain (Bernard)",waumcclainbernardh4684.xml,80444/xv04421,2,4,5,11
"Unknown",wauicelandicclubofgreaterseattle2244.xml,80444/xv31483,4,4,3,11
"McClees (Johanna)",waumccleesjohanna5362.xml,80444/xv47558,1,4,6,11
"Unknown",waupuechleralfred3900.xml,80444/xv79855,1,3,7,11
"Northwest Alaska Aerial Photographs",waunorthwestalaskaaerialphcoll208.xml,80444/xv08853,7,1,3,11
"Phillips (Jessie)",wauphillipsjessiew5516.xml,80444/xv58325,2,4,5,11
"Olcott (Virginia)",wauolcottvirginiaua2909.xml,80444/xv90997,2,4,5,11
"Todd Shipyards Corporation Photograph Album",wautoddshipyardscorporationphcoll079.xml,80444/xv18075,3,1,7,11
"MacGregor Family",waumacgregorfamilyscrapbooksph2014_006.xml,80444/xv59008,6,2,3,11
"Rhodes (Helen Neilson) Prints",waurhodeshelenphcoll762.xml,80444/xv22949,4,2,5,11
"Kumor (Georgia)",waukumorgeorgiaann4140.xml,80444/xv30880,1,5,5,11
"Taft Family Photograph Collection",wautaftfamilyphcoll848.xml,80444/xv07546,3,4,4,11
"University of Washington. College Relations Office.",wauuwresource00115.xml,80444/xv96743,3,3,5,11
"Unknown",wauperryclifforda2480.xml,80444/xv09701,3,2,6,11
"University of Washington Department of Industrial Engineering Records",wauuwresource00683.xml,80444/xv19296,2,3,6,11
"Meadows (William)",waumeadowswilliamc2696-100.xml,80444/xv90884,3,3,5,11
"Unknown",wauuwresource00412.xml,80444/xv93768,4,2,5,11
"Paden (Kathryn)",waupadenkathrynstover3416-001.xml,80444/xv08480,8,2,1,11
"Unknown",wauplummergeorge4848.xml,80444/xv10830,4,3,4,11
"Kane (Thomas)",waukanethomasfranklinua2382_3341.xml,80444/xv16540,2,5,4,11
"Unknown",wausciglianoeric5105.xml,80444/xv61264,5,4,2,11
"Woo (Florence)",wauwooflorencefunglam2696-128.xml,80444/xv45208,5,3,3,11
"Spector (Ivar,)",wauspectorivarua2701.xml,80444/xv59307,3,4,4,11
"Beezer (Robert R.) Chamber Papers",waubeezerrobertr6019.xml,80444/xv45385,0,0,11,11
"Unknown",waurobinjoshua5305.xml,80444/xv57315,3,4,4,11
"Unknown",wauelkanrose3142.xml,80444/xv48101,2,5,4,11
"University of Washington. Dept. of Chemical Engineering.",wauuwresource00332.xml,80444/xv01254,2,2,7,11
"Unknown",wauogilviefay3973.xml,80444/xv33468,2,4,5,11
"Gessner (Suzanne)",waugessnersuzanne2696-121.xml,80444/xv67788,2,5,4,11
"University of Washington. Society and Justice Program.",wauuwresource00347.xml,80444/xv83514,2,4,5,11
"Sapiro (Scotty) China Photographs",wausapiroscottyphcoll501.xml,80444/xv24044,2,0,9,11
"Church (Frederick)",wauchurchfredericks1456_1457.xml,80444/xv60018,3,3,5,11
"University of Washington. School of Medicine. Photography Office.",wauuwresource00387.xml,80444/xv17294,2,4,5,11
"Unknown",wautwightjanetdana3423.xml,80444/xv63952,2,3,6,11
"University of Washington. Medical Center. Communication Services.",wauuwresource00213.xml,80444/xv12936,1,4,6,11
"Culbertson (Alice) Photograph Collection",wauculbertsonalicephcoll1344.xml,80444/xv42364,3,6,2,11
"Washington State Association of the U.A. Plumbers and Pipefitters",wauwastassocplumberspipefittersphcoll1216.xml,80444/xv30383,3,8,0,11
"Photographs of the Launches of the USS West Lianga and USS Nile",waulaunchoftheusswestliangaphcoll1405.xml,80444/xv67706,9,2,0,11
"Meld (Murray) oral history",waumeldmurray5770.xml,80444/xv67626,6,3,2,11
"Buckley (Thomas)",waubuckleythomasct2696-009.xml,80444/xv16949,2,4,5,11
"Case (W.H) Photographs of Native American Baskets",waucasewhnativeamericanbasketsphcoll1188.xml,80444/xv41427,4,5,2,11
"Unknown",waumuenchalice3842.xml,80444/xv91561,5,3,3,11
"Great Britain Photograph Album",waugreatbritainphcoll182.xml,80444/xv59216,5,2,4,11
"Unknown",waucohanabnerh2093.xml,80444/xv15777,3,3,5,11
"Wellspring Family Services Film Collection",wauwellspringfamilyservicesphcoll886.xml,80444/xv26873,3,3,5,11
"Bevan (Donald)",waubevandonaldeua4169.xml,80444/xv47012,2,3,6,11
"Pi Alpha (University of Washington).",waupialpha3323.xml,80444/xv59982,2,3,6,11
"Unknown",wautoddjohnw4279.xml,80444/xv02725,2,3,6,11
"Roosevelt (Theodore) Photographs of",wautheodorerooseveltphcoll736.xml,80444/xv78189,3,4,4,11
"Marr (Carolyn,)",waumarrcarolyn2696-012.xml,80444/xv48928,3,3,5,11
"Unknown",waurisberggerda1927.xml,80444/xv50234,0,5,6,11
"Unknown",wausykoraelmerr2355.xml,80444/xv33981,2,5,4,11
"University of Washington College of Education Dean",wauuwresource00265.xml,80444/xv33813,3,4,4,11
"Unknown",wauvansoelenantonc0379.xml,80444/xv13708,3,4,4,11
"Junior Science and Humanities Symposium.",wauuwresource01134.xml,80444/xv05358,3,3,5,11
"More (Charles)",waumorecharleschurchua4439_5001.xml,80444/xv94827,3,4,4,11
"Irene Joshi Photograph Collection",waujoshiireneph2008_019.xml,80444/xv87326,5,4,2,11
"Dubin (Maxwell)",waudubinmaxwellh1107.xml,80444/xv47726,2,4,5,11
"French (Anna) Photograph Collection",waufrenchannaphcoll157.xml,80444/xv85684,3,3,5,11
"Neumann (Kay) Photograph Collection",wauneumannkayphcoll261.xml,80444/xv49642,3,4,4,11
"Unknown",waukahnfredfritz2976.xml,80444/xv63928,4,2,5,11
"Smith (George)",wausmithgeorgemcphail2359.xml,80444/xv81842,1,5,5,11
"Nowell (Frank) photographs of Smith Tower construction",waunowellfranksmithtowerphcoll1023.xml,80444/xv85195,0,11,0,11
"Hong (Anna)",wauhongannamariaua4141.xml,80444/xv86401,2,4,5,11
"Smith (Canfield)",wausmithcanfieldf4225.xml,80444/xv93576,2,5,4,11
"Unknown",waudupeevogelfamily2271.xml,80444/xv96441,4,3,4,11
"University of Washington. Oval Club.",wauuniversityofwashingtonovalclubua3396.xml,80444/xv78466,0,6,5,11
"Mountaineers (Society). Annual Editor.",waumountaineersannualeditor3432.xml,80444/xv09811,3,4,4,11
"Unknown",waudowellbf4720.xml,80444/xv26568,3,3,5,11
"Hertzberg (Abraham)",wauhertzbergabrahamua3386.xml,80444/xv85235,3,5,3,11
"Monahan (James)",waumonahanjames5240.xml,80444/xv09286,3,4,4,11
"Max Ivor Motel",waumaxivorphcoll846.xml,80444/xv14794,5,1,5,11
"Nelson (May)",waunelsonmaykomedal3935.xml,80444/xv37234,2,4,5,11
"Pickett (Mildred)",waupickettmildred3416-001.xml,80444/xv88525,3,3,5,11
"Unknown",wauhansonhowardarthur4745.xml,80444/xv77307,2,4,5,11
"Shapard (Jeffrey)",waushapardjeffrey2696-035.xml,80444/xv47894,2,5,4,11
"Anderson (Donald L.) Papers",wauua22_13_1681andersondonald.xml,80444/xv68066,3,4,4,11
"Unknown",wauknappralph0197.xml,80444/xv57290,4,4,3,11
"American Road Builders' Association. Student Chapter (University of Washington).",wauamericanroadbuildersassociationstudentchapter4346.xml,80444/xv74114,4,3,4,11
"Unknown",waugreatnorthernlumbercompany5253.xml,80444/xv37960,3,3,5,11
"Unknown",wausterlingrecreationorganization3208.xml,80444/xv13562,3,6,2,11
"Casa Latina Records",waucasalatina5975.xml,80444/xv93518,0,0,11,11
"Unknown",waupacificfisherybiologistssociety1847.xml,80444/xv95306,1,5,5,11
"University of Washington. Student Accounts and Scholarships Office.",wauuwresource00189.xml,80444/xv65380,4,4,3,11
"Unknown",wauyamakayuzuru1489.xml,80444/xv16278,3,4,4,11
"Miller (Bruce)",waumillerbrucegranville2696-114.xml,80444/xv98986,2,5,4,11
"Unknown",wauulbricksonalvinedmund2941.xml,80444/xv41174,2,5,4,11
"Children's Orthopedic Hospital Building Photograph Collection",wauchildrensorthopedichospitalphcoll136.xml,80444/xv22412,3,3,5,11
"Seattle Magazine.",wauseattlemagazine1491_1509_1887.xml,80444/xv39727,1,5,5,11
"Unknown",wausingallison2465.xml,80444/xv28106,3,4,4,11
"Pierson & Co. photographs of Seattle apartment buildings",waupiersoncophotographsseattleapartmentbuildingsphcoll1170.xml,80444/xv89215,0,5,6,11
"Williams (Gordon) Photographs",wauwilliamsgordonphcoll252.xml,80444/xv25765,3,3,5,11
"Unknown",wauholmesjlister3789.xml,80444/xv87692,0,5,6,11
"Unknown",waustusserelizabethw2828.xml,80444/xv50671,3,1,7,11
"Legion Against War.",waulegionagainstwar1500.xml,80444/xv48016,5,2,4,11
"Walkinshaw (Robert B.) Papers",wauwalkinshawrobertb5568.xml,80444/xv27896,4,2,5,11
"Miles (Charles)",waumilescharles4026.xml,80444/xv33212,4,2,5,11
"Kracht (Benjamin)",waukrachtbenjaminr2696.xml,80444/xv79284,1,3,7,11
"Whitish (Rachel)",wauwhitishrachelbrignone3416-001.xml,80444/xv97662,2,4,5,11
"Unknown",wauhilpertdavid4149.xml,80444/xv51147,6,2,3,11
"Unknown",waumatsuokajamesm2064.xml,80444/xv12237,2,3,6,11
"University of Washington. Payroll Office.",wauuwresource00190.xml,80444/xv51599,3,4,4,11
"Okamura (Raymond)",wauokamuraraymondy2395.xml,80444/xv26397,1,5,5,11
"Treiger (Karen) oral history",wautreigerkaren5772.xml,80444/xv16958,9,2,0,11
"Goldberg (J.)",waugoldbergjirwin5464.xml,80444/xv16674,5,2,4,11
"Street (Robert)",waustreetroberteua4504.xml,80444/xv91964,3,3,5,11
"Marts (Marion E.) Papers",waumartsmarionua4130.xml,80444/xv45614,0,0,11,11
"Bayley (Frank)",waubayleyfranks3115.xml,80444/xv77212,3,3,5,11
"Unknown",waurogersalbertbowman0642.xml,80444/xv48455,2,2,7,11
"Fuller (M.) Photograph Album",waufullermphcoll040.xml,80444/xv39044,2,4,5,11
"Unknown",waucongregationnertamidofbellevuebellevuewash4401.xml,80444/xv21569,0,2,9,11
"Moore (Ellen)",waumooreellenk2696-096.xml,80444/xv21960,2,5,4,11
"San Jose (Johnny) photograph album",wausanjosejohnnyphcoll1144.xml,80444/xv91018,2,3,6,11
"Tostberg (Robert)",wautostbergroberteua3336.xml,80444/xv89813,3,3,5,11
"Barns Photograph Collection",waubarnsphcoll183.xml,80444/xv49108,7,1,3,11
"Norling (Ernest Ralph) papers",waunorlingernestralph5962.xml,80444/xv86309,0,8,3,11
"Barber (Putnam) papers",waubarberputnam5907.xml,80444/xv05615,3,3,5,11
"Oliver (Josephine)",wauoliverjosephinejames3416-001.xml,80444/xv67575,3,3,5,11
"Unknown",waudubuarpaul4356.xml,80444/xv02957,2,3,6,11
"Unknown",wauiserigeorge2467.xml,80444/xv74685,2,5,4,11
"Unknown",wauhigginsonella4755.xml,80444/xv10711,4,2,5,11
"Landry (Myrtle)",waulandrymyrtlecharley3416-001.xml,80444/xv84231,2,3,6,11
"Migdal (Joel)",waumigdaljoels5460.xml,80444/xv81341,3,2,6,11
"University of Washington. Hospitals. Director of Finance.",wauuwresource07369.xml,80444/xv68670,3,4,4,11
"Ames (William)",wauameswilliameua3394.xml,80444/xv27270,3,2,6,11
"North Cascades Foundation Records",waunorthcascadesfoundation5603.xml,80444/xv84570,5,2,4,11
"Krawczyk (Elizabeth) linguistic field research on Alaskan Yup'ik Eskimo Yukon, Coastal, and Kuskokwim dialects.",waukrawczykelizabeth2696-139-01.xml,80444/xv73178,3,2,6,11
"Unknown",wauhaashedwig4207.xml,80444/xv68682,3,4,4,11
"Unknown",waurasmussenwalterh1440.xml,80444/xv67654,2,4,5,11
"University of Washington Applied Physics Laboratory Film Collection",wauuwappliedphysicslaboratoryphcoll1114.xml,80444/xv82897,3,4,4,11
"Pelly (Thomas M.) Photograph Collection",waupellythomasmphcoll089.xml,80444/xv33123,0,4,6,10
"United States. General Land Office.",wauunitedstatesgenerallandoffice0813_1100.xml,80444/xv25860,1,5,4,10
"Unknown",waunationalorganizationforwomenwashingtonstatechapter4294.xml,80444/xv95465,2,2,6,10
"Tatsumi (Henry)",wautatsumihenrysaburo4441.xml,80444/xv09735,1,2,7,10
"Unknown",waustaadeckervictor5018.xml,80444/xv18112,2,3,5,10
"Unknown",waumunroedward4036.xml,80444/xv47790,1,4,5,10
"Unknown",wauweedluella5043.xml,80444/xv31802,2,4,4,10
"University of Washington International Services Office Records",wauuwresource00179.xml,80444/xv43475,4,2,4,10
"McMurray (Wash.).",waumcmurray2109.xml,80444/xv74649,2,2,6,10
"Wagoner (David)",wauwagonerdavidua4560.xml,80444/xv87756,2,2,6,10
"University of Washington. Dept. of History.",wauuwresource00290.xml,80444/xv96917,2,4,4,10
"Sakura family",wausakurafamily4173.xml,80444/xv36865,3,5,2,10
"Unknown",wauhemlocksocietynezpercepalousechapter4271.xml,80444/xv45767,2,3,5,10
"Unknown",waugranbyconsolidatedminingsmeltingandpowercompany2065.xml,80444/xv42822,3,3,4,10
"Washington State PTA photograph collection",wauwashstptaph2014_004.xml,80444/xv48699,5,4,1,10
"Oliverio (Giulia)",wauoliveriogiuliarm2696-098.xml,80444/xv35147,1,1,8,10
"Unknown",waufetzerpauls4038.xml,80444/xv96710,3,5,2,10
"Unknown",wauniedermarcusseattle2542.xml,80444/xv01599,2,2,6,10
"Unknown",wauschaferbrothersloggingcompany0822.xml,80444/xv34146,3,3,4,10
"Custis (Vanderveer,)",waucustisvanderveer4716.xml,80444/xv30886,2,3,5,10
"University of Washington. Vice Provost for Branch Campuses.",wauuwresource00119.xml,80444/xv84658,1,2,7,10
"Filipino Club (University of Washington).",waufilipinoclub3310.xml,80444/xv17941,2,2,6,10
"Rustad (John)",waurustadjohnaustin3659.xml,80444/xv69812,2,4,4,10
"GI Voting in WWII Photograph Collection",waugivotingwwiiphcoll1045.xml,80444/xv02792,3,3,4,10
"Van Mason (Patricia Pocock) Photograph Collection",wauvanmasonpatriciapocockph2016_007.xml,80444/xv79138,1,5,4,10
"Unknown",waudiffordwallaceellsworth1231.xml,80444/xv92538,0,5,5,10
"Unknown",waumargoliesherminerosenblatt3688.xml,80444/xv61682,3,4,3,10
"Crowley (Ruth)",waucrowleyruthl3416-001.xml,80444/xv09671,1,4,5,10
"Van Doren (Delia)",wauvandorendeliafrancesgeer1912.xml,80444/xv73147,3,2,5,10
"Unknown",wauhorowitzsara4045.xml,80444/xv63397,0,4,6,10
"Dreifus (Betty)",waudreifusbetty1739.xml,80444/xv54107,1,4,5,10
"University of Washington. School of Nursing. Occupational Health Nursing Program.",wauuwresource00421.xml,80444/xv43649,2,3,5,10
"Unknown",wautarshissamuelwilliam4098.xml,80444/xv02334,2,3,5,10
"Unknown",waurochesteralfredr3048.xml,80444/xv92373,3,4,3,10
"Chaikin (Sol)",wauchaikinsol2798.xml,80444/xv77731,1,2,7,10
"University of Washington. Dept. of Oral and Maxillofacial Surgery.",wauuwresource00362.xml,80444/xv17208,2,3,5,10
"Turner (Nancy)",wauturnernancyj1835.xml,80444/xv55142,1,4,5,10
"Unknown",wauowsleymarie3771.xml,80444/xv63787,0,5,5,10
"University of Washington. Dept. of Germanics.",wauuwresource00307.xml,80444/xv36236,3,3,4,10
"Wade (Kathryn) Photographs of Solid Waste Disposal Sites",wauwadekathrynsolidwastephcoll1384.xml,80444/xv08581,0,10,0,10
"Unknown",wausmithes4896.xml,80444/xv40750,8,2,0,10
"Hirsch (Fred)",wauhirschfred0746.xml,80444/xv31982,1,4,5,10
"Kohanski (Dorothy)",waukohanskidorothydellar3639.xml,80444/xv27886,2,2,6,10
"Unknown",wauhagensteinwalter1169.xml,80444/xv89053,3,3,4,10
"Unknown",waugossettlarry4659.xml,80444/xv15444,2,2,6,10
"University of Washington Office of Ceremonies",wauuwresource07768.xml,80444/xv97454,2,4,4,10
"Mountaineers Lantern Slides",waumountaineerslanternslidesphcoll1130.xml,80444/xv88485,6,3,1,10
"Barksdale (Julian D.) Papers",wauua19_20_2036barksdalejulian.xml,80444/xv38314,3,6,1,10
"Hraska (Mary)",wauhraskamary3416-001.xml,80444/xv19705,2,3,5,10
"Unknown",waurussellirwin2391.xml,80444/xv33206,2,2,6,10
"Unknown",wauhiraikaichiro1634.xml,80444/xv25491,3,2,5,10
"Theater, Motion Picture and Entertainment Photograph Collection",wautheatermotionpictureandentertainmentphcoll253.xml,80444/xv32641,3,3,4,10
"Washington Territorial Legislature of 1877 photograph album",wauwashingtonterritoriallegislaturephcoll1308.xml,80444/xv25561,2,4,4,10
"King County (Wash.). Records and Elections Department.",waukingcountyrecordselections2377.xml,80444/xv94796,2,3,5,10
"Seattle (Wash.). Human Rights Dept.",wauseattlehumanrightsdept1800_2037.xml,80444/xv58248,2,3,5,10
"Unknown",waumassartclarencef0865.xml,80444/xv06811,4,4,2,10
"Stenerson (M.)",waustenersonmr3052.xml,80444/xv11495,2,3,5,10
"Smith (Merle)",wausmithmerleirene3030.xml,80444/xv56213,2,3,5,10
"Truax (Sarah)",wautruaxsarah0151.xml,80444/xv34963,3,3,4,10
"Pacific Northwest Writers' Conference.",waupacificnorthwestwritersconference0020_0783.xml,80444/xv13665,1,3,6,10
"Gowey Ships Photograph Collection",waugoweyshipsphcoll248.xml,80444/xv96759,3,5,2,10
"Hemmat (Amir)",wauhemmatamirh5449.xml,80444/xv15481,2,3,5,10
"University of Washington. Scholarly Journals Office.",wauuwresource07249.xml,80444/xv91818,3,4,3,10
"Williams (Curtis)",wauwilliamscurtistalmadgeua0993.xml,80444/xv46060,3,3,4,10
"Stuart (Robert)",waustuartrobertg4914.xml,80444/xv84396,2,1,7,10
"Goetze (Otto D.) Photographs of Nome, Alaska",waugoetzeottodphcoll304.xml,80444/xv70001,4,3,3,10
"Northwest Craft Center interior design drawings",waunwcraftcenterarchdrawingsphcoll1278.xml,80444/xv18661,2,5,3,10
"Spitzer (Leo,)",wauspitzerleo0289.xml,80444/xv86618,1,5,4,10
"Warren (C.)",wauwarrench5646.xml,80444/xv46304,1,4,5,10
"Unknown",wauuwresource07246.xml,80444/xv51580,6,3,1,10
"Unknown",waufujitaharryn4534.xml,80444/xv00811,5,2,3,10
"Mason (J.)",waumasonjtate3459.xml,80444/xv25421,2,3,5,10
"Preston",wauprestonfamily5813.xml,80444/xv97644,1,4,5,10
"Unknown",wauseattlejapanesecommunityservice3648.xml,80444/xv68869,6,2,2,10
"Mountaineers (Society).",waumountaineers1294_1946_1984.xml,80444/xv09780,6,2,2,10
"Unknown",wauthompsonthomasg4345.xml,80444/xv50173,1,4,5,10
"Molner (Denise)",waumolnerdenise3416-001.xml,80444/xv30432,1,5,4,10
"Kramer (Jennifer)",waukramerjennifer2696-099.xml,80444/xv34069,3,3,4,10
"Stevens (John)",waustevensjohnf2142.xml,80444/xv27944,3,2,5,10
"Unknown",waunordstromannae0684.xml,80444/xv58917,1,3,6,10
"University of Washington. Regional Epilepsy Center.",wauuwresource00483.xml,80444/xv50503,2,2,6,10
"Mount St. Helens Eruption Photograph and Ephemera Collection",waumountsthelensphcoll125.xml,80444/xv33328,3,2,5,10
"Unknown",wauseattlecoarts5288.xml,80444/xv09274,3,4,3,10
"Unknown",waurichardsamoretteday4475.xml,80444/xv74530,1,5,4,10
"Skinner (Beth)",wauskinnerbeth2696-046.xml,80444/xv86563,1,4,5,10
"Webster & Stevens Photographs of the Leschi Boathouse and Madison Park Theatre",wauwebsterstevensleschiboathousephcoll901.xml,80444/xv53765,2,3,5,10
"Meya (Wilhelm)",waumeyawilhelmk2696-107.xml,80444/xv49386,3,4,3,10
"Unknown",wauserethhenrynoah2494.xml,80444/xv65893,1,3,6,10
"Unknown",wauwaterlilysteamer4957.xml,80444/xv52532,2,1,7,10
"Unknown",wauwilsonjohnlockwood4975.xml,80444/xv52700,2,3,5,10
"French (Anna)",waufrenchanna3280.xml,80444/xv96063,2,3,5,10
"Unknown",wauwoodcarlpaigeua0909.xml,80444/xv97503,2,4,4,10
"Wagner (Nathaniel)",wauwagnernathanielua2709.xml,80444/xv99429,3,3,4,10
"Unknown",waugutersonmurrayb5323.xml,80444/xv47766,3,4,3,10
"Sodergren (Evert) Furniture Drawings",wausodergrenevertph2016_003.xml,80444/xv60076,2,8,0,10
"Bebb & Gould, Architects.",waubebbgouldarchitects2990.xml,80444/xv85409,0,5,5,10
"Unknown",wauwestlandjack0505.xml,80444/xv59716,2,4,4,10
"Goodfellow (Anne)",waugoodfellowanne2696-097.xml,80444/xv23052,3,3,4,10
"Lude (Mike)",wauludemikeua4995.xml,80444/xv21820,2,2,6,10
"Mund (Vernon)",waumundvernonaua2357.xml,80444/xv63107,3,2,5,10
"University of Washington Center for Teaching and Learning Records",wauuwresource09005.xml,80444/xv69403,2,4,4,10
"American Universities Field Staff.",wauamericanuniversitiesfieldstaff3200.xml,80444/xv20144,1,4,5,10
"Unknown",wauheggenbertl0382.xml,80444/xv12280,2,4,4,10
"Unknown",wauuwresource07284.xml,80444/xv15914,1,3,6,10
"Unknown",wautempleshalomyakimawash4069.xml,80444/xv85372,1,3,6,10
"Russell (Mary)",waurussellmary3416-001.xml,80444/xv92291,2,3,5,10
"Wooster (Warren)",wauwoosterwarrensua3354.xml,80444/xv71582,2,2,6,10
"Unknown",waulumbercodeauthority3518.xml,80444/xv01971,2,3,5,10
"Redford (Grant)",wauredfordgranth4349.xml,80444/xv94201,2,4,4,10
"Unknown",waurubinclaragordon3296.xml,80444/xv49450,1,4,5,10
"Unknown",waucookjimmiejean4308.xml,80444/xv16229,3,6,1,10
"Unknown",waunortheasternresourcescommitteeus0292.xml,80444/xv38232,1,2,7,10
"Unknown",wausangersl4070.xml,80444/xv04519,4,2,4,10
"Selam (James)",wauselamjames2696-054.xml,80444/xv09960,2,3,5,10
"MacLaury (Robert)",waumaclauryroberte2696-060.xml,80444/xv23419,2,3,5,10
"Aida (Opera Performance)",wauaidaoperaperformance4588.xml,80444/xv21743,2,3,5,10
"Hanford (C.H.) Photograph Collection",wauhanfordchphcoll506.xml,80444/xv55380,2,4,4,10
"Unknown",wauua21_00_3377gilesfrederic.xml,80444/xv35235,5,2,3,10
"Van Arsdale (Albert H.) Photograph Album",wauvanarsdalealberthph2010_007.xml,80444/xv61541,2,1,7,10
"Redeker (Charles)",wauredekercharlescua3397.xml,80444/xv76010,2,3,5,10
"Unknown",waujordandavidstarr2929.xml,80444/xv50396,2,3,5,10
"Unknown",waurothschildmaryaickin1150.xml,80444/xv59484,4,3,3,10
"Robbins (Floyd)",waurobbinsfloyddavidua1795.xml,80444/xv73080,0,3,7,10
"Sternoff (Burton) Collection of Josef Scaylea Photographs",wausternoffburtonph2007_020.xml,80444/xv53741,1,1,8,10
"Vasa Order of America. Lodge Number 378 (Preston, Wash.).",wauvasaorderofamericalodgenumber378_1208.xml,80444/xv65762,3,3,4,10
"University District Photograph Collection",wauuniversitydistrictphcoll194.xml,80444/xv96932,2,3,5,10
"Columna (Potenciano Parin)",waucolumnapotencianoparin5744.xml,80444/xv73666,0,0,10,10
"Henry (John Frazier) Mount Rainier Photograph Collection",wauhenryjohnfrazierphcoll096.xml,80444/xv08355,2,5,3,10
"Unknown",waucommitteefortheseattlecommons5331.xml,80444/xv82574,8,2,0,10
"Dexter Horton National Bank Photograph Collection",waudexterhortonbankphcoll404.xml,80444/xv50283,2,5,3,10
"Unknown",wauhistoricalrecordssurveywash1191.xml,80444/xv51959,1,2,7,10
"Unknown",wauveblenmarthannae2973.xml,80444/xv63290,2,3,5,10
"Foreign Language Press.",wauforeignlanguagepress4732.xml,80444/xv18658,2,3,5,10
"Sanders Family photograph album",wausandersfamilyphotographalbumphcoll1103.xml,80444/xv20657,4,3,3,10
"Washington (George,)",wauwashingtongeorge0002.xml,80444/xv02984,6,2,2,10
"Puget Sound Electric Railway Photograph Collection",waupugetsoundelectricrailwayph2005_030.xml,80444/xv07522,2,4,4,10
"Eatonville, Washington, Photograph Collection",waueatonvillealbumphcoll456.xml,80444/xv48913,9,1,0,10
"Vincent (Leon Stuart) Videotape of Home Movies",wauvincentleonstuartphcoll822.xml,80444/xv27090,3,1,6,10
"Solberg (Ramona)",wausolbergramona2664.xml,80444/xv59466,2,2,6,10
"Pomerantz (Kay)",waupomerantzkaykantor3873.xml,80444/xv98913,3,3,4,10
"Furry (Mabel) Photograph Collection",waufurrymabelphcoll1235.xml,80444/xv09829,1,7,2,10
"Greenberg (Daniel)",waugreenbergdanieljoseph4740.xml,80444/xv86767,3,1,6,10
"Friedman (Harry)",waufriedmanharryj1814_1834_2751.xml,80444/xv07061,0,3,7,10
"Unknown",waublanchardandpartridgeseattlewash4613.xml,80444/xv91543,4,4,2,10
"Unknown",waufunkaaron3414.xml,80444/xv03787,2,3,5,10
"Grekoff (George)",waugrekoffgeorge1835.xml,80444/xv31539,2,3,5,10
"Gordon (Solomon)",waugordonsolomona3717.xml,80444/xv04547,3,2,5,10
"Unknown",waugorendavid4044.xml,80444/xv39358,1,2,7,10
"Ross (Russell)",waurossrussellua5190.xml,80444/xv90393,1,3,6,10
"Unknown",waulevinsonruthkahn4057.xml,80444/xv44882,3,5,2,10
"University of Washington, Parking Services Records",wauuwresource00132.xml,80444/xv24673,3,3,4,10
"Bushnell (C.A.) and Crouch (Pearl R.) Photograph",waubushnellandcrouchphcoll787.xml,80444/xv84753,5,2,3,10
"Unknown",wauwilliamsforrestv1804.xml,80444/xv07284,2,4,4,10
"Miller (John Franklin) Papers",waumillerjohnf1267.xml,80444/xv37288,3,4,3,10
"Thomas Burke Memorial Washington State Museum. Public Relations Office.",wauuwresource00320.xml,80444/xv96197,2,7,1,10
"McKay (George)",waumckaygeorgefrederickua0406.xml,80444/xv41375,2,7,1,10
"McConnahey (James)",waumcconnaheyjames0546.xml,80444/xv44964,1,3,6,10
"Poppe (Nicholas,)",waupoppenicholasua4477.xml,80444/xv85937,2,3,5,10
"Rabel (Irvine)",waurabelirvine0483.xml,80444/xv85797,2,3,5,10
"University of Washington. Student Loans Office.",wauuwresource00191.xml,80444/xv07690,2,5,3,10
"Unknown",waunewpacificpublishingassociation5262.xml,80444/xv40039,2,2,6,10
"Fields (Paul E.) Publication Collection",waufieldspauleua5551.xml,80444/xv23587,2,4,4,10
"University of Washington. Microbiology Department.",wauuwresource00411.xml,80444/xv52395,3,5,2,10
"Tidball (Harriet)",wautidballharrietua4595.xml,80444/xv91772,3,2,5,10
"Unknown",waunicholsarthurh2458.xml,80444/xv40118,3,2,5,10
"Unknown",wauyantisgeorgefranklin0282.xml,80444/xv52795,3,3,4,10
"Unknown",wauweisshowardd3097.xml,80444/xv29354,2,6,2,10
"University of Washington. Experimental College.",wauuwresource00160.xml,80444/xv62875,3,4,3,10
"Woodruff (Gene)",wauwoodruffgenelua2729.xml,80444/xv75482,3,2,5,10
"Gordon (Wyona)",waugordonwyonaelizasurfusstahlnecker0391.xml,80444/xv88122,3,2,5,10
"Unknown",wauhendersonjosephe4464.xml,80444/xv22720,2,3,5,10
"Washington Women's Heritage Project.",wauwashingtonwomensheritageproject3416.xml,80444/xv43023,2,1,7,10
"Smith (Thomas)",wausmiththomase1331.xml,80444/xv62008,2,4,4,10
"McKenney (Hazel)",waumckenneyhazelcharley3416-001.xml,80444/xv97988,2,3,5,10
"Kaplan (Ted)",waukaplanted3141.xml,80444/xv52850,3,3,4,10
"Unknown",wauolsonandrewolof2087.xml,80444/xv09631,2,4,4,10
"Solberg (Carl)",wausolbergcarleua3337.xml,80444/xv24069,3,2,5,10
"Unknown",wauwildernesssocietyusnorthwestregion4354.xml,80444/xv64251,1,5,4,10
"Unknown",waulovejoywe4679.xml,80444/xv23287,3,2,5,10
"Christian Church of Waverly Order Books",wauchristianchurchofwaverly5741.xml,80444/xv57641,3,3,4,10
"Parcher (Frederick Philip) Photograph Collection",wauparcherfrederickphilipphcoll076.xml,80444/xv63494,4,3,3,10
"Gatch (Thomas)",waugatchthomasmua4318.xml,80444/xv63891,3,2,5,10
"Jeffers, Shirley J.",waujeffersshirleyj3581.xml,80444/xv97247,1,3,6,10
"Historic American Buildings Survey No. WA-201 (Longacres Park) Collection",waulongacresphcoll442.xml,80444/xv83115,7,1,2,10
"Unknown",wauroslingedward5307.xml,80444/xv35177,2,4,4,10
"Williams (Donald)",wauwilliamsdonaldtua5407.xml,80444/xv15844,1,3,6,10
"Chapple (Stanley) papers",wauchapplestanleyua4575.xml,80444/xv35598,8,0,2,10
"Stern (Carolyn)",wausterncarolynf3133.xml,80444/xv84774,3,3,4,10
"Unknown",waustotlandezra2505.xml,80444/xv55059,0,5,5,10
"University of Washington. Assistant Attorney General.",wauuwresource00169.xml,80444/xv42468,2,1,7,10
"Yesler Dock Repair Photograph Collection",wauyeslerdockrepairphcoll080.xml,80444/xv90850,2,4,4,10
"Snohomish County Public Utility District No. 1 (Wash.).",wausnohomishcountypublicutilitydistrictno1_0534_0698.xml,80444/xv55325,3,2,5,10
"Kraft (George)",waukraftgeorgehua3360.xml,80444/xv54061,2,4,4,10
"Auerbach (Marc) Labor and Protest Photographs",wauauerbachmarcph2016_013.xml,80444/xv94088,0,0,10,10
"Van Arsdel (Paul)",wauvanarsdelpaulpua4451.xml,80444/xv00247,1,3,6,10
"Unknown",wauoserangrace4528.xml,80444/xv72695,0,5,5,10
"Unknown",waupugetsoundutilitycommissionersassociation4858.xml,80444/xv24365,2,5,3,10
"Unknown",waubenolielalan3266.xml,80444/xv69625,2,3,5,10
"Schrieber (Albert)",wauschrieberalbertnua3038.xml,80444/xv52191,2,3,5,10
"Unknown",wauseattlelabortempleassociation3626.xml,80444/xv15728,6,1,3,10
"University of Washington. Dept. of Biological Structure.",wauuwresource00401.xml,80444/xv47164,2,4,4,10
"Mastroianni (Anna C.)",waumastroianniannaua5765.xml,80444/xv27667,1,5,4,10
"University of Washington. Hospital. Business and Finance Division.",wauuwresource00224.xml,80444/xv76351,0,4,6,10
"Your Woods Film",wauyourwoodsphcoll831.xml,80444/xv74688,2,4,4,10
"American Institute of Industrial Engineers. Seattle Chapter. Conference (4th : 1958 : University of Washington).",wauamericaninstituteofindustrialengineersseattlechapterconference3305.xml,80444/xv00289,2,1,7,10
"University of Washington. Economic Research Institute.",wauuwresource00316.xml,80444/xv77615,1,3,6,10
"Unknown",wauernstambroseb1699.xml,80444/xv31707,3,5,2,10
"University of Washington Libraries, Acquisition Division",wauuwresource07340.xml,80444/xv32568,1,0,9,10
"Puget Sound Educational Service District Slide & Filmstrip Collection",waupugetsoundeducationalservicedistrictph2004_076.xml,80444/xv52490,8,2,0,10
"University of Washington. Vice Provost for Extension and Summer Quarter.",wauuwresource07425.xml,80444/xv71548,2,4,4,10
"Shi (Youzhong,)",waushiyouzhongua2221.xml,80444/xv41577,2,3,5,10
"Unknown",wauwebsterstevens4986.xml,80444/xv15869,6,0,4,10
"Matson (Bob) papers",waumatsonbob6020.xml,80444/xv78768,0,8,2,10
"Underwood (Geraldine)",wauunderwoodgeraldinegeorge3416-001.xml,80444/xv17083,1,5,4,10
"Unknown",waubloedeljoanross3287.xml,80444/xv52120,4,2,4,10
"Mellor (Roy)",waumellorroym1367_1431.xml,80444/xv79943,4,3,3,10
"Unknown",waukingcountyindustrialassociation4770.xml,80444/xv86315,7,2,1,10
"Curtiss Aeroplane and Motor Company",waucurtissaeroplanemotorcophcoll1180.xml,80444/xv61819,4,2,4,10
"Unknown",waucentury21expo5948.xml,80444/xv36230,0,2,8,10
"Shaw (George)",waushawgeorgecoombs0018.xml,80444/xv62545,3,3,4,10
"Unknown",waumarshgordon4295.xml,80444/xv42022,3,3,4,10
"Unknown",wauamateurathleticunionpacificnorthwestassociation4598.xml,80444/xv48629,3,3,4,10
"Parry (Betty T.) Photograph Album",wauparrybettytphcoll056.xml,80444/xv10699,1,5,4,10
"Unknown",waucoreytheronb4992.xml,80444/xv77777,2,1,7,10
"Unknown",waumountaineerssocietyolympiabranch3980.xml,80444/xv23898,1,2,7,10
"Unknown",waucallowevelyn4459.xml,80444/xv14816,2,2,6,10
"Unknown",waustorygeorgeburnside3897.xml,80444/xv88552,2,3,5,10
"Puget Sound Clean Air Agency Photograph Collection",waupugetsoundcleanairagencyph2016_048.xml,80444/xv87286,0,6,4,10
"Larrison (Earl)",waularrisonearlj4672.xml,80444/xv21932,1,4,5,10
"University of Washington, Center for Multicultural Education Records",wauuwresource08996.xml,80444/xv00662,6,3,1,10
"Unknown",waufoxfrankg5149.xml,80444/xv65774,2,5,3,10
"Unknown",wauhantmanbarry3504.xml,80444/xv99249,2,2,6,10
"Nagano Family Photograph Collection",waunaganofamilyphcoll092.xml,80444/xv12899,1,2,6,9
"Chicago, Milwaukee & Puget Sound Railway Album",wauchicagomilwaukeepugetsoundrailwayphcoll260.xml,80444/xv07699,1,3,5,9
"Unknown",wauwilsonoliverking4976.xml,80444/xv28201,0,3,6,9
"Yakima Valley Museum And Historical Society.",wauyakimavalleymuseumandhistoricalsociety0870.xml,80444/xv56942,3,3,3,9
"Gordon (Barbara)",waugordonbarbaraua4105.xml,80444/xv93231,1,4,4,9
"University of Washington. Health Sciences Center for Educational Resources.",wauuwresource00445.xml,80444/xv99633,4,3,2,9
"Norton (Helen)",waunortonhelenhyatt2696.xml,80444/xv75842,2,4,3,9
"Landon (Deb)",waulandondeb4016.xml,80444/xv85119,3,2,4,9
"United States. Forest Service. Pacific Northwest Region.",wauunitedstatesforestservicepacificnorthwestregion3549.xml,80444/xv18307,2,3,4,9
"German Club (University of Washington).",waugermanclub3312.xml,80444/xv85897,1,2,6,9
"Unknown",waugerrishfamily0970.xml,80444/xv98910,2,2,5,9
"Unknown",waurichmancarol5193.xml,80444/xv11965,1,4,4,9
"Unknown",waurooseveltfranklind4872.xml,80444/xv40759,3,5,1,9
"Rus (Jan)",waurusjan2696-115.xml,80444/xv34478,2,2,5,9
"Hess (Thom,)",wauhessthom1835_2696-026.xml,80444/xv57598,3,1,5,9
"Unknown",wauwalkowherschel2404.xml,80444/xv46527,2,1,6,9
"Mould (Tom,)",waumouldtom2696-118.xml,80444/xv18200,1,4,4,9
"Civic Improvement Association (Bremerton, Wash.).",waucivicimprovementassociation4799.xml,80444/xv00308,2,3,4,9
"Smedley-Strong-Snow Society of China.",wausmedleystrongsnowsocietyofchina3845.xml,80444/xv18218,0,2,7,9
"Graves (Deanne)",waugravesdeannemariehofseth3416-001.xml,80444/xv96557,2,2,5,9
"President Kennedy Speaks at Hanford Film",waukennedyhanfordfilmphcoll828.xml,80444/xv99829,2,1,6,9
"Unknown",waunewlonmc3957.xml,80444/xv94689,1,4,4,9
"Unknown",wauisraelvictoria2057.xml,80444/xv20373,3,4,2,9
"Terry (Miriam)",wauterrymiriamua5229.xml,80444/xv11593,1,2,6,9
"Unknown",wausekofamily3276.xml,80444/xv42489,6,2,1,9
"Unknown",waufarrercharlesm1213.xml,80444/xv82156,3,4,2,9
"Public Utility District No. 1 of Clark County (Wash.).",waupublicutilitydistrictno1ofclarkcounty0486.xml,80444/xv22869,3,3,3,9
"Unknown",waubradforddanielf4621.xml,80444/xv29959,3,2,4,9
"Strumza (Vitalis)",waustrumzavitalis3270.xml,80444/xv28967,1,4,4,9
"Spring (Salman)",wauspringsalman1538.xml,80444/xv12966,3,2,4,9
"Unknown",waubellsleonard1649.xml,80444/xv72225,3,3,3,9
"Emerson (Donald)",wauemersondonald1342.xml,80444/xv19104,3,2,4,9
"Viking",wauvikingnewsletter2260.xml,80444/xv46459,2,4,3,9
"Unknown",wauseligmandaniel3864.xml,80444/xv45205,8,0,1,9
"Van den Berghe (Pierre)",wauvandenberghepierrelua5097.xml,80444/xv30331,2,3,4,9
"Flowers (Verla)",wauflowersverla5518.xml,80444/xv30239,2,1,6,9
"Shorts (Calhoun) England Photograph Album",waushortscalhounphcoll471.xml,80444/xv53421,0,4,5,9
"Schwob (Marcel,)",wauschwobmarcel0041.xml,80444/xv89834,3,2,4,9
"Samsel (Mildred)",wausamselmildred3416-001.xml,80444/xv08743,2,4,3,9
"Harborview Medical Center (Seattle, Wash.). Nursing Education Office.",wauuwresource00482.xml,80444/xv65066,3,3,3,9
"Todd (J.)",wautoddjronaldua3358.xml,80444/xv86383,2,4,3,9
"Cuba Photograph Collection",waucubanphcoll109.xml,80444/xv59362,2,2,5,9
"Rhodes (Fred)",waurhodesfredharoldua3357.xml,80444/xv51177,1,3,5,9
"Charley (Freda)",waucharleyfredastrom3416-001.xml,80444/xv36318,4,3,2,9
"Unknown",waubyrnerutherford4628.xml,80444/xv72546,2,5,2,9
"Sylvester (Robert)",wausylvesterrobertoua1555.xml,80444/xv35858,1,3,5,9
"Schuster (Helen)",wauschusterhelenh2696-015.xml,80444/xv03747,1,3,5,9
"Bonath (Harry) Advertising Art",waubonathharryph2016_022.xml,80444/xv12145,1,8,0,9
"Unknown",waujapanesemethodistepiscopalchurchseattlewash1530.xml,80444/xv02127,3,2,4,9
"Unknown",waujohnsonguela4334.xml,80444/xv58212,3,0,6,9
"Raymond-Turner (James A.) Collection",wauraymond-turnerjamesph2005_037.xml,80444/xv42404,2,3,4,9
"Quintero (Pilar)",wauquinteropilarvillanueva3416-001.xml,80444/xv73989,2,3,4,9
"Woodburne (Lloyd)",wauwoodburnelloydsua2424.xml,80444/xv69613,1,4,4,9
"Peace Action of Washington Photographs",waupeaceactionofwashingtonph2016_054.xml,80444/xv22109,0,0,9,9
"Harborview Medical Center (Seattle, Wash.). Personnel Office.",wauuwresource00474.xml,80444/xv71759,3,1,5,9
"Roberts (Fani) Presents Sephardic Voices CDs",waurobertsfani6002.xml,80444/xv82827,4,0,5,9
"Unknown",wauwhiteharrykeith2442.xml,80444/xv72320,0,2,7,9
"Unknown",waupacificnorthwestloggersassociation0313.xml,80444/xv01159,5,1,3,9
"Williams (Bernice)",wauwilliamsbernicesheldon3416-001.xml,80444/xv70321,1,3,5,9
"Court Statements by Defendants in the Trident Base Trial",wauuniversitycongregationalchurch5635.xml,80444/xv13156,3,2,4,9
"Unknown",wauwoessnerfranka2545.xml,80444/xv38116,2,2,5,9
"Cuppoletti (Linda)",waucuppolettilinda5478.xml,80444/xv94454,1,4,4,9
"Unknown",waumacgowanjanewilson3500.xml,80444/xv68276,2,3,4,9
"Savage (Ellen)",wausavageellenaugusta3416-001.xml,80444/xv58349,1,3,5,9
"Seattle Junior Ad Club Photograph Collection",wauseattlejunioradclubphcoll448.xml,80444/xv40533,2,1,6,9
"Moore (Milo)",waumooremilo0230.xml,80444/xv64035,2,4,3,9
"University of Washington. Dept. of Classics.",wauuwresource00300.xml,80444/xv34008,5,2,2,9
"University of Washington. Division of Cardiothoracic Surgery.",wauuwresource00389.xml,80444/xv09085,2,1,6,9
"Nez Perce Tribe of Idaho.",waunezpercetribeofidaho0004.xml,80444/xv02493,1,4,4,9
"Schrader (Bert L.) Lumber Industry Photograph Collection",wauschraderbertlphcoll356.xml,80444/xv91500,3,3,3,9
"Shelton (John S.)",wausheltonjohnsph2010_024.xml,80444/xv77081,3,3,3,9
"Hirose (Tomio,)",wauhirosetomio2696-123.xml,80444/xv57861,2,4,3,9
"Yetman (David,)",wauyetmandavid2696.xml,80444/xv18713,0,4,5,9
"Unknown",waumuntercatherinedahm4303.xml,80444/xv88815,2,2,5,9
"Read (Lyman Cary) Photographs of Mountains near Atlin, B.C., Canada",waureadlcphcoll1121.xml,80444/xv10623,2,4,3,9
"Storey (Ellsworth) Photograph Collection",waustoreyellsworthphcoll336.xml,80444/xv41558,1,2,6,9
"Strayer (George)",waustrayergeorgee3317.xml,80444/xv45483,2,3,4,9
"Gayton (John)",waugaytonjohnj4746.xml,80444/xv32797,2,3,4,9
"Culp (Dora)",wauculpdoram3416-001.xml,80444/xv87118,2,2,5,9
"Frank (Ella)",waufrankella3416-001.xml,80444/xv44256,2,2,5,9
"Skagit County Photograph Album",wauskagitcountyalbumph2016_049.xml,80444/xv42205,0,0,9,9
"Mansfield (Louise)",waumansfieldlouisewassonua4132.xml,80444/xv05621,2,3,4,9
"Dailey (Michael)",waudaileymichael2641.xml,80444/xv83963,2,3,4,9
"Washington Territory. Auditor's Office.",wauwashingtonterritoryauditorsoffice3251.xml,80444/xv18875,1,3,5,9
"Sijohn (Eleanor)",wausijohneleanormiller3416-001.xml,80444/xv21676,2,4,3,9
"Unknown",wauneubergerrichardl4831.xml,80444/xv16125,2,2,5,9
"Unknown",waulittlewilliama2610.xml,80444/xv13546,3,3,3,9
"Schwarz (Maureen)",wauschwarzmaureentrudelle2696-112.xml,80444/xv60940,1,3,5,9
"Prunet (Jean-François)",wauprunetjeanfrancois2696-058.xml,80444/xv97900,2,3,4,9
"University of Washington Office of the Executive Vice President Records",wauuwresource00096.xml,80444/xv17056,7,0,2,9
"Unknown",wauunitednationsassociationoftheunitedstatesofamericawashingtonstatecouncil0717.xml,80444/xv43276,3,4,2,9
"Unknown",wauoregonwashingtonrailroadandnavigationcompany5154.xml,80444/xv61843,6,2,1,9
"Simmons (J. Oscer) family",wausimmons0952.xml,80444/xv81997,0,5,4,9
"Toledo y Luna (Alonso)",wautoledoylunaalonsode0531.xml,80444/xv57489,4,5,0,9
"Norcross (Amoena)",waunorcrossamoenab2696.xml,80444/xv80941,2,3,4,9
"Unknown",wauroseleaffamily1214.xml,80444/xv14947,1,3,5,9
"Unknown",wauuwresource07321.xml,80444/xv38973,2,3,4,9
"Meyer (Heye)",waumeyerheyehua0187.xml,80444/xv49679,2,4,3,9
"Unknown",wausecordbellakracower3546.xml,80444/xv74581,2,2,5,9
"Americans for Democratic Action.",wauamericansfordemocraticaction0843.xml,80444/xv79388,4,4,1,9
"Unknown",wauferrisharryr0458.xml,80444/xv14978,2,2,5,9
"Glickman (Harry,)",wauglickmanharry2823.xml,80444/xv47576,1,4,4,9
"DeLateur (Conrad) Family",waudelateurfamilyphcoll1367.xml,80444/xv66638,2,4,3,9
"Unknown",waubarrjacquelinev4360.xml,80444/xv18646,3,3,3,9
"Johnson, Leroy V. Photograph Collection",waujohnsonleroyphcoll1096.xml,80444/xv62768,1,5,3,9
"Hauberg",wauhaubergjohnph2003_043.xml,80444/xv23867,2,1,6,9
"Wedgwood (Ralph)",wauwedgwoodralphjua3367.xml,80444/xv72119,3,4,2,9
"Unknown",wauontrack5488.xml,80444/xv69155,5,1,3,9
"Harcourt (Raoul)",wauharcourtraould0835.xml,80444/xv83401,2,3,4,9
"Unknown",waunorthwesthardwarecowhatcom0543.xml,80444/xv19412,2,3,4,9
"New England Fish Company Photograph Collection",waunewenglandfishcoph2016_053.xml,80444/xv22076,0,0,9,9
"Unknown",wauuwresource07384.xml,80444/xv83004,2,3,4,9
"Unknown",waufederalwritersprojectwash4227.xml,80444/xv69692,3,4,2,9
"Schaukal (Richard)",wauschaukalrichardvon3282.xml,80444/xv36856,2,3,4,9
"Unknown",wauwashingtonstategraduatenursesassociation5234.xml,80444/xv08364,2,3,4,9
"Johnson (Leslie)",waujohnsonlesliem2696-119.xml,80444/xv00708,0,3,6,9
"University of Washington. College of Forest Resources. Forestry Continuing Education.",wauuwresource00342.xml,80444/xv64181,1,3,5,9
"Buck (George)",waubuckgeorgeua4157.xml,80444/xv88546,3,3,3,9
"University of Washington. Foresters' Alumni Association.",wauuniversityofwashingtonforestersalumniassociation3318.xml,80444/xv02944,3,2,4,9
"Wilson (James)",wauwilsonjamesbua4115.xml,80444/xv35806,2,4,3,9
"University of Washington. School of Medicine. Cardiovascular Research and Training Center.",wauuwresource00394.xml,80444/xv86389,4,4,1,9
"Unknown",wauhoughhalleybrewstersavery3339.xml,80444/xv49468,1,2,6,9
"Unknown",wauwashingtonkayakclubseattlewash2616.xml,80444/xv50186,3,3,3,9
"University of Washington. Medical Center. Food and Nutrition Services Department.",wauuwresource00226.xml,80444/xv23376,3,1,5,9
"University of Washington. Purchasing Dept.",wauuwresource00124.xml,80444/xv64440,3,5,1,9
"University of Washington. Dept. of Anesthesiology.",wauuwresource00398.xml,80444/xv46789,2,5,2,9
"Unknown",wauphillipsrenarobinson3743.xml,80444/xv60147,4,1,4,9
"Olsen (Sigurd and Ingrith) Papers and Photographs",wauolsensigurdandingrithph2016_010.xml,80444/xv90011,5,1,3,9
"Rowlands (David)",waurowlandsdavidd1353_1395_1452_1478.xml,80444/xv67611,7,2,0,9
"Unknown",wauterrybeatrice3976.xml,80444/xv80328,0,3,6,9
"Unknown",waucasserdfreda2775.xml,80444/xv11865,2,2,5,9
"McGuire (C.)",waumcguirecc1573.xml,80444/xv17425,2,4,3,9
"Colcord (Josiah E.)",waucolcordjosiaheua5968.xml,80444/xv74893,1,0,8,9
"E.R.A. H.J.R. 61 Campaign Committee.",wauerahjr61campaigncommittee2041.xml,80444/xv59451,1,3,5,9
"University of Washington Advancement Services",wauuwresource07781.xml,80444/xv09936,1,3,5,9
"Karpen (Joe)",waukarpenjoephcoll1191.xml,80444/xv20703,1,2,6,9
"Taub (F.)",wautaubfbua4117.xml,80444/xv17745,1,3,5,9
"Timbers (Lawrence,)",wautimberslawrence0390.xml,80444/xv10763,1,3,5,9
"Unknown",waugraycharleso2302.xml,80444/xv04568,9,0,0,9
"Osborn (Edward Thomas) Photograph Collection",wauosbornedwardthomasphcoll337.xml,80444/xv54537,3,4,2,9
"B'nai B'rith. Washington Council of Lodges.",waubnaibrithwashingtoncounciloflodges3591.xml,80444/xv93090,2,2,5,9
"Harkin (Michael)",wauharkinmichaeleugene2696-056.xml,80444/xv59497,2,3,4,9
"Marshall (Carol)",waumarshallcarolr2696-001.xml,80444/xv80981,2,4,3,9
"Fasten (Nathan,)",waufastennathanua5183.xml,80444/xv69522,3,1,5,9
"Unknown",wauwaitealvinh3475.xml,80444/xv05249,3,3,3,9
"Eastman (Carol)",waueastmancarolm2696-011.xml,80444/xv40469,1,4,4,9
"Garmo (Frances)",waugarmofrances2550.xml,80444/xv60372,2,3,4,9
"Tsutakawa (George)",wautsutakawageorge2447.xml,80444/xv00592,2,1,6,9
"Unknown",wauarchitectsreferencefilephcoll1305.xml,80444/xv64337,6,1,2,9
"Unknown",waubyrdrobert1781.xml,80444/xv89599,2,6,1,9
"Unknown",waumatthewtylerr5138.xml,80444/xv65710,3,3,3,9
"Junior Hadassah (Organization : U.S.).",waujuniorhadassah5498.xml,80444/xv07589,2,3,4,9
"Lindholm (Charles Arthur) Photograph Collection",waulindholmcharlesarthurphcoll081.xml,80444/xv82513,4,1,4,9
"Wagness (John T.) Photographs",wauwagnessjohntphcoll562.xml,80444/xv57781,1,2,6,9
"Zelikovsky family photograph collection",wauzelikovskyfamilyphcoll1175.xml,80444/xv56527,0,3,6,9
"Jacknis (Ira)",waujacknisira2696-039.xml,80444/xv37701,2,3,4,9
"University of Washington. Musical Clubs.",wauuwresource05641.xml,80444/xv05947,1,3,5,9
"Unknown",waufarrarmax0674.xml,80444/xv56875,1,3,5,9
"Unknown",wauvasaorderofamerica0028.xml,80444/xv76754,3,1,5,9
"Unknown",wauweavercharlese4330.xml,80444/xv24731,3,1,5,9
"Unknown",wauwisemanab2379.xml,80444/xv38342,2,1,6,9
"Unknown",waucountygroupkingcountywash3023.xml,80444/xv81451,1,4,4,9
"Unknown",waumacdonaldjamesfrederick3267.xml,80444/xv28305,3,2,4,9
"Unknown",waumeadgeorgew4813.xml,80444/xv59393,3,2,4,9
"Coalition for Jewish Concerns-Amcha.",waucoalitionforjewishconcernsamcha5491.xml,80444/xv10162,1,2,6,9
"Unknown",wausmirnoffsergen0612.xml,80444/xv45932,1,4,4,9
"Conning (Andrew)",wauconningandrewscott2696-117.xml,80444/xv54309,0,3,6,9
"Chevra Bikur Cholim (Tanana Valley, Alaska).",wauchevrabikurcholim4669.xml,80444/xv82925,2,3,4,9
"Young Democrats (University of Washington).",wauyoungdemocrats4418.xml,80444/xv04821,2,3,4,9
"Unknown",wauuwresource07375.xml,80444/xv39425,3,3,3,9
"Efron (Sara) Photograph Collection",wauefronsaraphcoll1064.xml,80444/xv76004,5,2,2,9
"Washington State Planning Council.",wauwashingtonstateplanningcouncil4953.xml,80444/xv37023,3,2,4,9
"Nowell (Frank H.) Montana Mining Photographs",waunowellfrankmontanaminingph2008_010.xml,80444/xv73867,1,1,7,9
"Carver (Raymond) family photographs",waucarverraymondph2011_011.xml,80444/xv59533,5,1,3,9
"Unknown",waureynoldsmilton1240.xml,80444/xv09851,2,1,6,9
"Unknown",wauefronsara2535.xml,80444/xv70471,3,2,4,9
"Northwest Yeshiva High School.",waunorthwestyeshivahighschool4352.xml,80444/xv05758,4,4,1,9
"Unknown",waunaitorichardhideo4011.xml,80444/xv91647,3,3,3,9
"Unknown",wauunitedfinnishkalevabrothersandsisters4927.xml,80444/xv47747,2,3,4,9
"Cavanaugh (Albert)",waucavanaughalbertb0716.xml,80444/xv92028,2,3,4,9
"Unknown",waucooneylloyd5170.xml,80444/xv22882,2,1,6,9
"Unknown",waugeithmannharriet4652.xml,80444/xv91668,2,3,4,9
"Washington Territory. Justice of the Peace Court (Pierce County).",wauwashingtonterritoryjusticeofthepeacecourt4845.xml,80444/xv36868,2,4,3,9
"Unknown",wauwashingtonstateallergysociety4185.xml,80444/xv97555,7,1,1,9
"Mazeltones (Musical group).",waumazeltones5497.xml,80444/xv66986,1,7,1,9
"University of Washington. Physical Plant Dept. South Campus Maintenance and Alterations Office.",wauuwresource00125.xml,80444/xv27133,2,2,5,9
"Unknown",waubradfordsamuelw4622.xml,80444/xv93850,2,5,2,9
"Watanabe (Honoré)",wauwatanabehonore2696.xml,80444/xv53082,2,3,4,9
"Seattle (Wash.). Building Dept.",wauseattlebuildingdept3507.xml,80444/xv86587,3,3,3,9
"University of Washington Department of Genome Sciences Records",wauuwresource05748.xml,80444/xv58630,2,4,3,9
"Unknown",waureifirm3129.xml,80444/xv55285,3,1,5,9
"Cox (Anna)",waucoxannafrye3416-001.xml,80444/xv21273,1,3,5,9
"Unknown",waumoilanenjohnw3634.xml,80444/xv00860,4,3,2,9
"Payne (Blanche)",waupayneblanchephcoll249.xml,80444/xv01248,4,5,0,9
"Unknown",waumountaineerssocietyindoordivision2887.xml,80444/xv89718,6,0,3,9
"Unknown",waumakirobert3444.xml,80444/xv89248,2,4,3,9
"Walkinshaw (Jean) Video Collection",wauwalkinshawjeanph2005_038.xml,80444/xv23019,3,3,3,9
"Robkin (M.)",waurobkinmaua5072.xml,80444/xv57705,1,2,6,9
"Unknown",waupiersonflorelloj0942.xml,80444/xv90927,1,4,4,9
"Unknown",wauswiftlouise4917.xml,80444/xv99786,1,5,3,9
"University of Washington. College of Education. Office of Graduate Information.",wauuwresource00266.xml,80444/xv84097,3,2,4,9
"University of Washington. Ocean Engineering Research Laboratory.",wauuwresource00453.xml,80444/xv38772,4,2,3,9
"Sether (Sven)",wausethersvenjohn3851.xml,80444/xv97811,2,2,5,9
"Kennedy for President . Washington State Campaign.",waukennedyforpresidentwashingtonstatecampaign2588.xml,80444/xv51925,1,3,5,9
"Unknown",waumitchellbruce2194.xml,80444/xv14755,1,3,5,9
"Louisiana Purchase Exposition (1904 : Saint Louis, Mo.).",waulouisianapurchaseexposition4268.xml,80444/xv84521,1,3,5,9
"Unknown",wauschulercarl4368.xml,80444/xv16915,2,3,4,9
"Lake Wilderness Lodge Photographs",waulakewildernesslodgeph2016_012.xml,80444/xv73022,4,4,1,9
"Unknown",waumacdonaldbettybard2344.xml,80444/xv80850,4,4,1,9
"Unknown",wauwashingtonstatemedicalsociety0030.xml,80444/xv10025,3,2,4,9
"Unknown",waunationalassociationofsocialworkersmountrainierunittacomawash2772.xml,80444/xv98287,2,3,4,9
"Schultz (Robert C.) Papers",wauschultzrobertua5981.xml,80444/xv49081,2,4,3,9
"Fancher (Ida)",waufancheridav4546.xml,80444/xv77593,3,3,3,9
"Unknown",wauamericanbaptistforeignmissionsociety4603.xml,80444/xv42639,3,1,5,9
"Unknown",waunorthwestassociationforindependentliving4244.xml,80444/xv86575,4,3,2,9
"Lucas (Mae) Opera Ephemera Collection",waulucasmae5537.xml,80444/xv98989,3,3,3,9
"Unknown",wausonsofnorwayleiferiksonlodge3875.xml,80444/xv29281,3,4,2,9
"Quintero (Carolyn)",wauquinterocarolyn2696-053.xml,80444/xv93197,1,4,4,9
"Hessel (Eugene)",wauhesseleugeneandrewua2915.xml,80444/xv65200,2,3,4,9
"University of Washington Ombud",wauuwresource00083.xml,80444/xv58532,5,1,3,9
"Unknown",waupayneclarenced0998.xml,80444/xv60818,0,3,6,9
"Unknown",waulawsonirwin2628.xml,80444/xv39617,4,1,4,9
"Unknown",waugunnarthurd3623.xml,80444/xv20614,2,4,3,9
"Unknown",waumccormackja1263.xml,80444/xv33215,2,3,4,9
"Tobey (Ed) Spanish American War Lantern Slide Collection",wautobeyedphcoll573.xml,80444/xv07443,2,3,4,9
"Vietnam Veterans Against the War, Washington-Alaska Regional Office records",wauvietnamveteransagainstthewarwashingtonalaskaregionaloffice5596.xml,80444/xv77160,2,4,3,9
"University of Washington. Retirement Association.",wauuniversityofwashingtonretirementassociationua2957.xml,80444/xv12124,1,4,4,9
"Ramstad (Emma)",wauramstademmakvindlog2423.xml,80444/xv04696,2,3,4,9
"Whitehouse (Harold C.) Architectural Projects Photographs of",wauwhitehouseharoldcphcoll439.xml,80444/xv21258,3,1,5,9
"Gloyd (F.)",waugloydfstewart0982.xml,80444/xv45333,1,2,6,9
"Savage (George)",wausavagegeorgemiltonua5131.xml,80444/xv50354,3,3,3,9
"Long (Harvey Leroy) Photograph Collection",waulongharveyleroyph2016_041.xml,80444/xv18621,5,4,0,9
"Unknown",wauandersonfamily2984.xml,80444/xv28295,4,1,4,9
"Richardson (Allan)",waurichardsonallan2696-036.xml,80444/xv20907,2,2,5,9
"Unknown",wauwhiteernest4965.xml,80444/xv35729,7,1,1,9
"Jacobsohn (Boris)",waujacobsohnborisa0708.xml,80444/xv53921,3,3,3,9
"Unknown",waunelsonmarg1184.xml,80444/xv36419,2,1,6,9
"Iler (Betty)",wauilerbettymay5639.xml,80444/xv66812,2,2,5,9
"Craine (Bessie)",waucrainebessiewilson4712.xml,80444/xv68856,3,5,1,9
"Haller (Uli)",wauhalleruli3798.xml,80444/xv02151,3,2,4,9
"Ludwig Photograph Collection",wauludwigphcoll005.xml,80444/xv31741,0,4,5,9
"Griffiths (James) & Sons Co.",waugriffiths0053.xml,80444/xv56896,1,4,4,9
"Gibson (James)",waugibsonjames1835.xml,80444/xv75494,2,3,4,9
"Unknown",wauvolandhowardm4596.xml,80444/xv21600,1,4,4,9
"Feinberg (Morris)",waufeinbergmorrisbergermary6001.xml,80444/xv24291,6,0,2,8
"University of Washington Libraries Office of Advancement records",wauuwresource00776.xml,80444/xv82223,2,4,2,8
"Hopp (Cora)",wauhoppcora3416-001.xml,80444/xv82272,0,3,5,8
"Jack Richlen Oral History",waurichlenjack5620.xml,80444/xv64227,3,2,3,8
"Unknown",wauomicronnuomicronchapter3333.xml,80444/xv26309,1,1,6,8
"Unknown",wauwashingtonstateorganizationforpublichealthnursing2439.xml,80444/xv18612,1,3,4,8
"Van Allan (Cheryl)",wauvanallancheryll3416-001.xml,80444/xv85714,1,4,3,8
"Columbia City (Seattle, Wash.).",waucolumbiacity2779.xml,80444/xv86047,1,2,5,8
"University of Washington. Nurses' Club.",wauuwresource05343.xml,80444/xv74035,2,1,5,8
"Unknown",waumetcalfwilliam5222.xml,80444/xv80752,1,3,4,8
"Unknown",wautownevernonw3042.xml,80444/xv51489,1,3,4,8
"Weaver (Eugene M.) Photographs",wauweavereugenephcoll772.xml,80444/xv26141,1,3,4,8
"University of Washington 1920s Photograph Collection",wauuwnineteentwentiesph2016_051.xml,80444/xv05200,0,0,8,8
"Davidson (Matthew)",waudavidsonmatthew2696-108.xml,80444/xv12860,2,4,2,8
"Hershberg (Joseph,)",wauhershbergmrsjoseph2995.xml,80444/xv22369,1,2,5,8
"McKaen (Maureen)",waumckaenmaureen3416-001.xml,80444/xv08312,2,3,3,8
"Unknown",wauoregon4779.xml,80444/xv72457,8,0,0,8
"Unknown",waukambakrichard3974.xml,80444/xv23959,1,2,5,8
"Unknown",waumountaineerssocietytrailtripscommittee3501.xml,80444/xv72180,4,3,1,8
"Century 21 Fiftieth Anniversary Celebration Collection ("the Next Fifty")",waucentury21fiftiethanniversarycelebration5935.xml,80444/xv23312,1,7,0,8
"Harborview Medical Center (Seattle, Wash.). Planning Dept.",wauuwresource00468.xml,80444/xv67459,4,2,2,8
"Riley (Allen)",waurileyallen2689.xml,80444/xv90243,1,2,5,8
"Halpern (Beth) Oral History",wauhalpernbeth5614.xml,80444/xv16696,1,3,4,8
"Trans-Mississippi and International Exposition (1898 : Omaha, Neb.).",wautransmississippiandinternationalexposition4776.xml,80444/xv75128,4,1,3,8
"Unknown",waucookemary3136.xml,80444/xv61410,0,3,5,8
"University of Washington. Dept. of Community Health Care Systems.",wauuwresource00420.xml,80444/xv86016,3,4,1,8
"Smith (Lenore)",wausmithlenore1097.xml,80444/xv45187,2,2,4,8
"Ichihara (Kaoru) Papers",wauichiharakaoru1839_1.xml,80444/xv50555,0,0,8,8
"Western Cooperage Company",wauwesterncooperagecompanyphcoll1335.xml,80444/xv86236,0,4,4,8
"Unknown",waulagenwilliamfamilyfilmsphcoll1207.xml,80444/xv03784,4,4,0,8
"Unknown",wauhadassahthewomenszionistorganizationofamericanorthpacificcoastregion4455.xml,80444/xv43685,2,1,5,8
"Squires (Melvina)",wausquiresmelvina2124.xml,80444/xv22625,0,2,6,8
"University of Washington. Administrative Data Processing Division. Systems Development Office.",wauuwresource00201.xml,80444/xv65554,3,3,2,8
"Brenner (Sam) Papers",waubrennersam5908.xml,80444/xv46508,6,2,0,8
"Unknown",wautacomawashdeptofpublicutilitieslightdivision0559.xml,80444/xv47299,3,1,4,8
"University of Washington Department of Aeronautics and Astronautics Records",wauuwresource00338.xml,80444/xv80899,1,2,5,8
"University of Washington. Dept. of Radiology. Digital Imaging Network System/Picture Archives Communication.",wauuwresource00402.xml,80444/xv22561,3,3,2,8
"Dodd (Stuart)",waudoddstuartcarterua1686.xml,80444/xv70266,2,4,2,8
"Tartar (Herman)",wautartarhermanvance1008.xml,80444/xv03533,1,3,4,8
"Unknown",waudeasejohnwarren4642.xml,80444/xv52572,2,6,0,8
"Rogers (John)",waurogersjohngarwood0643.xml,80444/xv22317,2,2,4,8
"University of Washington Extended MPH Degree Program Records",wauuwresource00531.xml,80444/xv83755,3,1,4,8
"Denny (Viretta)",waudennyvirettachambers4643.xml,80444/xv06921,0,3,5,8
"Unknown",wausouthwestwashingtonpudassociation0307.xml,80444/xv14059,3,2,3,8
"Unknown",waufeinberggoldie4414.xml,80444/xv56250,4,2,2,8
"Unknown",waumaccabeesclubofseattle5020.xml,80444/xv52789,6,2,0,8
"Cross (Virginia)",waucrossvirginia3416-001.xml,80444/xv64154,1,3,4,8
"Grays Harbor Regional Planning Commission (Wash.).",waugraysharborregionalplanningcommission1088.xml,80444/xv69894,0,4,4,8
"University of Washington. Medical Center. Electroencephalography Department.",wauuwresource00229.xml,80444/xv29806,1,3,4,8
"Harborview Medical Center (Seattle, Wash.). Psychiatry Dept.",wauuwresource00484.xml,80444/xv37487,3,4,1,8
"Unknown",waupacificnorthwestbirdandmammalsociety4835.xml,80444/xv69558,3,1,4,8
"National Right to Work Committee (U.S.).",waunationalrighttoworkcommittee0475.xml,80444/xv45260,1,3,4,8
"Timbers (Lawrence,)",wautimberslawrence0043.xml,80444/xv40234,1,3,4,8
"Unknown",wauturnerdorothymae3567.xml,80444/xv14874,2,0,6,8
"Unknown",waueatonwilliamg0725.xml,80444/xv06878,1,1,6,8
"Unknown",wauschenkgeorger4882.xml,80444/xv81631,1,2,5,8
"University of Washington Center for Quantitative Science in Forestry, Fisheries, and Wildlife records",wauuwresource07666.xml,80444/xv54318,4,0,4,8
"Long (William G.) Papers",waulongwilliamg5952.xml,80444/xv63568,1,1,6,8
"Unknown",waucrosstompeete4714.xml,80444/xv45471,2,2,4,8
"Parker (B.L.) Photograph Collection",wauparkerblphcoll206.xml,80444/xv74621,2,2,4,8
"University of Washington Bothell Office of the Chancellor Records",wauuwresource09257.xml,80444/xv01550,3,3,2,8
"Davisson (William)",waudavissonwilliami4639.xml,80444/xv84609,3,1,4,8
"Morgan (R.S.) Album",waumorganrsphcoll233.xml,80444/xv87597,5,2,1,8
"University of Washington, Human Services Policy Center",wauuwresource09342.xml,80444/xv43676,0,0,8,8
"Unknown",waulowercolumbiariversportsmenscouncilwashington3823.xml,80444/xv19369,5,2,1,8
"University of Washington School, of Public Health and Community Medicine, Preventative Medicine Residency Program Records",wauuwresource00459.xml,80444/xv90786,3,0,5,8
"Warner (Ruth) Photograph Album",wauwarnerruthphcoll054.xml,80444/xv31805,3,2,3,8
"Unknown",wauherzlsisterhoodseattlewash2378.xml,80444/xv74142,1,3,4,8
"Taubeneck (John) Photograph Collection",wautaubeneckjohnphcoll347.xml,80444/xv32653,2,2,4,8
"Silver (Shirley)",wausilvershirley2696-025.xml,80444/xv71325,2,2,4,8
"University of Washington. College of Arts and Sciences.",wauuwresource00272.xml,80444/xv67547,1,2,5,8
"Cugini (Norma)",waucugininormajeandenzer3416-001.xml,80444/xv75234,1,3,4,8
"Shibutani (Tamotsu,)",waushibutanitamotsu2881.xml,80444/xv97384,2,3,3,8
"Usdane (Bernice) photograph collection",wauusdanebernicephcoll1167.xml,80444/xv71060,3,3,2,8
"Wheeler (Eldridge) Papers",wauwheelereldridgeua5992.xml,80444/xv81738,6,0,2,8
"Magalnick (Joel)",waumagalnickjoel5982.xml,80444/xv98095,3,0,5,8
"Fuyo Kai (University of Washington).",wauuwresource04657.xml,80444/xv76409,3,2,3,8
"Dash (J.G.) Papers",waudashjg_ua4142.xml,80444/xv08288,1,3,4,8
"Miller (Doris)",waumillerdorisadams3416-001.xml,80444/xv46951,2,2,4,8
"Welsch (Robert)",wauwelschrobertlenhart2696-010.xml,80444/xv15673,2,3,3,8
"Unknown",wauriddleca4864.xml,80444/xv80026,1,2,5,8
"Unknown",wauseattlehoteloperatorsdomeikai1896.xml,80444/xv59454,3,0,5,8
"Helmboldt (Frederick G.) Travel Photograph Collection",wauhelmboldtfrederickgphcoll472.xml,80444/xv42550,2,1,5,8
"Unknown",waupearsondc0971.xml,80444/xv25222,0,4,4,8
"Mae (Cousin)",waucousinmae3510.xml,80444/xv52407,1,3,4,8
"Rogers (John)",waurogersjohnrankin4796.xml,80444/xv10089,1,4,3,8
"Unknown",waurichardsrichardhenry4863.xml,80444/xv45019,1,3,4,8
"Pollard (Robert)",waupollardrobertt2453.xml,80444/xv84124,1,3,4,8
"Unknown",wauwomenincommunicationsincseattleprofessionalchapter4118.xml,80444/xv48840,4,1,3,8
"Pifer (Drury) Photograph Collection",waupiferdruryphcoll145.xml,80444/xv76159,3,2,3,8
"Unknown",wauwashingtonroadsidecouncil1366.xml,80444/xv05938,2,5,1,8
"Jones (Alice) Photograph Collection",waujonesaliceph2009_033.xml,80444/xv57531,3,3,2,8
"Tiebout (Charles)",wautieboutcharlesmillsua0882.xml,80444/xv16351,0,5,3,8
"Rose (Suzanne)",waurosesuzanne2696-028.xml,80444/xv63977,2,2,4,8
"Unknown",waupeasleeenosb0630.xml,80444/xv64324,0,3,5,8
"Unknown",waualexanderanka3075.xml,80444/xv05813,2,3,3,8
"Unknown",waumillerahlsonseattlewash3240.xml,80444/xv79144,5,1,2,8
"Unknown",waupowerselizabethjane0613.xml,80444/xv89971,0,3,5,8
"Verkist (Wave)",wauverkistwavelapman3416-001.xml,80444/xv06384,3,2,3,8
"Hogness (John)",wauhognessjohnrua3352.xml,80444/xv22976,1,3,4,8
"Sherman (Albert A.) Photograph Album",waushermanalbertaph2008_047.xml,80444/xv84103,3,5,0,8
"Grondal (Florence)",waugrondalflorencearmstrong0044.xml,80444/xv92926,2,2,4,8
"Chamber of Commerce of the United States of America. National Forestry Policy Committee.",wauchamberofcommerceoftheunitedstatesofamericanationalforestrypolicycommittee3428.xml,80444/xv20129,1,3,4,8
"Unknown",wauthomsondavid0083.xml,80444/xv89013,1,3,4,8
"Busse (Doris)",waubussedorise4019.xml,80444/xv66589,3,3,2,8
"Sperry (Robert,)",wausperryrobert2561.xml,80444/xv00534,1,3,4,8
"Morhaime (Sophie) papers",waumorhaimesophie5794.xml,80444/xv69378,4,3,1,8
"Gilsdorf (Thomas) papers",waugilsdorfthomas2696-142.xml,80444/xv06695,0,6,2,8
"Coastal Puget Sound",waucoastalpugetsoundphcoll794.xml,80444/xv11447,1,1,6,8
"Unknown",wauschwabacheremilieb3403.xml,80444/xv91491,3,2,3,8
"Mixco (Mauricio)",waumixcomauricioj2696.xml,80444/xv72137,2,3,3,8
"Unknown",wauolympiaveneercoolympiawash1182.xml,80444/xv65014,0,2,6,8
"Rodgers (Jennie)",waurodgersjennieellengivler3416-001.xml,80444/xv06124,3,3,2,8
"Van Ogle (Louise)",wauvanoglelouise0886.xml,80444/xv50067,1,5,2,8
"Unknown",waufeministcoordinatingcouncil2414.xml,80444/xv71149,4,2,2,8
"Matthes (F.E.) Photographs of Mount Rainier",waumatthesfephcoll895.xml,80444/xv26953,3,3,2,8
"Tartar (Vance,)",wautartarvance4322.xml,80444/xv35101,2,3,3,8
"University of Washington. Benefits Office.",wauuwresource00200.xml,80444/xv07238,2,1,5,8
"Unknown",waunationalorganizationforwomeneastsidechapter4425.xml,80444/xv38208,2,3,3,8
"Unknown",waublockrobertj3402.xml,80444/xv51956,4,3,1,8
"Unknown",waucallcorinnebeard2724.xml,80444/xv34750,2,2,4,8
"Jones, John N.",waujonesjohnn0291.xml,80444/xv72842,1,3,4,8
"Cline (Walter)",wauclinewalterbuchanan2113.xml,80444/xv69937,0,3,5,8
"Waugh (V.)",wauwaughvc0679.xml,80444/xv17684,2,2,4,8
"University of Washington School of Medicine. Associate Dean for Academic Affairs Records",wauuwresource00372.xml,80444/xv65649,1,2,5,8
"Thrush (Loren and Donna) Photograph Album",wauthrushlorenph2009_058.xml,80444/xv41812,1,4,3,8
"Schutte (Nancy) Collection of Port Townsend and Hadlock, WA Photographs",wauschuttenancyphcoll916.xml,80444/xv14160,2,4,2,8
"Friends of the Medicinal Herb Garden (University of Washington).",waufriendsofthemedicinalherbgarden4335.xml,80444/xv77957,1,2,5,8
"Unknown",waustillaguamishcountryclub5358.xml,80444/xv24829,1,1,6,8
"Whitehorn (David,)",wauwhitehorndavid0853.xml,80444/xv53005,2,2,4,8
"Unknown",wausurvivinggenerationsoftheholocaust4172.xml,80444/xv59881,4,1,3,8
"Hoover (H.)",wauherberthooverphcoll1223.xml,80444/xv00732,3,0,5,8
"Tacoma Japanese Language School and Tacoma Hongwanji Buddhist Church",waujapaneselanguageschooltacomaphcoll1020.xml,80444/xv27655,2,3,3,8
"United States Boundary Survey Photograph Collection",wauunitedstatesboundarysurveyphcoll462.xml,80444/xv17984,2,3,3,8
"Unknown",waudurantstudyclubseattlewash3822.xml,80444/xv68008,2,2,4,8
"Unknown",waugarcia-vegamichelle5756.xml,80444/xv82580,2,3,3,8
"Unknown",waumaxsonlouish3896.xml,80444/xv35388,0,4,4,8
"Unknown",waukiddja4768.xml,80444/xv57037,4,2,2,8
"Slade (Mary)",wauslademarygoodwin3416-001.xml,80444/xv77407,2,3,3,8
"Xiao (Gongquan,)",wauxiaogongquanua1140_2084_3014.xml,80444/xv41143,6,1,1,8
"Unknown",wauwestbergvirginia2475.xml,80444/xv73956,1,4,3,8
"Torgerson (Ruth)",wautorgersonruth3416-001.xml,80444/xv34579,1,3,4,8
"Watkins (Charles)",wauwatkinscharlesaua2043.xml,80444/xv35006,1,4,3,8
"Unknown",wauhaimanlewis1607.xml,80444/xv96340,1,3,4,8
"Rognon (Orville J.) Alaska-Yukon-Pacific Exposition Photographs",waurognonorvilleaypephcoll779.xml,80444/xv01876,3,4,1,8
"Unknown",waugroutjames0457.xml,80444/xv34274,3,1,4,8
"Zimmer (Julia)",wauzimmerjuliaj2696-103.xml,80444/xv20986,2,3,3,8
"University of Washington. Medical Center. Internal Audit Office.",wauuwresource00214.xml,80444/xv77316,2,3,3,8
"Thomas (John)",wauthomasjohntlishal2696-027.xml,80444/xv95092,0,4,4,8
"Seattle Art Museum expansion architectural drawings and models",wauseattleartmuseumarchphcoll1196.xml,80444/xv39218,1,3,4,8
"Unknown",wauzemagene4485.xml,80444/xv07327,4,2,2,8
"Unknown",waumountaineerssocietyjuniors5013.xml,80444/xv40780,2,2,4,8
"Unknown",wautemplebethoreverettwash3926.xml,80444/xv25405,2,4,2,8
"Jackson (Sara)",waujacksonsarao3416-001.xml,80444/xv25228,2,1,5,8
"Parrington (Vernon Louis) Photograph Collection",wauparringtonvernonlouisph2016_046.xml,80444/xv57647,0,6,2,8
"Censorship Undermines Radio Station Ethics (CURSE) records",waucensorshipunderminesradiostationethics6015.xml,80444/xv63583,0,4,4,8
"Unknown",waupugetsoundacademyofophthalmologyandotolaryngology3920.xml,80444/xv52590,5,2,1,8
"University of Washington. Dept. of Psychiatry and Behavioral Sciences. Community Psychiatry Division.",wauuwresource00409.xml,80444/xv23104,4,3,1,8
"Feldman (Edward L.) Papers and Ephemera",waufeldmanedward5914.xml,80444/xv07067,0,0,8,8
"Unknown",waurusselljervis2002.xml,80444/xv84033,2,2,4,8
"Unknown",waumountaineerssocietytrusteesboard2892.xml,80444/xv57080,5,2,1,8
"Fay (John)",waufayjohnp4648.xml,80444/xv01821,1,2,5,8
"Chittick (V.)",wauchittickvloua2028.xml,80444/xv03713,3,3,2,8
"Boatner (Haydon)",wauboatnerhaydonl1737.xml,80444/xv00555,3,2,3,8
"Unknown",wauparkerhubbardgeorge4417.xml,80444/xv00744,1,3,4,8
"Farris (Linda)",waufarrislinda2732_2762.xml,80444/xv65512,3,3,2,8
"Schwarz (M.)",wauschwarzmroyua4139.xml,80444/xv11758,2,2,4,8
"Kobelt (Ernest)",waukobelternestphcoll1219.xml,80444/xv77178,5,2,1,8
"Unknown",wauglickmanjeanettehorowitz2822.xml,80444/xv99618,3,2,3,8
"University of Washington. Academic Publications Office.",wauuwresource00118.xml,80444/xv40316,0,3,5,8
"Kerry (Albert Sperry)",waukerryalbertsperryphcoll820.xml,80444/xv63323,8,0,0,8
"Washington (State). Governor. Asian American Advisory Council.",wauwashingtonasianamericanadvisorycouncil2151.xml,80444/xv30154,1,3,4,8
"University of Washington. Capital and Space Planning Office.",wauuwresource00100.xml,80444/xv45394,3,3,2,8
"Boy Scouts of America. Troop 46 (Seattle, Wash.).",wauboyscoutsofamericatroop46_4413.xml,80444/xv98425,1,3,4,8
"Unknown",waujewishwarveteransoftheunitedstatesofamericapostseattlewash3256.xml,80444/xv81539,7,1,0,8
"Unknown",waumcfarlanleehorace4329.xml,80444/xv98681,2,4,2,8
"Newton (Alice)",waunewtonaliceshale3416-001.xml,80444/xv72644,2,3,3,8
"Unknown",wauortmandavide5279.xml,80444/xv77856,3,3,2,8
"Hidy (Ralph)",wauhidyralphw3984.xml,80444/xv23760,2,2,4,8
"Unknown",waujapanesepresbyterianchurchseattlewash4853.xml,80444/xv15310,2,2,4,8
""Muchos y Buenos" Radio Broadcast and News Release",waumuchosybuenos5969.xml,80444/xv89862,3,2,3,8
"Unknown",waudunnjohn4722.xml,80444/xv14901,3,2,3,8
"Toyo Studio Photographs of the Tanaka School of Dressmaking",wautoyostudiotanakadressmakingph2009_017.xml,80444/xv09484,2,2,4,8
"Forbes (Stuart) Photograph Collection",wauforbesstuartphcoll148.xml,80444/xv39822,1,3,4,8
"Goren (Harold)",waugorenharold0809.xml,80444/xv49377,2,3,3,8
"Shay (Alban) Photograph Collection",waushayalbanphcoll342.xml,80444/xv49063,0,3,5,8
"Pasco (Duane) Correspondence with Barbara Winther",waupascoduane6007.xml,80444/xv04296,5,3,0,8
"Bouchard (Randy)",waubouchardrandy1835.xml,80444/xv37841,1,2,5,8
"Works Progress Administration Artists Photograph Collection",wauworksprogressadministrationartistsphcoll571.xml,80444/xv08456,2,2,4,8
"Unknown",wausimpsonlumbercompany4894.xml,80444/xv38085,6,1,0,7
"Richards Studio Album of St. Regis Paper Company",waurichardsstudioregispaperalbumphcoll1181.xml,80444/xv63873,3,2,2,7
"Panama Pacific International Exposition and Panama-California Exposition Photograph Album",waupanamapacificinternationalexpophcoll201.xml,80444/xv90039,3,3,1,7
"Unknown",waunakkerudted2232.xml,80444/xv95126,2,3,2,7
"Unknown",waufoltzlauraa2625.xml,80444/xv80517,2,2,3,7
"Historic American Buildings Survey No. WA-197 (Fox Theatre) Collection",waufoxtheatrephcoll386.xml,80444/xv20870,5,2,0,7
"Northwest Council of Camera Clubs records",waunorthwestcouncilcameraclubs5731.xml,80444/xv82608,1,3,3,7
"Trail Blazers (Organization).",wautrailblazers4259.xml,80444/xv40191,3,2,2,7
"Touchie (Bernice)",wautouchiebernice2696-002.xml,80444/xv81076,0,2,5,7
"Unknown",wauschwantescarlosa2619.xml,80444/xv55422,2,2,3,7
"Williston (Frank)",wauwillistonfrankgoodman0715.xml,80444/xv26104,0,3,4,7
"Joel Dunham Linguistic Field Research on Douglas Lake Okanagan.",waudunhamjoel2696.xml,80444/xv89041,0,3,4,7
"Carte-de-visite and Tintype Photograph Collection",waucarte-de-visiteandtintypephcoll1034.xml,80444/xv25329,0,0,7,7
"Unknown",waurhodessurvivorsaidcommitteeseattlewash4002.xml,80444/xv29013,2,2,3,7
"Wilson (Veazie) Photographs",wauwilsonveaziephcoll311.xml,80444/xv81176,2,1,4,7
"Harborview Medical Center (Seattle, Wash.). Airlift Northwest.",wauuwresource00469.xml,80444/xv18637,1,2,4,7
"University of Washington. Dept. of Medicine.",wauuwresource00390.xml,80444/xv38140,1,3,3,7
"Seattle-Kobe Affiliation Committee (Seattle, Wash.).",wauseattlekobeaffiliationcommittee1099_1290.xml,80444/xv56112,1,3,3,7
"Matsushita",waumatsushitaiwaofilmsphcoll823.xml,80444/xv43035,2,3,2,7
"Powell (J.)",waupowelljv1835.xml,80444/xv97277,1,2,4,7
"Moore (Miles)",waumooremilesconway0128.xml,80444/xv79254,1,1,5,7
"Unknown",waumcgivernpeterj3887.xml,80444/xv54742,0,5,2,7
"Thompson (John)",wauthompsonjohnw4332.xml,80444/xv41772,1,1,5,7
"Burke (Helen)",wauburkehelenua1466.xml,80444/xv75387,1,3,3,7
"Seder (Jean) papers",wausederjean5938.xml,80444/xv30261,0,0,7,7
"Delvau (Alfred,)",waudelvaualfred0026.xml,80444/xv42828,1,3,3,7
"Mohrer (Betty)",waumohrerbetty3899.xml,80444/xv17687,3,2,2,7
"Jeffery (C.)",waujefferycj0832.xml,80444/xv59729,0,4,3,7
"Raybourn (Carole)",wauraybourncarolea2696.xml,80444/xv14541,1,3,3,7
"Unknown",wauhaymarione4751.xml,80444/xv36798,3,2,2,7
"Carroll (A.P.) Photographs",waucarrollalvinpercyphcoll1351.xml,80444/xv39102,0,0,7,7
"Wataridori: Birds of Passage",wauwataridoriphcoll987.xml,80444/xv05169,0,1,6,7
"Seattle Chamber of Commerce. State Development Dept.",wauseattlechamberofcommercestatedevelopmentdept3708.xml,80444/xv83255,0,2,5,7
"Goldmark (John)",waugoldmarkjohn1421.xml,80444/xv58474,0,2,5,7
"Jewish Community Center, North End Branch Photograph Collection",waujccnorthendbranchphcoll1072.xml,80444/xv67739,3,2,2,7
"Kolloen (Peter) collection",waukolloenpetercollection6027.xml,80444/xv68481,0,0,7,7
"Seaburg (William)",wauseaburgwilliamr1835_2696-004.xml,80444/xv70608,6,0,1,7
"University of Washington. Biology Program.",wauuwresource00311.xml,80444/xv18286,0,3,4,7
"Portland Central America Solidarity Committee records",wauportlandcentralamericasolidaritycommittee5632.xml,80444/xv09350,5,2,0,7
"Miller (William Ward) Slides of Washington State",waumillerwilliamslidesphcoll1401.xml,80444/xv65646,6,1,0,7
"Oppenheimer (Walter) papers",wauoppenheimerwalter5844.xml,80444/xv79067,2,2,3,7
"Unknown",wauuwresource07288.xml,80444/xv53146,1,1,5,7
"Gerberding (William P.)",waugerberdingwpphcoll1369.xml,80444/xv85476,3,4,0,7
"Roseman (Lawrence J.) Papers",waurosemanlawrencej6008.xml,80444/xv24972,0,7,0,7
"McMinn (Bryan)",waumcminnbryantua3319.xml,80444/xv56539,1,2,4,7
"Unknown",waudanishbrotherhood1953.xml,80444/xv32500,2,3,2,7
"Seattle Coterie Photograph Collection",waucoteriephcoll447.xml,80444/xv51229,0,1,6,7
"Unknown",wauwalshedwardf4946.xml,80444/xv64331,3,1,3,7
"Cook (Peggy)",waucookpeggy3416-001.xml,80444/xv28378,1,0,6,7
"Health Sciences Library and Information Center",wauuwresource07713.xml,80444/xv10073,0,0,7,7
"Unknown",waumauermannmaryanne4357.xml,80444/xv76925,0,1,6,7
"Unknown",wauunderstandinginc1687.xml,80444/xv51928,1,0,6,7
"Burns (Michael,)",wauburnsmichael3443.xml,80444/xv86428,2,4,1,7
"Unknown",wauhsbellefamily4606.xml,80444/xv58575,1,3,3,7
"University of Washington. University Police.",wauuwresource00135.xml,80444/xv12911,0,1,6,7
"Bigelow (Charles)",waubigelowcharlesa2696-017.xml,80444/xv87091,1,2,4,7
"University of Washington Album 3",wauuniversityofwashingtonalbum3phcoll115.xml,80444/xv47875,1,2,4,7
"Unknown",wausouthislandjewishcenterofmercerisland4374.xml,80444/xv91891,2,2,3,7
"Hodges (Leander)",wauhodgesleanderl4663.xml,80444/xv69824,1,3,3,7
"Clifford (Howard) Photograph Collection",waucliffordhowardphcoll1178.xml,80444/xv20080,7,0,0,7
"National Environmental Satellite, Data, and Information Service Collection of Mount St. Helens Photographs",waunesdisphcoll613.xml,80444/xv28052,1,0,6,7
"Unknown",wauslipperjohnh0739.xml,80444/xv75158,1,2,4,7
"Unknown",wauseattlecivilianwarcommission1843.xml,80444/xv54553,1,3,3,7
"Taber (Gisela)",wautabergisela5505.xml,80444/xv30068,1,3,3,7
"Unknown",wausamuelbendelstheatricalacademy2871.xml,80444/xv98171,3,1,3,7
"Unknown",waukatsmanbaruch2977.xml,80444/xv20257,5,2,0,7
"White (Thomas)",wauwhitethomastaylor1890.xml,80444/xv98019,1,3,3,7
"Unknown",waugorhamwmh4658.xml,80444/xv87100,5,0,2,7
"Unknown",wausternbarrye3866.xml,80444/xv92755,2,2,3,7
"Unknown",waueldredgewilliamw0010.xml,80444/xv10656,3,3,1,7
"University of Washington Department of Romance Languages and Literature Records",wauuwresource00296.xml,80444/xv25015,0,4,3,7
"Unknown",waujapanesecongregationalchurchseattlewash2107.xml,80444/xv09426,4,3,0,7
"Baron (Akesha) papers",waubaronakesha2696-140.xml,80444/xv88879,1,0,6,7
"Unknown",wausocietyofamericanforesterspugetsoundsection1040.xml,80444/xv29248,3,2,2,7
"Unknown",waugoodglicksamuel2831.xml,80444/xv26586,3,2,2,7
"Gorilla Gone Wild",waugorillagonewildfilmphcoll1116.xml,80444/xv90426,4,0,3,7
"Unknown",wauvestkystensnordmorslag4540.xml,80444/xv41894,1,3,3,7
"Taft (President William H.) Photographs of",wautaftpresidentwilliamhphcoll735.xml,80444/xv97314,2,2,3,7
"Hasler (Bruce)",wauhaslerbruce2393.xml,80444/xv50048,0,3,4,7
"Rosen (H.)",waurosenh3493.xml,80444/xv21859,1,1,5,7
"Unknown",wauweilrosalindbornstein4092.xml,80444/xv88894,2,2,3,7
"University of Washington. Retired Staff Members' Association.",wauuwresource05351.xml,80444/xv65023,2,3,2,7
"Unknown",waumurphyrichardh4829.xml,80444/xv82376,1,2,4,7
"Unknown",waumillerroberte3513.xml,80444/xv39801,3,3,1,7
"Unknown",wauraabirvingt2489.xml,80444/xv46640,2,1,4,7
"Unknown",waudobbbartley5235.xml,80444/xv18267,1,2,4,7
"Unknown",waujacksonforpresidentcommitteeny5314.xml,80444/xv93298,2,1,4,7
"Varey (Gordon)",wauvareygordonbua4506.xml,80444/xv54849,0,3,4,7
"Thomas (Peter) Papers",wauthomaspeter5758.xml,80444/xv77600,2,1,4,7
"University of Washington. College of Forest Resources. Division of Ecosystem Science and Conservation.",wauuwresource00344.xml,80444/xv06085,0,3,4,7
"Garrick (James S.) Photograph Album",waugarrickjamessphcoll060.xml,80444/xv80218,0,2,5,7
"Civil War Photograph Collection",waucivilwarphotographsphcoll1378.xml,80444/xv24645,4,3,0,7
"Cressey (Paul)",waucresseypaulfphcoll943.xml,80444/xv39608,5,0,2,7
"Wartnik (Anthony,)",wauwartnikanthony5461.xml,80444/xv86141,2,2,3,7
"Unknown",wauhoffmanal3902.xml,80444/xv87173,1,1,5,7
"Phillips (Rita)",wauphillipsrita2539.xml,80444/xv12142,1,3,3,7
"Samuels (David)",wausamuelsdavidwilliam2696.xml,80444/xv85043,2,3,2,7
"Unknown",waufickettfredwildon3709.xml,80444/xv63803,3,2,2,7
"National Association for the Advancement of Colored People, Seattle Branch, Photograph Collection",waunaacpseattlephcoll1391.xml,80444/xv01245,1,3,3,7
"University of Washington Libraries. Library Operations Group Records",wauuwresource05682.xml,80444/xv40783,1,2,4,7
"Moore (Robert)",waumooreroberte2696-050.xml,80444/xv49420,2,1,4,7
"Unknown",waucharlesandemmafryeartmuseum4520.xml,80444/xv48425,1,4,2,7
"University of Washington. Childcare Coordinators Office.",wauuwresource00151.xml,80444/xv52365,1,1,5,7
"Unknown",waustephensmaryc1276.xml,80444/xv22003,0,2,5,7
"Washington Poets Association Records",wauwashingtonpoetsassociation6000.xml,80444/xv62850,7,0,0,7
"Randlett (Mary) Papers",waurandlettmary6005.xml,80444/xv28747,0,0,7,7
"Strong (John)",waustrongjohn1418.xml,80444/xv53793,2,4,1,7
"Unknown",wauwolfstonemichael4978.xml,80444/xv59313,1,3,3,7
"Unknown",waupocockstanleyrichard4310.xml,80444/xv88763,0,6,1,7
"Unknown",waumoorewilliamd4825.xml,80444/xv18081,3,2,2,7
"Washington State Nautical School Records",wauwashingtonstatenauticalschool5934.xml,80444/xv42950,1,4,2,7
"Washington Environmental Foundation.",wauwashingtonenvironmentalfoundation5384.xml,80444/xv48785,1,3,3,7
"Synnestvedt (Harald) papers",wausynnestvedtharald6003.xml,80444/xv27468,7,0,0,7
"Unknown",waustevensjackd0648.xml,80444/xv49230,1,3,3,7
"Ruegnitz (W.C.) Collection of McCloud River Lumber Company and Port Gamble Photographs",waumccloudriverlumbercophcoll1029.xml,80444/xv83242,2,1,4,7
"Hyman (Harold)",wauhymanharoldmelvin0351.xml,80444/xv61584,1,3,3,7
"Scantland (Anna)",wauscantlandannacecile3060.xml,80444/xv20837,0,4,3,7
"Unknown",wautemplebethisraeltacomawash2155.xml,80444/xv51058,4,0,3,7
"Allen (Al) Collection on the International Lonshore and Warehouse Union",wauallenintllongshorewarehouseunion6028.xml,80444/xv17388,0,0,7,7
"University of Washington. Class of 1916.",wauuwresource03180.xml,80444/xv82864,0,2,5,7
"Eckstein (Nathan) Photograph Collection",wauecksteinnathanphcoll749.xml,80444/xv79110,2,2,3,7
"Western Ski Promotions Photograph Collection",wauwesternskipromotionsph2015_015.xml,80444/xv63818,3,2,2,7
"Unknown",wausparkmanmargaret4150.xml,80444/xv30737,1,1,5,7
"Citizens for Referendum 19 -- S.J.R. 17.",waucitizensforreferendum4633.xml,80444/xv70989,1,1,5,7
"Shorter (David)",waushorterdavidallen2696-122.xml,80444/xv22015,1,3,3,7
"Pacific Lumber Inspection Bureau.",waupacificlumberinspectionbureau0297.xml,80444/xv26611,0,2,5,7
"Unknown",wauowingsnicholash4780.xml,80444/xv65975,3,1,3,7
"Harborview Medical Center, Board of Trustees Records",wauuwresource05665.xml,80444/xv78305,2,0,5,7
"Student Nonviolent Coordinating Committee (University of Washington). Friends.",waustudentnonviolentcoordinatingcommittee0677.xml,80444/xv37384,3,2,2,7
"Unknown",waumontlertimothy3018.xml,80444/xv96588,1,2,4,7
"Unknown",waunorthwestguarantyloancompany4833.xml,80444/xv83645,2,2,3,7
"Orcas Island YMCA Camp Photograph Collection",wauorcasislandcampphcoll1195.xml,80444/xv09439,1,3,3,7
"Watkins (Vernon)",wauwatkinsvernonphillipsua2935.xml,80444/xv12585,0,3,4,7
"Thal (Sidney)",wauthalsidney5456.xml,80444/xv73062,2,2,3,7
"Unknown",waurigsbybruce3797.xml,80444/xv75360,0,3,4,7
"Unknown",waututtlerobert4183.xml,80444/xv60552,3,2,2,7
"Woodbury (Anthony)",wauwoodburyanthonyc2696-020.xml,80444/xv68737,2,1,4,7
"Unknown",waumountaineerssocietypropertiesdivision2888.xml,80444/xv15472,3,2,2,7
"Unknown",wauwillnerfamily2493.xml,80444/xv63317,1,2,4,7
"Unknown",waubetaalphapsideltachapteruniverstiyofwashington4103.xml,80444/xv34637,1,3,3,7
"Johnson (Ralph)",waujohnsonralphwhitneyua2320.xml,80444/xv87872,2,3,2,7
"Levine (Leo)",waulevineleo3218.xml,80444/xv52526,4,2,1,7
"Unknown",waunelsongeraldb3891.xml,80444/xv04147,1,2,4,7
"Tacoma Narrows Bridge Construction Home Movie",wautacomanarrowsbridgeconstructionphcoll837.xml,80444/xv11074,1,4,2,7
"Crabshell Alliance Records",waucrabshellalliance5931.xml,80444/xv61294,2,0,5,7
"University of Washington. Office of Development. Associate Director of Annual Giving.",wauuwresource00138.xml,80444/xv53805,2,2,3,7
"Unknown",waustroumsamuel3519.xml,80444/xv75317,1,2,4,7
"Unknown",wauweissphilj4476.xml,80444/xv70306,2,3,2,7
"Drebin (Harold) Papers",waudrebinharold5993.xml,80444/xv15243,5,0,2,7
"Barokas (Kathie Alhadeff) Papers",waubarokaskathiealhadeff5920.xml,80444/xv04910,3,0,4,7
"Unknown",waumaimonfamily3164.xml,80444/xv94949,3,2,2,7
"Unknown",wauturcofrank0752.xml,80444/xv77877,1,2,4,7
"Gormley Family Photograph Collection",waugormleyfamilyphcoll225.xml,80444/xv06594,3,1,3,7
"Unknown",wauhebrewshelteringandimmigrantaidsocietyofamerica3409.xml,80444/xv43447,5,2,0,7
"Unknown",waudanishevangelicallutheranchurchinamericapugetsounddistrict2722.xml,80444/xv77590,2,2,3,7
"Kramer (Gideon A.) Papers",waukramergideon6006.xml,80444/xv14117,5,2,0,7
"Unknown",wauhillnaomiherren4272.xml,80444/xv66076,1,2,4,7
"Unknown",waunorthwestcommitteeagainstrepressivelegislation3446.xml,80444/xv70422,0,2,5,7
"Unknown",waumoorewilliamhickman4826.xml,80444/xv04873,1,3,3,7
"Unknown",waumacdonaldstevenc4593.xml,80444/xv61663,2,2,3,7
"Unknown",wauunitedstatesbureauofindianaffairsagencyforthepuyallupnisquallyandotherindiantribes4933.xml,80444/xv09078,0,4,3,7
"Unknown",waucurrieian4539.xml,80444/xv16751,2,2,3,7
"Harrington (Donal)",wauharringtondonal4260.xml,80444/xv12725,1,3,3,7
"Purcell (Abbie Ann Stimson) Photographs",waupurcellabbieannstimsonph2012_004.xml,80444/xv84271,4,1,2,7
"Roberts (John O.) Photograph and Ephemera Collection",waurobertsjohnph2016_030.xml,80444/xv17886,4,0,3,7
"Unknown",waugardnerpearlgreenberg3526.xml,80444/xv06103,0,3,4,7
"Unknown",wauburnetthc5237.xml,80444/xv06527,2,3,2,7
"Storey (Ellsworth P.) photgraph album",waustoreyellsworthph2016_006.xml,80444/xv66421,3,2,2,7
"Unknown",wautaylorirene3232.xml,80444/xv64746,5,1,1,7
"American Society for Engineering Education. Annual Meeting (1950 : University of Washington).",wauamericansocietyforengineeringeducationannualmeeting5064.xml,80444/xv26107,2,1,4,7
"Unknown",wauwilliamsanneseidelhuber3521.xml,80444/xv98788,0,7,0,7
"University of Washington Alumni Reunion Photograph Collection",wauuwalumnireunionalbumphcoll363.xml,80444/xv86709,2,4,1,7
"Rock (Joseph F.) Ethnographic and Exploration Films",wau_waseumc_uwemc.xml,80444/xv60098,5,2,0,7
"Swank (Doug) Photographs",wauswankdougph2015_018.xml,80444/xv86459,7,0,0,7
"Unknown",wauwarnerarthurchurchill0377.xml,80444/xv45214,2,4,1,7
"Uyeda family",wauuyedafamily3994.xml,80444/xv30145,2,2,3,7
"Dracos (Ted) Photographs",waudracostedph2016_021.xml,80444/xv72650,4,0,3,7
"Garretson (Herman John, Jr.)",waugarretsonhermanjohnjr5946.xml,80444/xv75369,0,2,5,7
"Odegaard Undergraduate Library Records",wauuwresource09350.xml,80444/xv89239,0,0,6,6
"Unknown",waujapanesechristianchurchfederationseattlewash4438.xml,80444/xv25253,3,2,1,6
"University of Washington, School of Medicine, Office of the Associate Dean for Scientific Affairs Records",wauuwresource07732.xml,80444/xv64675,2,2,2,6
"Unknown",wauuwresource00185.xml,80444/xv30404,4,2,0,6
"Cushman (F.)",waucushmanairplanecrashphcoll1394.xml,80444/xv40664,0,0,6,6
"University of Washington Puppeteers Photograph Album",wauuwpuppeteersph2016_058.xml,80444/xv69549,0,0,6,6
"University of Washington Human Subjects Division Records",wauuwresource00183.xml,80444/xv49462,4,2,0,6
"Unknown",wauwashingtonstateinternationalmarketingconference3328.xml,80444/xv46063,1,0,5,6
"Ames Family (Margaret Beckman) Photograph Collection",wauamesmargaretbeckmanphcoll1399.xml,80444/xv02236,0,0,6,6
"Clagett (Fred) Papers",wauclagettfred3543.xml,80444/xv88587,3,3,0,6
"Strong (Anna Louise) camera and slide collection",waustrongannalouiseph2015_007.xml,80444/xv64822,1,2,3,6
"Central Committee for Conscientious Objectors. Western Regional Office.",waucentralcommitteeforconscientiousobjectorswesternregionaloffice1666.xml,80444/xv83929,1,2,3,6
"Universal Plan Service Architectural Drawings",wauuniversalplanserviceph2015_029.xml,80444/xv17416,2,2,2,6
"Unknown",waunomealaskaphcoll602.xml,80444/xv32840,0,4,2,6
"Unknown",wauwashingtonosteopathicmedicalassociation3227.xml,80444/xv06381,1,0,5,6
"Benedetti (Umberto)",waubenedettiumberto4545.xml,80444/xv87237,5,0,1,6
"Rodenhouse (Irma Z.) Travel Slides",waurodenhouseirmaph2016_015.xml,80444/xv59722,2,1,3,6
"Richardson (Frank,)",waurichardsonfrankua4135.xml,80444/xv08087,1,2,3,6
"Unknown",waufeinberghyman3735.xml,80444/xv12203,4,0,2,6
"Ziontz (Al) Photographs",wauziontzalph2016_043.xml,80444/xv04562,0,0,6,6
"Lynch (Judge)",waujudgelynch2405.xml,80444/xv95254,3,1,2,6
"University of Washington. Physical Plant Dept. Records Section.",wauuwresource00126.xml,80444/xv40933,1,2,3,6
"Unknown",waugalvinmike3612.xml,80444/xv91580,0,2,4,6
"Unknown",wauzakmarian5278.xml,80444/xv06195,2,2,2,6
"French (Kathrine)",waufrenchkathrines2696-048.xml,80444/xv58279,1,3,2,6
"Ripley (Herbert)",wauripleyherbertsua2710.xml,80444/xv99072,1,3,2,6
"University of Washington 1908 Football and Men and Women's Crew Team Photographs",wauuw1908footballandcrewph2016_038.xml,80444/xv52746,5,0,1,6
"University of Washington. Medical Center. Admitting Dept.",wauuwresource00220.xml,80444/xv52655,0,2,4,6
"Yarnell (Ron)",wauyarnellron2981.xml,80444/xv83526,1,2,3,6
"University of Washington American Indian Studies Program Records",wauuwresource09343.xml,80444/xv55258,0,0,6,6
"Unknown",wauthomasnancyc4088.xml,80444/xv50424,3,2,1,6
"Unknown",waukellergeorgem3151.xml,80444/xv96566,1,2,3,6
"University of Washington. Medical Center. Medical Records Department.",wauuwresource00212.xml,80444/xv83682,0,1,5,6
"Rudin (Catherine,)",waurudincatherine2696.xml,80444/xv24194,2,2,2,6
"Haas (Kate) biography of Gerda Buchheim Haas",wauhaaskate5955.xml,80444/xv73074,0,2,4,6
"Meikle (William)",waumeiklewilliamph2016_039.xml,80444/xv93978,6,0,0,6
"Unknown",waudearingstclair4641.xml,80444/xv40502,2,0,4,6
"Hamblin (Ken) Photographs",wauhamblinkenph2016_057.xml,80444/xv21643,0,0,6,6
"Unknown",wauwilbourvsgallagher1531.xml,80444/xv05224,5,1,0,6
"Unknown",wauuwresource07357.xml,80444/xv03411,0,2,4,6
"Unknown",waureevesbelleculp0782.xml,80444/xv71945,1,4,1,6
"Gray (Harold)",waugrayharold5468.xml,80444/xv39489,1,2,3,6
"Fisher (Eula)",waufishereulap3416-001.xml,80444/xv56671,3,1,2,6
"Morton (Bernice) Photograph Collection",waumortonbernicephcoll228.xml,80444/xv05880,2,3,1,6
"Kusakovich (Theodore) papers",waukusakovichtheodore6014.xml,80444/xv53759,0,6,0,6
"Unknown",wauwomensinternationalleagueforpeaceandfreedomseattlebranch3615.xml,80444/xv98854,3,2,1,6
"Unknown",wausorianolouis2745.xml,80444/xv68194,5,0,1,6
"Unknown",wauuniversitydistrictcommunitycouncil4254.xml,80444/xv88562,2,2,2,6
"Unknown",wauricklesmona3707.xml,80444/xv58737,1,2,3,6
"Walsh (Linda)",wauwalshlindag2696-059.xml,80444/xv53164,1,2,3,6
"Hara Family Papers",wauharafamily5917.xml,80444/xv47991,4,0,2,6
"United States. Army. Washington Territorial Volunteers.",wauunitedstatesarmywashingtonterritorialvolunteers0065_2294_2721.xml,80444/xv75744,5,0,1,6
"Livingston (Ellen)",waulivingstonellenbarbara2696-051.xml,80444/xv15966,1,2,3,6
"Patton (Harry)",waupattonharryd19ua2714_5009.xml,80444/xv49444,1,3,2,6
"Swayze (E.)",wauswayzeeharoldua4316.xml,80444/xv67782,4,2,0,6
"United States Reclamation Service.",wauunitedstatesreclamationservice4028.xml,80444/xv29104,0,1,5,6
"Unknown",wautreigerbettylou5326.xml,80444/xv57797,3,0,3,6
"Magnusson (Carl E.) Papers",waumagnussoncarlua1793.xml,80444/xv96716,1,0,5,6
"Rorrison (Esther)",waurorrisonesthersimonds3416-001.xml,80444/xv04598,1,3,2,6
"Nippon Kan Theatre Photograph Collection",waunipponkantheaterphcoll508.xml,80444/xv98635,2,0,4,6
"University of Washington. Medical Center. Emergency Medicine Services.",wauuwresource00230.xml,80444/xv82678,1,1,4,6
"Mihas (Elena) papers",waumihaselena2696_144.xml,80444/xv55822,0,0,6,6
"McCaffrey (Frank,)",waumccaffreyfrank4194.xml,80444/xv05383,3,1,2,6
"American Historical Society. Pacific Coast Branch. Meeting (21st : 1925 : University of Washington).",wauamericanhistoricalsocietypacificcoastbranchmeeting4557.xml,80444/xv64892,2,2,2,6
"Jacobs (Elizabeth)",waujacobselizabethderr3416-001.xml,80444/xv49688,2,2,2,6
"Unknown",waupacificcoastmaritimeindustryboard3862.xml,80444/xv32244,0,3,3,6
"Unknown",waupnwartsorganizationsandartists6011.xml,80444/xv38061,0,3,3,6
"Filipino Alumni Association (University of Washington).",waufilipinoalumniassociation5137.xml,80444/xv54977,1,2,3,6
"University of Washington Dean of Men Records",wauuwresource09351.xml,80444/xv01367,0,0,6,6
"Mignon (Edmond) Music Manuscripts",waumignonedmondua5980.xml,80444/xv67932,4,0,2,6
"Committee For Washington Tax Reform.",waucommitteeforwashingtontaxreform0895.xml,80444/xv88449,0,3,3,6
"University of Washington. Class of 1925.",wauuwresource04611.xml,80444/xv16174,1,3,2,6
"Berkeley (Katherine)",wauberkeleykatherinesheldon3416-001.xml,80444/xv92813,2,2,2,6
"Beardsley (Arthur)",waubeardsleyarthursua2920.xml,80444/xv40499,3,1,2,6
"Wyllie (Jim) papers",wauwylliejim6022.xml,80444/xv23144,0,0,6,6
"MacKay (R.E.) Papers",waumackayre5640.xml,80444/xv19699,1,3,2,6
"Warshal (Dennis) Oral History Interview",wauwarshaldennis5965.xml,80444/xv39151,2,0,4,6
"Harborview Medical Center (Seattle, Wash.). Obstetrics and Gynecology Dept.",wauuwresource00480.xml,80444/xv12570,3,1,2,6
"Stone (Edward)",waustoneedward5519.xml,80444/xv28955,1,2,3,6
"Unknown",waublockhenrietta3217.xml,80444/xv12594,3,0,3,6
"Hartshorn (Florence)",wauhartshornflorencephcoll1354.xml,80444/xv41757,1,1,4,6
"Tamarin (Arnold)",wautamarinarnoldua3399.xml,80444/xv55969,0,4,2,6
"Unknown",waustrongeva4913.xml,80444/xv28887,5,0,1,6
"Unknown",wauleipzigmarwayne3749.xml,80444/xv57373,2,2,2,6
"Unknown",wauoffertherese2470.xml,80444/xv54232,1,0,5,6
"Unknown",wauandersonandrewa3951.xml,80444/xv53628,2,1,3,6
"Unknown",wauhelpinghandsociety4754.xml,80444/xv30078,2,2,2,6
"Eggleston (Esther) Papers",wauegglestonesther5988.xml,80444/xv19229,0,0,6,6
"Koran",waukoranprayers0743.xml,80444/xv93588,1,1,4,6
"Wilson (Katherine)",wauwilsonkatherine0538.xml,80444/xv47283,2,2,2,6
"Unknown",wauheathjean3831.xml,80444/xv41818,1,1,4,6
"Unknown",wauseattlekollel4406.xml,80444/xv11029,5,1,0,6
"Teller (Davida) Papers",wautellerdavidaua2410.xml,80444/xv17355,2,1,3,6
"New Dimensions in Music (Organization : Seattle, Wash.).",waunewdimensionsinmusic1544.xml,80444/xv51898,1,4,1,6
"Diet.",waudiet4253.xml,80444/xv70346,3,3,0,6
"Moe (Roger E.) Papers",waumoerogerua6024.xml,80444/xv06823,0,0,6,6
"Heinz Schwarz Photograph Collection",wauschwarzheinzphcoll1393.xml,80444/xv35043,1,0,5,6
"Cornelius (John)",waucorneliusjohna0261.xml,80444/xv97348,3,2,1,6
"Bush (Wilma)",waubushwilmaadams3416-001.xml,80444/xv28982,1,0,5,6
"Bowie (Dorothee)",waubowiedorothee3044.xml,80444/xv09182,1,2,3,6
"Nakayama (Toshihide,)",waunakayamatoshihide2696-083.xml,80444/xv82546,1,2,3,6
"University of Washington. College of Engineering. Continuing Education Program.",wauuwresource00331.xml,80444/xv58453,0,1,5,6
"University of Washington Computing and Communications Records",wauuwresource00139.xml,80444/xv49932,2,3,1,6
"Unknown",waumountaineerssocietysafetycommittee3710.xml,80444/xv14062,1,3,2,6
"University of Washington. School of Nursing. Primary Health Care Nurse Practitioner Program.",wauuwresource06076.xml,80444/xv69851,1,1,4,6
"Curtis (Edward S.)",waucurtisedwardphcoll484.xml,80444/xv38018,0,0,6,6
"Depenheuer (Elizabeth)",waudepenheuerelizabeth3416-001.xml,80444/xv09667,1,2,3,6
"Unknown",waumcgillicuddyblaineh0904.xml,80444/xv36248,3,2,1,6
"Vail (Charity)",wauvailcharity3794.xml,80444/xv06207,1,2,3,6
"Seihoku Nippo Photograph Collection",wauseihokunippophcoll687.xml,80444/xv57263,2,3,1,6
"Tinan (Jean)",wautinanjeande0225.xml,80444/xv03515,0,3,3,6
"Unknown",wauinternationalconferenceonsalishlanguages5206.xml,80444/xv29528,1,2,3,6
"Unknown",waushucklingerald2331.xml,80444/xv63531,0,3,3,6
"Unknown",waubakkendick2172.xml,80444/xv54962,0,3,3,6
"Levy (F. J.) Papers",waulevyfredua5382.xml,80444/xv57241,0,0,6,6
"Berge (Anna) papers",waubergeanna2696_143.xml,80444/xv85366,0,0,6,6
"Seattle Chamber of Commerce Photograph Collection",wauseattlechambercommercephcoll20.xml,80444/xv94402,1,2,3,6
"Grube (Vara) Scrapbooks",waugrubevara5928.xml,80444/xv96545,0,6,0,6
"Rajneeshpuram Postcard Collection",waurajneeshpuramphcoll1407.xml,80444/xv80844,0,0,6,6
"Unknown",waugaytonvirginiaclark4737.xml,80444/xv98992,2,2,2,6
"Unknown",wauperspectives5053.xml,80444/xv87496,1,1,4,6
"Ness (Emma Theresa) scrapbook",waunessemmatheresa5944.xml,80444/xv76907,2,2,2,6
"Harrington (LaMar) Papers",wauharringtonlamar2824.xml,80444/xv29592,2,2,2,6
"University of Washington Curriculum Office Records",wauuwresource09158.xml,80444/xv97402,2,0,4,6
"Unknown",wausilleckwilliam4893.xml,80444/xv67617,6,0,0,6
"Cook (James) Collection of Engravings from the Voyages",waucookexpeditionprintsph.xml,80444/xv83700,2,4,0,6
"Skiing in Sun Valley film",wauskiinginsunvalleyphcoll1266.xml,80444/xv45660,4,2,0,6
"Harbor Club Seattle records",wauharborclubseattle6004.xml,80444/xv91183,3,0,3,6
"University of Washington. Educational Psychology Department.",wauuwresource00270.xml,80444/xv89126,3,1,2,6
"Foundation for Research at the University of Washington.",waufoundationforresearchattheuniversityofwashington3311.xml,80444/xv17590,2,2,2,6
"Unknown",wauuwresource07312.xml,80444/xv44723,3,1,2,6
"Brady (Ann)",waubradyann4623.xml,80444/xv40011,2,2,2,6
"Unknown",wauwilkesoncoalandcokecompany4969.xml,80444/xv56958,3,1,2,6
"University of Washington. School of Medicine. Facilities and Construction Office.",wauuwresource00381.xml,80444/xv58078,1,2,3,6
"Unknown",wauherzogedgarr1025.xml,80444/xv10195,3,3,0,6
"Unknown",wauweinsteinedythe3654.xml,80444/xv02963,1,3,2,6
"Unknown",wauwomensamericanortgreaterseattleareacouncil2810.xml,80444/xv81857,1,2,3,6
"Unknown",wauwidrigralphs3796.xml,80444/xv73410,2,2,2,6
"University Students Club (University of Washington).",wauuniversitystudentsclub1853_3316.xml,80444/xv23541,1,4,0,5
"Daniels (George)",waudanielsgeorgew1083.xml,80444/xv03546,2,2,1,5
"Washington (James)",wauwashingtonjamesw1282.xml,80444/xv49542,2,1,2,5
"Chan Family Panama Cafe Collection",wauchanfamily5515.xml,80444/xv25387,2,3,0,5
"Weyerhaeuser Camp McDonald Photograph Collection",wauweyerhaeusercampmcdonaldphcoll1392.xml,80444/xv16210,0,0,5,5
"University of Washington, Department of Facilities Planning and Construction Records",wauuwresource09344.xml,80444/xv43374,0,0,5,5
"Unknown",wauuwresource07346.xml,80444/xv98934,0,0,5,5
"Bacharach (Jere)",waubacharachjerelua4264.xml,80444/xv19180,2,0,3,5
"Unknown",waufrinkrerusselle4258.xml,80444/xv21350,1,4,0,5
"Unknown",waulillylewis4677.xml,80444/xv40246,3,2,0,5
"Goykhman (Meyer) Papers",waugoykhmanmeyer5985.xml,80444/xv89358,0,3,2,5
"Moriarty (Charles)",waumoriartycharlesp0665.xml,80444/xv64358,2,1,2,5
"Northern Native Broadcasting Yukon",waunorthernnativebroadcastingyukon6023.xml,80444/xv91711,0,0,5,5
"Misener (Roy B.) photograph collection",waumisenerroyphcoll1338.xml,80444/xv74627,0,0,5,5
"Sanchez (Patricia)",wausanchezpatricia3416-001.xml,80444/xv38516,3,2,0,5
"Rudd (Joan) Papers",wauruddjoan5963.xml,80444/xv25033,3,0,2,5
"Norwegian Hospital Association Records",waunorwegianhospitalassociation6013.xml,80444/xv08007,0,3,2,5
"Oregon Forest Protection Association.",wauoregonforestprotectionassociation3157.xml,80444/xv20840,1,1,3,5
"United States. Weather Bureau. Seattle Station (Seattle, Wash.).",wauunitedstatesweatherbureauseattlestation0524.xml,80444/xv45013,3,2,0,5
"Sothern (Ann) Film Collection",wausothernannfilmsph2005_016.xml,80444/xv70431,0,5,0,5
"Albertype Company University of Washington Photograph Album",waualbertypecouniversityofwashingtonph2016_024.xml,80444/xv55917,5,0,0,5
"Thomas (Edward B.) Photograph Collection",wauthomasedwardbphcoll143.xml,80444/xv16333,3,2,0,5
"Unknown",wauunitedstatessurgeongeneralsoffice4942.xml,80444/xv59774,1,0,4,5
"Metcalf (James)",waumetcalfjamesi0862_1018_5140.xml,80444/xv96252,1,1,3,5
"University of Washington. Vice Provost for Academic Services.",wauuwresource00117.xml,80444/xv29843,2,2,1,5
"Unknown",wauuwresource00391.xml,80444/xv87734,1,3,1,5
"Japanese Navy Ships in Seattle Photograph Collection",waujapanesenavyshipsph2009_054.xml,80444/xv55538,3,2,0,5
"Couch-Derickson Family Photograph Collection",waucouchdericksonfamilyphcoll1337.xml,80444/xv39398,0,1,4,5
"Brown & Bigelow Calendar collection",waubrownandbigelowcalendar6016.xml,80444/xv69958,0,5,0,5
"Thurston County Chapter (National Organization for Women) records",waunationalorganizationforwomenthurstoncountychapter5950.xml,80444/xv67343,3,1,1,5
"Unknown",waudevinejeanporter2632.xml,80444/xv81585,5,0,0,5
"Unknown",wauindependentorderofoddfellowsfriendshiplodge13portgamblewash1146.xml,80444/xv83187,2,3,0,5
"Unknown",waubouchercormacke1505.xml,80444/xv38897,1,1,3,5
"Unknown",wauweinerlewis4091.xml,80444/xv52627,2,1,2,5
"Camp Ghormley Historic Sleeping Cabins Photographs",waucampghormleyphcoll640.xml,80444/xv80379,5,0,0,5
"Whiteley (Helen R.) Papers",wauwhiteleyhelenua4337.xml,80444/xv57516,1,3,1,5
"Unknown",wauscheffertheodoreh3029.xml,80444/xv23983,3,0,2,5
"University of Washington Alcohol and Drug Abuse Institute Records",wauuwresource00439.xml,80444/xv52587,3,2,0,5
"Thomas (Herbert) and Natalie Malin Oral History",wauthomasherbertvictor5627.xml,80444/xv66870,2,3,0,5
"Pacific Coast Oyster Growers Association.",waupacificcoastoystergrowersassociation0747_1354.xml,80444/xv53924,1,0,4,5
"Unknown",waupnwnewspapersspecialissues5997.xml,80444/xv56475,0,3,2,5
"Stewart family papers",waustewartfamily5940.xml,80444/xv23809,0,0,5,5
"Tufts (Paul) Papers",wautuftspaulua5444.xml,80444/xv90597,3,1,1,5
"Steele (Joan M.) papers",wausteelejoan5923.xml,80444/xv28674,5,0,0,5
"Vasquez (Michael)",wauvasquezmichaellouis2696.xml,80444/xv62985,0,2,3,5
"Unknown",wauwashingtonirrigationinstitute4952.xml,80444/xv37747,1,1,3,5
"Clark County Teachers Institute.",wauclarkcountyteachersinstitute1384.xml,80444/xv30844,3,1,1,5
"Unknown",wauhazardjosephtaylor3488.xml,80444/xv25039,0,5,0,5
"Unknown",wauuwresource07322.xml,80444/xv06881,0,0,5,5
"Miles (Edward L.) papers",waumilesedwardlua5970.xml,80444/xv81512,0,2,3,5
"Unknown",waugrossesther2281.xml,80444/xv68930,1,3,1,5
"University of Washington Office of Institutional Educational Research Records",wauuwresource07690.xml,80444/xv41732,2,2,1,5
"Unknown",waumorrismuscatelandsonsseattlewash3473.xml,80444/xv91528,4,1,0,5
"University of Washington, School of Law, Dean Records",wauuwresource00351.xml,80444/xv64682,0,1,4,5
"Unknown",wauconnerjohnafamily0437.xml,80444/xv70651,0,3,2,5
"Sperry (Robert) "Potters of Onda" Photographs",wausperryrobertphcoll441.xml,80444/xv32632,3,1,1,5
"University of Washington. Hospital. Auxiliary.",wauuniversityofwashingtonhospitalauxiliary4494.xml,80444/xv51666,1,2,2,5
"Phillips (Ronald P.) Papers",wauphillipsronaldp5526.xml,80444/xv08084,2,2,1,5
"Woods (Rachel) Photograph Collection",wauwoodsrachelphcoll1363.xml,80444/xv61993,0,5,0,5
"Unknown",wauseattleyiddishgroup5801.xml,80444/xv00576,3,2,0,5
"University of Washington World Series Records",wauuwresource01698.xml,80444/xv41714,0,5,0,5
"Pitharoulis (Cae) manuscript and computer discs",waupitharouliscae5829.xml,80444/xv05441,2,2,1,5
"Unknown",wauwoodmenoftheworldlifeinsurancecoseattlecampno69_3975.xml,80444/xv40945,0,2,3,5
"Sandra Glazer Lake Photographs",waulakesandraglazerphcoll1356.xml,80444/xv65057,4,0,1,5
"Helping the Homeless Man: Activities and Facilities of the Central Registry for Homeless Single Men",wauhelpingthehomelessphcoll608.xml,80444/xv96795,1,0,4,5
"Engles (Harold)",wauenglesharoldphcoll1220.xml,80444/xv07760,0,3,2,5
"University of Washington. College of Arts and Sciences. Development Office.",wauuwresource00275.xml,80444/xv60452,0,2,3,5
"Unknown",waubeckergeorge3389.xml,80444/xv92495,3,1,1,5
"Washington State Historic Building Mitigation Documentation of Twisp Administrative Site",wautwispadministrativesiteph2016_031.xml,80444/xv91287,3,2,0,5
"University of Washington. College of Education. Educational Leadership and Policy Studies.",wauuwresource00268.xml,80444/xv55737,0,2,3,5
"Unknown",waukauffmanleone2520.xml,80444/xv30902,0,0,5,5
"Unknown",wausidelarchie1956.xml,80444/xv59637,1,2,2,5
"Thompson (Clark)",wauthompsonclarkw0706.xml,80444/xv41851,4,1,0,5
"Unknown",wauforestproductsresearchsociety3458.xml,80444/xv28817,5,0,0,5
"Unknown",wauuwresource00103.xml,80444/xv84606,1,0,4,5
"Unknown",waumillermorrisr2285.xml,80444/xv27520,3,2,0,5
"Unknown",wauwashingtonstatedefensecouncil1013.xml,80444/xv50454,1,3,1,5
"Seattle 2000 Commission.",wauseattle2000commission2820.xml,80444/xv83041,1,0,4,5
"Shaw (H. Walter) Photograph Album",waushawhwalterphcoll545.xml,80444/xv41452,3,1,1,5
"Marshall (Nell)",waumarshallnell3416-001.xml,80444/xv89886,0,2,3,5
"Unknown",waugintherronald0603.xml,80444/xv10980,1,3,1,5
"Zeta Beta Tau, Alpha Mu Chapter Records",wauzetabetataualphamu5991.xml,80444/xv78848,5,0,0,5
"University of Washington. Dept. of Biostatistics.",wauuwresource00460.xml,80444/xv85809,3,1,1,5
"Unknown",wauschwabacherhardwarecoseattlewash4472.xml,80444/xv35656,1,2,2,5
"Unknown",waufrolundlaurits2134.xml,80444/xv69500,1,2,2,5
"Hawthorne (Donald C.) papers",wauhawthornedonaldua5394.xml,80444/xv24224,1,0,4,5
"Grashin (Barbara)",waugrashinbarbara3839.xml,80444/xv16790,3,2,0,5
"Denison (Carolyn) Filmstrips",waudenisoncarolynph2016_050.xml,80444/xv15048,0,0,5,5
"Weedin Family Photograph Collection",wauweedinfamilyphcoll014.xml,80444/xv16021,2,1,2,5
"Unknown",waucollinsjosiah1279.xml,80444/xv12704,2,3,0,5
"University of Washington Department of Psychology Psychological Services and Training Center Records",wauuwresource09183.xml,80444/xv05239,1,1,3,5
"Unknown",waugumpowenphcoll632.xml,80444/xv81746,2,0,3,5
"Unknown",waumcnarycharleslinza0900.xml,80444/xv19647,3,2,0,5
"Unknown",wauwebberrubyclein2081.xml,80444/xv43121,0,2,3,5
"Unknown",wauspaffordelizabethsandvig2692.xml,80444/xv56121,1,2,2,5
"Seattle (Washington Territory).",wauseattlewashingtonterritory0173.xml,80444/xv76251,2,1,2,5
"Johnson (d'Elaine) Papers",waujohnson_d_elaine6012.xml,80444/xv44091,0,4,1,5
"Unknown",wauschwabachermortonl1016.xml,80444/xv18545,1,1,3,5
"Phi Beta Kappa. Puget Sound Association Records",wauphibetakappapugetsoundassociation5387.xml,80444/xv37435,5,0,0,5
"Shaul (David)",waushauldavidleedom2696-087.xml,80444/xv77670,0,3,2,5
"Barton (Kearney W.) Collection of Northwest Sound Recordings, 1950-2000",wau_waseumc2010.01.xml,80444/xv40075,1,2,2,5
"Unknown",wauwolfmel5027.xml,80444/xv31509,2,1,2,5
"Pan-Hellenic Association of the University of Washington.",waupanhellenicassociationoftheuniversityofwashington5059.xml,80444/xv33508,0,1,4,5
"Tinan (Le)",wautinanlebarbierde0224.xml,80444/xv25424,3,2,0,5
"Unknown",wauwestseattleseattlewashgoodspeedsaddition2869.xml,80444/xv42156,1,0,4,5
"Newsfilm of Grays Harbor County",waunewsfilmgraysharborcountyphcoll925.xml,80444/xv91696,4,0,1,5
"Freeman (Melvin Irwin) Scrapbooks",waufreemanmelvinirwin5942.xml,80444/xv52322,0,5,0,5
"Unknown",wauhartmansarahmcallister4748.xml,80444/xv40591,3,1,0,4
"Uncle Reube Photograph Album",wauunclereubealbumphcoll055.xml,80444/xv78924,1,1,2,4
"Newell (Margaret)",waunewellmargaret3416-001.xml,80444/xv63476,1,1,2,4
"Unknown",waupacificcoaststeamshipcompany0250.xml,80444/xv19015,1,0,3,4
"University of Washington Health Sciences Center for Educational Resources Photograph Collection",wauuwhealthsciencescenterforeducationalresourcesph2016_027.xml,80444/xv67578,0,0,4,4
"Unknown",waustoweharrietbeecher4911.xml,80444/xv65652,4,0,0,4
"Unknown",wauashfordpaul0785.xml,80444/xv77627,1,1,2,4
"Unknown",waulawsonronaldaaron4359.xml,80444/xv65103,1,1,2,4
"Unknown",wauwilsonelmer3683.xml,80444/xv13854,0,0,4,4
"Unknown",waumurphyug1248.xml,80444/xv94006,1,1,2,4
"Unknown",waumonheimermelville1992.xml,80444/xv66235,1,0,3,4
"Tolleson (Floyd)",wautollesonfloydclyde4489.xml,80444/xv51623,2,1,1,4
"Unknown",waucouncilforminorityrights3682.xml,80444/xv33706,1,1,2,4
"Bennett (Linton P.) papers",waubennettlintonp5960.xml,80444/xv19671,0,0,4,4
"Unknown",wauwashingtonsocietyoflandscapearchitects2875.xml,80444/xv45847,3,1,0,4
"Unknown",waulorberdov2974.xml,80444/xv66293,2,2,0,4
"Unknown",wauogdenpeterskene4774.xml,80444/xv84997,0,4,0,4
"Woodhouse (Philip R.) Photograph Collection",wauwoodhousephiliprphcoll190.xml,80444/xv33242,3,0,1,4
"University of Washington School of Nursing. Department of Family and Child Nursing Records",wauuwresource00422.xml,80444/xv12478,0,0,4,4
"Unknown",wauschmitzdietrich0699.xml,80444/xv61590,0,0,4,4
"Unknown",waurustfamily1115.xml,80444/xv58102,2,2,0,4
"UW Medicine Information Technology Services records",wauuwresource00211.xml,80444/xv19879,0,0,4,4
"Champion (Edouard,)",wauchampionedouard0290.xml,80444/xv59436,1,1,2,4
"Thomas Burke Memorial Washington State Museum Director",wauuwresource00319.xml,80444/xv45889,0,3,1,4
"Bigelow (Eileen) Scrapbooks",waubigeloweileen5974.xml,80444/xv61309,2,0,2,4
"Yakima Valley farming photograph album",wauyakimavalleyph2009_006.xml,80444/xv38580,0,2,2,4
"UWTV (Television station : Seattle, Wash.).",wauuwresource00142.xml,80444/xv35009,1,1,2,4
"Moon (George) Photographs",waumoongeorgephcoll371.xml,80444/xv75915,0,2,2,4
"Starr (Mildred)",waustarrmildred3990.xml,80444/xv89965,2,1,1,4
"Northwest Buildings Survey No. WA-001 (Fred Nelson Barn/Old Riverview Farms Dairy Barn) Collection",waufrednelsonbarnphcoll554.xml,80444/xv75248,2,0,2,4
"Univar Corporate History Manuscript",wauunivarcorporation5604.xml,80444/xv36367,2,1,1,4
"Unknown",wauferryelishap2156.xml,80444/xv56134,4,0,0,4
"Deus X Machina Theater Company Records",waudeusxmachina5577.xml,80444/xv07797,2,0,2,4
"Gluck (Joseph) Photograph Collection",waugluckjosephph2016_059.xml,80444/xv18603,0,0,4,4
"Unknown",wauseattlefishco5998.xml,80444/xv97552,4,0,0,4
"University of Washington Libraries, Monographic Services Division",wauuwresource07344.xml,80444/xv41687,1,1,2,4
"Misener Family Films",waumisenerfilmsphcoll1325.xml,80444/xv34405,0,0,4,4
"Unknown",wauwesternwashingtonboardofrabbis4276.xml,80444/xv28231,2,2,0,4
"Unknown",waudemocraticpartymetropolitandemocraticclubseattle3720.xml,80444/xv83969,3,1,0,4
"Unknown",wauunitedklansofamerica5233.xml,80444/xv82510,2,1,1,4
"Unknown",waublackwellwilliamb4610.xml,80444/xv44284,2,0,2,4
"Unknown",wauseattlehardwareco5660.xml,80444/xv11410,2,2,0,4
"Medical Arts Building Collection",waumedicalartsphcoll618.xml,80444/xv48914,2,1,1,4
"Unknown",wausmetpierrejeande4640.xml,80444/xv61474,0,0,4,4
"University of Washington. Services and Activities Fee Committee.",wauuwresource06500.xml,80444/xv35906,0,2,2,4
"Unknown",wauuwresource07345.xml,80444/xv97070,4,0,0,4
"Lev (Daniel S.) Papers",waulevdanielsua5925.xml,80444/xv59701,0,0,4,4
"University of Washington Medical Center, Medical Director Records",wauuwresource00215.xml,80444/xv19152,0,1,3,4
"Hurley (Vic) Papers",wauhurleyvic5918.xml,80444/xv59814,4,0,0,4
"Ryan (Milo)",wauuwresource09310.xml,80444/xv37857,0,0,4,4
"University of Washington Science Curriculum Committee",wauuwresource09341.xml,80444/xv36654,0,0,4,4
"Unknown",wauseattleprogressiveladiesauxiliary5869.xml,80444/xv04629,2,1,1,4
"Unknown",waupacificsteamshipcompany0399.xml,80444/xv35488,2,0,2,4
"University of Washington. Clinical Nursing Scholars Program.",wauuwresource06078.xml,80444/xv45611,0,0,4,4
"Unknown",wauradinskyjack2407.xml,80444/xv04977,0,3,1,4
"Unknown",waubruckartjohnray3484.xml,80444/xv86254,2,2,0,4
"Franklin (Abby) Oral History",waufranklinabby5698.xml,80444/xv48553,2,2,0,4
"Unknown",waucentralcontractorsassociation1346.xml,80444/xv73175,4,0,0,4
"Unknown",waudaughtersofpenelopefirwooddistrict22_3813.xml,80444/xv59765,1,0,3,4
"University of Washington. Bureau of International Relations.",wauuwresource05081.xml,80444/xv01223,1,2,1,4
"Smith (George) Photograph Album",wausmithgeorgeph2015_025.xml,80444/xv13940,2,0,2,4
"Sussman (Jerry) papers",wausussmanjerry5919.xml,80444/xv49966,2,2,0,4
"Unknown",wauwashingtonstatecemeteryassociation5391.xml,80444/xv12283,2,2,0,4
"University of Washington Libraries Donor's Tea Photograph Collection",wauuwlibrariesdonorteaph2016_035.xml,80444/xv56118,2,2,0,4
"Wolff (J.)",wauwolffj1495_1633_1676.xml,80444/xv95132,1,2,1,4
"AVID Clinical Trial Center (University of Washington) Records",wauuwresource04830.xml,80444/xv32266,0,0,4,4
"Kassowitz (Ernst) Photographs and Drawings",waukassowitzernstphcoll215.xml,80444/xv14282,0,3,1,4
"Unknown",wauhirashimam1158.xml,80444/xv91726,0,2,2,4
"Unknown",wausmithalfredj4815.xml,80444/xv66467,2,1,1,4
"Unknown",waubennsamuel4694.xml,80444/xv83224,1,2,1,4
"Fitzpatrick (Darleen)",waufitzpatrickdarleenann2696-042.xml,80444/xv26412,2,1,1,4
"Lewis (Harry) Papers",waulewisharry5987.xml,80444/xv50177,0,2,2,4
"U.S. Navy WAVES Seattle Camp Photograph Collection",wauusnavywavesph2009_015.xml,80444/xv42367,1,3,0,4
"Silber (Linda)",wausilberlinda2771.xml,80444/xv83078,1,1,2,4
"Unknown",waucentennialflouringmillcompanyspokanewash4629.xml,80444/xv80706,2,1,1,4
"Unknown",waushakespeareclubportgamblewash0031.xml,80444/xv68362,3,0,1,4
"Seattle Urban League Photograph and Film Collection",wauseattleurbanleaguephcoll625.xml,80444/xv55578,1,0,3,4
"Unknown",wauwashingtonrecreationandparksociety2486.xml,80444/xv63415,0,0,4,4
"Unknown",wauspeciallibrariesassociationpacificnorthwestchapter4236.xml,80444/xv94961,2,2,0,4
"Unknown",wauschultzzellam5075.xml,80444/xv67150,2,2,0,4
"Unknown",wauovadiaalbert1767.xml,80444/xv44976,1,2,1,4
"Goldman (Gerson) Oral History",waugoldmangerson5625.xml,80444/xv59683,1,1,2,4
"Lee (James P.) Alaska-Yukon-Pacific Exposition Photographs",wauleejamespaypephcoll760.xml,80444/xv24508,4,0,0,4
"Henderson (Transport)",wauhardingwarreng6009.xml,80444/xv69265,0,4,0,4
"Unknown",waudodgeflorencep5091.xml,80444/xv25198,0,4,0,4
"The Klondyke Nugget Poster Collection",wauklondykenuggetpostersphcoll1218.xml,80444/xv36978,2,0,2,4
"Unknown",waucanadaroadtripalbumphcoll1326.xml,80444/xv47268,4,0,0,4
"Unknown",wauwashingtonsouthernrailwaycompany4954.xml,80444/xv23370,1,2,1,4
"Sprincin (Helen)",wausprincinhelenrw5493.xml,80444/xv75814,0,3,1,4
"Iosif (Stefan) Family Photograph and Ephemera Collection",wauiosifstefanph2016_052.xml,80444/xv70840,0,0,4,4
"Western United States Photograph Collection",wauwesternunitedstatesphcoll392.xml,80444/xv90115,0,2,2,4
"Unknown",wauuwresource07327.xml,80444/xv22406,0,2,2,4
"Washington (State). World Fair Commission (1893).",wauwashingtonworldfaircommission4305.xml,80444/xv04879,2,2,0,4
"Murdock (Louis F.) Photographs",waumurdocklouisphcoll350.xml,80444/xv12701,1,1,2,4
"Turner (Edward)",wauturneredwardl3345.xml,80444/xv72021,0,2,2,4
"Unknown",waucohendov2802.xml,80444/xv06250,4,0,0,4
"Fitzgerald (Emerson G.) collection",waufitzgeraldemersong5958.xml,80444/xv88504,0,1,3,4
"Unknown",wauwalkerirene4536.xml,80444/xv05871,2,2,0,4
"Tacoma Motorcycle Race Film",waumotorcycleracingphcoll830.xml,80444/xv11331,0,4,0,4
"Unknown",waucooperfamily5204.xml,80444/xv14172,0,2,2,4
"Pacific Creosoting Co. Photograph Collection",waupacificcreosotingcophcoll430.xml,80444/xv38052,0,1,3,4
"Ross (Glynn W.) Papers",waurossglynnw5913.xml,80444/xv44073,1,0,3,4
"Fairbanks (Avard T.) Papers",waufairbanksavard5972.xml,80444/xv85647,1,1,2,4
"Flood (Daniel)",wauflooddanielj3970.xml,80444/xv29928,2,2,0,4
"Unknown",waumerwinthekla4222.xml,80444/xv57336,1,0,3,4
"Unknown",waumenashematilda3445.xml,80444/xv86734,0,3,0,3
"Hoover (J. Webster) University of Washington Baseball Team Photograph Collection",wauhooverjwebsterphcoll173.xml,80444/xv03405,0,1,2,3
"Wiltschko (Martina) Papers",wauwiltschkomartina2696-141.xml,80444/xv73382,0,0,3,3
"Cohn (Annette)",waucohnannettephcoll1362.xml,80444/xv32434,1,2,0,3
"Unknown",waureesemaryhynson3840.xml,80444/xv04119,0,0,3,3
"Gahringer (Ervin R.) Papers",waugahringerervin5399.xml,80444/xv33959,2,0,1,3
"Unknown",waucarterrandolphwarren1220.xml,80444/xv03732,0,1,2,3
"Burke (Edith B.)",wauburkeedith5986.xml,80444/xv98062,1,2,0,3
"Unknown",wauhorrockshattiegraham1053.xml,80444/xv53186,2,0,1,3
"McAlpin & Lamb Oregon and Alaska Photographs",waumcalpinandlambphcoll329.xml,80444/xv54861,0,3,0,3
"University of Washington Northwest Center for Public Health Practice Records",wauuwresource05734.xml,80444/xv01196,0,0,3,3
"University of Washington Center for Technology and Disability Studies",wauuwresource07760.xml,80444/xv36306,2,0,1,3
"Unknown",waupacificcoldstoragecoalandinvestmentcosouthbendwash4834.xml,80444/xv57189,2,1,0,3
"Unknown",waumitchelljohnr2269.xml,80444/xv88864,0,1,2,3
"Soule Seattle Fire Collection",wausoulejohnpseattlefirephcoll259.xml,80444/xv02178,3,0,0,3
"Unknown",waujorgensenbettymarie4996.xml,80444/xv49765,1,1,1,3
"Unknown",wausanadaseiichi3998.xml,80444/xv94549,0,0,3,3
"Unknown",wauwashingtonassociationchurches1567_5426.xml,80444/xv96136,0,0,3,3
"Scriven (Edward Baker) Photograph Collection",wauscrivenedwardphcoll781.xml,80444/xv98004,1,2,0,3
"Sexton Family University of Washington Photograph Collection",wausextonfamilyphcoll110.xml,80444/xv00671,0,1,2,3
"University of Washington. Educational Outreach. Marketing and Public Relations Office.",wauuwresource00145.xml,80444/xv72579,0,0,3,3
"Unknown",waustudentmobilizationcommitteeus1339.xml,80444/xv24230,0,0,3,3
"Wai Tung Rug Company, Tientsin rug design paintings",wauwaitungrugdesignpaintingsph2012_006.xml,80444/xv54577,2,0,1,3
"Unknown",waufacultyclubseattlewash3322.xml,80444/xv51345,0,0,3,3
"Unknown",wauaokishea5308.xml,80444/xv24865,2,1,0,3
"Martin (William H.) Exaggerated Postcards",waumartindadpostcardphcoll1279.xml,80444/xv17553,1,1,1,3
"Wagner (Clyde and Charles)",wauwagnercharlesandclyde5833.xml,80444/xv39392,3,0,0,3
"Young, Richardson, Carleton, & Detlie Photograph Collection",wauyoungrichardsoncarletondetlieph2004_021.xml,80444/xv28237,0,0,3,3
"Ohnick (Benjamin S.) Family Papers",wauohnickbenjaminsfamily5565.xml,80444/xv73736,1,0,2,3
"Unknown",wausatsoprailroadco0646.xml,80444/xv33807,2,1,0,3
"Unknown",waumathewsingera3627.xml,80444/xv67480,0,3,0,3
"Unknown",waupruzanharry4001.xml,80444/xv92645,0,0,3,3
"Hilbert (Vi) Papers",wauhilbertvi5401.xml,80444/xv54449,2,1,0,3
"Langins Family papers",waulanginsfamily5976.xml,80444/xv25524,0,0,3,3
"Unknown",wausampsondonaldc2765.xml,80444/xv48577,1,1,1,3
"Mulder (Jean)",waumulderjeangail2696-031.xml,80444/xv70144,0,3,0,3
"Thompson (J. W.) Slides",wauthompsonjwph2015_026.xml,80444/xv87738,2,1,0,3
"Unknown",waufarisellen1541.xml,80444/xv22497,1,2,0,3
"Kline Galland Center architectural drawing and photograph collection",waugallandcarolineklinephcoll854.xml,80444/xv11657,3,0,0,3
"University of Washington Center for Studies in Demography and Ecology Records",wauuwresource00274.xml,80444/xv77996,3,0,0,3
"Alpha Epsilon Pi, Chi Douteron Chapter Records",waualphaepsilonpichidouteron5990.xml,80444/xv09918,0,3,0,3
"Kechley (Gerald) Papers",waukechleygeraldua5953.xml,80444/xv58969,0,3,0,3
"Unknown",waumariongeorge3533.xml,80444/xv36007,0,3,0,3
"Unknown",waubutlerpierce0528.xml,80444/xv60632,1,0,2,3
"Unknown",waubonescottc0098.xml,80444/xv92053,1,2,0,3
"Unknown",wauplattfamily4847.xml,80444/xv83618,1,1,1,3
"Crawford (Donald and Lela) Negative Photograph Collection",waucrawfordairphotonegativesphcoll1346.xml,80444/xv42904,0,2,1,3
"Unknown",wausmithcannerymachinesco3054.xml,80444/xv43829,0,0,3,3
"Unknown",wauplotkinvladimir3860.xml,80444/xv51550,0,2,1,3
"Unknown",wauschoenfeldwalter2315.xml,80444/xv84542,0,1,2,3
"Seattle Visual Elements/Man-made Environments Photograph Collection",wauseattlevisualelementsphcoll400.xml,80444/xv48602,1,1,1,3
"Jewish Western Bulletin",waujewishwesternbulletin1570.xml,80444/xv18804,0,0,3,3
"Unknown",waupegelowalbert1132.xml,80444/xv51217,1,1,1,3
"Unknown",waucampbellpatricia0142.xml,80444/xv76309,3,0,0,3
"Unknown",wauwashingtonstatecommitteefortheprotectionoftheforeignborn4950.xml,80444/xv49032,2,0,1,3
"Unknown",waueasternwashingtonpublicutilitydistrictscommissionersassociation4645.xml,80444/xv60641,1,2,0,3
"Nile Shrine Collection of Photographs and Other Material",waunileshrineph2009_018.xml,80444/xv00274,1,0,2,3
"Long (Harvey) Photographs of",waulongharryphcoll816.xml,80444/xv32965,2,1,0,3
"Marshall (Louise)",waumarshalllouiseb1680_1879_2069.xml,80444/xv42651,1,0,2,3
"Unknown",wauhermannwilliam2303.xml,80444/xv88970,3,0,0,3
"Unknown",wauwatermandelos4958.xml,80444/xv70831,1,2,0,3
"Cello Bag Company Inc. records",waucellobagco6010.xml,80444/xv85537,0,3,0,3
"Webster and Stevens Alaska Photographs",wauwebsterandstevensphcoll411.xml,80444/xv86996,1,0,2,3
"Hutton (Esther Robbins) papers",wauhuttonestherrobbins5916.xml,80444/xv25979,2,1,0,3
"S.S. Yukon Trip up the Inland Passage",wauinlandpassagephcoll813.xml,80444/xv56072,3,0,0,3
"Unknown",wauovadiaike4380.xml,80444/xv18524,2,1,0,3
"Unknown",waudashleyhazelh5035.xml,80444/xv22900,0,3,0,3
"University of Washington. Training and Development.",wauuwresource00198.xml,80444/xv77835,0,3,0,3
"Reynolds (E.) India Photograph Album",waureynoldseindiaalbumphcoll257.xml,80444/xv58489,2,0,1,3
"Page (Thomas J.) Photograph Collection",waupagethomasphcoll238.xml,80444/xv59860,0,3,0,3
"Unknown",waubertelsonernestb0946.xml,80444/xv53256,0,1,2,3
"University of Washington Sports Photograph Collection",wauuwsportsphcoll429.xml,80444/xv25698,0,2,1,3
"Unknown",wautsujimotokazuo1026.xml,80444/xv03628,3,0,0,3
"University of Washington Commissioners",wauuwresource09282.xml,80444/xv07324,0,3,0,3
"Coates (Thomas)",waucoatesthomas4705.xml,80444/xv50119,2,0,1,3
"Unknown",wauuwresource07389.xml,80444/xv36984,0,1,2,3
"Stillaguamish Country Club Photograph Collection",waustillaguamishcountryclubphcoll665.xml,80444/xv46520,3,0,0,3
"Mears Panama Railroad Photograph Collection",waumearsphcoll108.xml,80444/xv40594,3,0,0,3
"Unknown",wauuchidafrank3999.xml,80444/xv84344,0,0,3,3
"University of Washington 1961 Convocation",wauuwresource09280.xml,80444/xv76562,0,3,0,3
"Unknown",wauhowardnorachristopher3137.xml,80444/xv11419,0,3,0,3
"Thomas (Paul)",wauthomaspaulf0548.xml,80444/xv76480,2,1,0,3
"Unknown",wauwarsinskenormang2733.xml,80444/xv86492,3,0,0,3
"Unknown",waugalerstreetcommunityassociationseattlewash4433.xml,80444/xv37942,1,2,0,3
"Nichols (Lynn)",waunicholslynn2696.xml,80444/xv93041,1,1,1,3
"Unknown",waugiddenszilphakeys3755.xml,80444/xv42636,0,3,0,3
"Tallmadge Hamilton House for University Senior Activity Center Scrapbooks and Other Material",wautallmadgehamiltonhouse5507.xml,80444/xv94125,1,1,1,3
"University of Washington Crew Photograph Album",wauuniversityofwashingtoncrewphcoll121.xml,80444/xv53802,0,0,3,3
"Unknown",wauspraguedavidg1963.xml,80444/xv69067,2,1,0,3
"University of Washington Buildings and Grounds Superintendent",wauuwresource09274.xml,80444/xv94198,0,2,1,3
"Unknown",wauyoungnaturalistsassociationseattlewash4985.xml,80444/xv45819,3,0,0,3
"Unknown",wauramseyerhelenes3081.xml,80444/xv04275,3,0,0,3
"United States. Wartime Civil Control Administration.",wauunitedstateswartimecivilcontroladministration0977_1416_5411.xml,80444/xv87850,1,1,1,3
"Unknown",waudorismorrisjoseph2564.xml,80444/xv49038,0,0,3,3
"Gordon (Lucille Charlotte) papers",waugordonlucillecharlotte5957.xml,80444/xv46481,1,1,1,3
"Unknown",waumoranmaryadelaide2289.xml,80444/xv94271,0,1,2,3
"Unknown",waunahmiasfamily4396.xml,80444/xv68811,2,1,0,3
"Brooks (Richard J.) Papers",waubrooksrichard2903.xml,80444/xv89004,0,1,2,3
"Grand Coulee Dam Photograph Albums",waugrandcouleedamalbumsph2015_013.xml,80444/xv63076,2,0,1,3
"Mattson (John L.) Papers",waumattsonjohnl5535.xml,80444/xv30911,1,2,0,3
"University of Washington Pulp Mill Research Project Records",wauuwresource07747.xml,80444/xv15255,2,1,0,3
"Scharhon (Victor) Papers",wauscharhonvictor5989.xml,80444/xv90509,0,0,3,3
"Unknown",wauroperjohn2181.xml,80444/xv34185,0,0,3,3
"Unknown",waulevyisaacjack4005.xml,80444/xv79653,3,0,0,3
"Steinbrueck (Victor)",wausteinbrueckvictorllphcoll547.xml,80444/xv92947,0,0,3,3
"Unknown",wauschwabacherbroscompanyseattlewash1403.xml,80444/xv66815,0,1,2,3
"Unknown",waumethenydavid4369.xml,80444/xv29681,1,1,1,3
"University of Washington. Treasurer.",wauuwresource00193.xml,80444/xv89898,1,1,0,2
"Unknown",waujacksongertrude3650.xml,80444/xv89993,0,2,0,2
"Unknown",wauronaldjamestheodore3619.xml,80444/xv02908,0,2,0,2
"Photographs of Turkey Growing and Processing",wauturkeygrowingphcoll1381.xml,80444/xv97241,0,2,0,2
"Unknown",waubordeauxfamily2390.xml,80444/xv22363,2,0,0,2
"Unknown",waujapanesecommercialcommission5896.xml,80444/xv01251,2,0,0,2
"Ravenna Creek Alliance Records",wauravennacreekalliance5534.xml,80444/xv92184,1,1,0,2
"Unknown",wauswabeygracew5156.xml,80444/xv75305,0,1,1,2
"University of Washington. Black Student Commission.",wauuwresource04765.xml,80444/xv94781,0,0,2,2
"Register-Darling (Sally Ann) Scrapbook",wauregisterdarlingsallyann5947.xml,80444/xv74331,2,0,0,2
"Unknown",waupaulhamuswilliamh0060.xml,80444/xv83837,0,2,0,2
"Unknown",waumasoncountycentralrailroadco0647.xml,80444/xv29251,2,0,0,2
"Koito Family Photograph Album",waukoitofamilyphcoll185.xml,80444/xv42199,2,0,0,2
"University of Washington Engineering Experiment Station photographs and lantern slides",wauuwengineeringexperimentstationph2015_003.xml,80444/xv90017,2,0,0,2
"Unknown",waufraynrobertmort5011.xml,80444/xv77810,1,0,1,2
"Northwest Locales Photograph Album",waunorthwestlocalesphcoll776.xml,80444/xv84838,2,0,0,2
"Unknown",wauseattlefriendsofhistadrut2525.xml,80444/xv77182,1,0,1,2
"University of Washington. Gastroenterology Division.",wauuwresource00392.xml,80444/xv20376,0,0,2,2
"Hartwich (Ethelyn)",wauhartwichethelynmillerua1731_1745_2949.xml,80444/xv31512,0,1,1,2
"Unknown",wauunitedstatesbureauofcustoms4932.xml,80444/xv30709,0,1,1,2
"Washington Historical Quarterly (University of Washington).",wauwashingtonhistoricalquarterly4317.xml,80444/xv52038,2,0,0,2
"Unknown",wauweisshelens5344.xml,80444/xv96371,0,2,0,2
"Unknown",wauajmillerco4821.xml,80444/xv62734,1,0,1,2
"Unknown",waustiefelsheryl3923.xml,80444/xv37619,0,2,0,2
"Unknown",waujdlaceyco0025.xml,80444/xv40072,1,1,0,2
"Unknown",wauankenylevi0067.xml,80444/xv03735,0,2,0,2
"Unknown",wauwarashinapatti2691.xml,80444/xv00265,1,1,0,2
"Unknown",waulevimargaretua5356.xml,80444/xv21832,1,1,0,2
"Cole (Dale) papers",waucoledaleua5819.xml,80444/xv72985,2,0,0,2
"Unknown",waugowalexandermurrayfamily0913.xml,80444/xv18432,2,0,0,2
"Unknown",wauharphameverette3967.xml,80444/xv98886,2,0,0,2
"University of Washington Global Trade Transportation and Logistics Studies Program Records",wauuwresource09200.xml,80444/xv33288,0,2,0,2
"Unknown",waupalmeredward4837.xml,80444/xv27438,0,0,2,2
"Unknown",waublumenthalherman3037.xml,80444/xv84323,0,2,0,2
"Wafenschmidt (Bob) Home Movies",wauwafenschmidtphcoll827.xml,80444/xv86248,0,0,2,2
"Unknown",wauficknelliemitchell0123.xml,80444/xv45437,0,2,0,2
"Unknown",wauunitedstatessubversiveactivitiescontrolboard4938.xml,80444/xv46166,2,0,0,2
"United States. Army. Washington Territorial Volunteers. Regiment, 2nd.",wauunitedstatesarmywashingtonterritorialvolunteersregiment2nd4930.xml,80444/xv39755,2,0,0,2
"Unknown",waucitizensforfairschoolfunding5413.xml,80444/xv61621,1,1,0,2
"Unknown",wauboasfranz2388.xml,80444/xv53396,2,0,0,2
"Unknown",wauhenningvirginiad4432.xml,80444/xv81637,2,0,0,2
"Unknown",waupolikabe2190.xml,80444/xv04644,2,0,0,2
"University of Washington. School of Communications.",wauuwresource00298.xml,80444/xv53750,0,2,0,2
"Unknown",waugrossmanhelene3225.xml,80444/xv54882,2,0,0,2
"Unknown",waumilligandon3065.xml,80444/xv56930,1,0,1,2
"Unknown",wauhartsuckben4749.xml,80444/xv19989,0,0,2,2
"Francis (Peter)",waufrancispeterd1639_1642_1645.xml,80444/xv65496,1,1,0,2
"Unknown",waufrenchwendelll2948.xml,80444/xv07400,0,2,0,2
"Francis (Amelia "Minnie" Francis)",wauhortonameliaminniefrancis5939.xml,80444/xv76022,0,0,2,2
"Stanley (William) Photograph Album",waustanleywilliamphcoll103.xml,80444/xv61968,0,1,1,2
"Unknown",wauxelfer4998.xml,80444/xv99450,1,1,0,2
"Seattle High School Teachers' League.",wauseattlehighschoolteachersleague0786.xml,80444/xv10137,0,2,0,2
"Unknown",wauuwresource07272.xml,80444/xv12878,0,1,1,2
"Unknown",wauloyalleagueofseattle4680.xml,80444/xv94503,1,0,1,2
"Unknown",waulevysolgeorge2077.xml,80444/xv00091,0,0,2,2
"Unknown",wauwashingtonstatephilologicalsociety5045.xml,80444/xv31536,2,0,0,2
"Unknown",waukikuchinaoki3811.xml,80444/xv29724,0,2,0,2
"University of Washington, Department of Medicine, Division of Allergy and Infectious Diseases Records",wauuwresource02664.xml,80444/xv80484,2,0,0,2
"Penington (Ruth,)",waupeningtonruth2837.xml,80444/xv45162,2,0,0,2
"Unknown",wauuwresource07300.xml,80444/xv64065,1,1,0,2
"Unknown",waurentonwilliam0803.xml,80444/xv79757,0,2,0,2
"University of Washington. Naval ROTC.",wauuwresource00122.xml,80444/xv66552,2,0,0,2
"Unknown",waupizzutolaura2666.xml,80444/xv85128,0,0,2,2
"Unknown",waunakkerudtrygve4075.xml,80444/xv40444,0,2,0,2
"University of Washington. School of Art. Division of Art History.",wauuwresource00288.xml,80444/xv97616,0,2,0,2
"Unknown",waufarwellhollis3712.xml,80444/xv77072,0,2,0,2
"Northwest Photographers Photograph Collection",wauyounorthwestphotographersphcoll420.xml,80444/xv12252,0,2,0,2
"Unknown",wautacomawashfaircommission4921.xml,80444/xv68322,0,0,2,2
"Unknown",wauquintesther5332.xml,80444/xv84963,0,0,2,2
"Unknown",wausteinbergriva3666.xml,80444/xv47610,2,0,0,2
"Unknown",wauwashingtonbankersassociation4949.xml,80444/xv15246,2,0,0,2
"Puget Sound Pulp and Timber Company Photograph Album",waupugetsoundpulptimberphcoll64.xml,80444/xv22131,0,0,2,2
"Hirschmann (Trude) Papers",wauhirschmanntrude5514.xml,80444/xv45642,1,0,1,2
"Unknown",wauuniversitycommunityclubseattlewash4928.xml,80444/xv48046,0,1,1,2
"Yukon and Northwest Territories Trips Photographs",wauyukonnorthwestterritoriesph2008_026.xml,80444/xv45919,2,0,0,2
"University of Washington Medical and Dental School Students Photograph Collection",wauuwschoolofmedicinestudentportraitsph2016_011.xml,80444/xv59719,0,0,2,2
"Unknown",wautworogerphilip5388.xml,80444/xv85174,2,0,0,2
"Unknown",waumageejohnb1055.xml,80444/xv48071,0,0,2,2
"Juenemann (Kathy) Photograph Collection",waujuenemannkathyphcoll150.xml,80444/xv45632,0,1,1,2
"Unknown",wauloussacada2364.xml,80444/xv57937,0,2,0,2
"Unknown",waumorrelldorothyc3576.xml,80444/xv71643,1,0,1,2
"Buckhorn Lodge Photographs",waubuckhornlodgeph2016_023.xml,80444/xv22354,2,0,0,2
"United States. Inter-agency Committee on Water Resources.",wauunitedstatesinteragencycommitteeonwaterresources1048.xml,80444/xv86883,0,0,2,2
"Unknown",waufarrartimothy0510.xml,80444/xv56820,2,0,0,2
"Unknown",wautacomacivicballet5943.xml,80444/xv25366,2,0,0,2
"Griffiths (Gordon)",waugriffithsgordonua5261.xml,80444/xv51150,0,2,0,2
"Woessner (Frank A.) Photographs",wauwoessnerfrankaphcoll156.xml,80444/xv44625,2,0,0,2
"Johnson (Duane) Travel Photograph Album",waujohnsonduanephcoll104.xml,80444/xv14608,1,1,0,2
"University of Washington. Nuclear Physics Laboratory.",wauuwresource00314.xml,80444/xv33020,0,1,1,2
"Touchet River and Dam Photographs",wautouchetriveranddamph2016_017.xml,80444/xv16439,0,0,2,2
"Unknown",waukingestherricklesweis3489.xml,80444/xv85998,2,0,0,2
"Unknown",waunewmanjohnhenry4832.xml,80444/xv24832,2,0,0,2
"Unknown",wauptarmiganclimbingclub2189.xml,80444/xv70080,0,2,0,2
"Unknown",waumusicandartfoundationseattlewashmagnoliaunit2999.xml,80444/xv45770,2,0,0,2
"Loundagin (J.B.) Photographs of Waitsburg, Washington",wauloundaginjbphcoll876.xml,80444/xv64019,0,2,0,2
"Unknown",wauleagueofwomenvotersoftacomapiercecounty1415.xml,80444/xv39935,0,0,2,2
"Development of an Infantile Psychosis film",wauinfantilepsychosisfilmphcoll1202.xml,80444/xv71566,1,1,0,2
"Richard J. Blandau Film Collection",waublandaurichardjfilmsphcoll1003.xml,80444/xv42797,2,0,0,2
"Unknown",wauskinnerjoanua2600.xml,80444/xv90481,0,0,2,2
"Jensen (Grace and Ludolf) Collection of Photographs of China",waujensengraceandludolfph2016_028.xml,80444/xv91238,0,2,0,2
"Unknown",waustabecktostenkittelsen2531.xml,80444/xv62802,0,2,0,2
"Unknown",waupailthorpmichellel2079.xml,80444/xv03762,1,1,0,2
"Rohrer (John) Architectural Illustrations",waurohrerjohnph2016_045.xml,80444/xv01696,0,2,0,2
"Unknown",wauandersonmargaret3753.xml,80444/xv71005,0,0,2,2
"Unknown",waukonoi2472.xml,80444/xv41171,0,0,2,2
"Unknown",wauseattleclayclubseattlewash2646.xml,80444/xv39694,1,0,1,2
"Trumbull (Harlan)",wautrumbullharlanphcoll1221.xml,80444/xv91467,0,0,2,2
"Rubin (Grace) Papers",waurubingrace5924.xml,80444/xv83389,1,0,1,2
"Unknown",waupettetwilliame1702.xml,80444/xv48919,2,0,0,2
"Unknown",waulurieedith2283.xml,80444/xv91479,0,2,0,2
"Unknown",waumethowtradingcompany4820.xml,80444/xv93066,0,0,2,2
"Unknown",wauuwresource07307.xml,80444/xv94155,1,1,0,2
"Kolloen Family Photograph Collection",waukolloenfamilyphcoll731.xml,80444/xv32717,0,0,2,2
"West Shore Engravings",wauwestshoreph2016_026.xml,80444/xv83856,0,2,0,2
"Unknown",waufreeselawrencetoby2183.xml,80444/xv29449,0,0,2,2
"Watch Tacoma Grow postcards",wauwatchtacomagrowphcoll1127.xml,80444/xv34289,1,1,0,2
"Griffith (Thomas) Papers",waugriffiththomas5445.xml,80444/xv04089,1,1,0,2
"Kalet (Ira J.) Papers",waukaletirajua6021.xml,80444/xv92382,0,0,2,2
"Wenatchee world.",wauwenatcheeworld1961.xml,80444/xv53277,0,2,0,2
"Johnsonian Society (University of Washington).",waujohnsoniansociety5057.xml,80444/xv13644,1,1,0,2
"Unknown",waumountainsafetyresearchinc3800.xml,80444/xv53247,2,0,0,2
"Unknown",waufosterdonald2847.xml,80444/xv39813,2,0,0,2
"Synapse.",wausynapse4919.xml,80444/xv50128,1,1,0,2
"Qamar (Anthony) Papers",wauqamaranthonyua5971.xml,80444/xv62844,0,1,1,2
"Unknown",wauuwresource07372.xml,80444/xv92211,1,1,0,2
"UW Medicine Marketing Records",wauuwresource06355.xml,80444/xv57232,2,0,0,2
"Unknown",wauseamansherbertl1876.xml,80444/xv51672,2,0,0,2
"Detlie (John S.) Papers",waudetliejohn5479.xml,80444/xv33700,1,1,0,2
"Unknown",waumeskimenfrances3416_001_24.xml,80444/xv05044,0,1,1,2
"Unknown",waurichardsonelmo2051.xml,80444/xv93627,1,1,0,2
"Blond (William) Papers",waublondwilliam5977.xml,80444/xv81103,0,0,2,2
"Unknown",wauhoskinsonrileym4759.xml,80444/xv39611,2,0,0,2
"Unknown",waufriedmanruth2796.xml,80444/xv31216,2,0,0,2
"Mt. Baker National Forest (Agency : U.S.).",waumtbakernationalforest1572.xml,80444/xv87710,1,1,0,2
"Unknown",waufurthjacob3105.xml,80444/xv84872,0,0,2,2
"Unknown",waugoodellannamaria4656.xml,80444/xv40927,0,2,0,2
"Unknown",waucotywam4711.xml,80444/xv02645,2,0,0,2
"Mount St. Helens Eruption Log",waumtsthelenslog5861.xml,80444/xv87680,2,0,0,2
"Unknown",waulippincottmarianne3625.xml,80444/xv57022,0,0,1,1
"Unknown",wauarmstrongolive3790.xml,80444/xv67422,0,0,1,1
"Booth (T. William) Papers",wauboothtwilliam5525.xml,80444/xv27728,1,0,0,1
"Unknown",wauamericansocietyoflandscapearchitectspacificnorthwestchapter4447.xml,80444/xv23788,0,0,1,1
"Unknown",wauvandenberghebenjamini5160.xml,80444/xv06439,0,0,1,1
"Unknown",waustevensfamily0051.xml,80444/xv29470,1,0,0,1
"Hult (Ruby El) Papers",wauhultrubyel0376.xml,80444/xv57220,0,1,0,1
"Unknown",wauseligmanfred3134.xml,80444/xv40567,0,1,0,1
"Unknown",waulipmanherbert2301.xml,80444/xv87606,0,1,0,1
"Unknown",wauulonskacarl0788.xml,80444/xv63684,0,0,1,1
"Unknown",wauanthonyhelenb3628.xml,80444/xv28793,0,0,1,1
"McDonald (R.)",waumcdonaldrtphcoll1099.xml,80444/xv90356,0,0,1,1
"Unknown",waueellsedwin4721.xml,80444/xv52706,0,1,0,1
"Unknown",waukerrjamesa3966.xml,80444/xv66470,0,1,0,1
"Unknown",wauokadarobert3064.xml,80444/xv89382,1,0,0,1
"Unknown",waualvordbenjamin4690.xml,80444/xv29385,0,0,1,1
"Unknown",wauschwartzharry2894.xml,80444/xv44891,0,1,0,1
"Unknown",waubarnetthg1293.xml,80444/xv70901,0,0,1,1
"Unknown",waufreydjane5029.xml,80444/xv57772,1,0,0,1
"Unknown",wausephardichousepacificnorthwestbranch4298.xml,80444/xv13388,0,0,1,1
"Unknown",waubaumannhenrynicholas0992.xml,80444/xv45480,1,0,0,1
"Unknown",waulesbiangayfreedomdaycommittee4468.xml,80444/xv13232,0,1,0,1
"Whiteley (Arthur H.) Marine Developmental Biology Films",wau_uwmc2015.01.xml,80444/xv24978,0,1,0,1
"Unknown",wausiegalsarah0963.xml,80444/xv45306,0,1,0,1
"Unknown",waustroumjewishcc5851.xml,80444/xv64245,1,0,0,1
"Holm (Bill) Papers",wauua19_17_2952holmbill.xml,80444/xv72855,0,1,0,1
"Unknown",waubrownmarykosher3785.xml,80444/xv50952,1,0,0,1
"Unknown",waurogowayestherschreiber2192.xml,80444/xv12228,0,0,1,1
"Unknown",wauwashingtonstatefederationofbusinessandprofessionalwomensclubs4232.xml,80444/xv50271,1,0,0,1
"Sherman (John C.) Papers",waushermanjohnua4348.xml,80444/xv94763,0,0,1,1
"Unknown",waubrennerruthkutoff2419.xml,80444/xv55664,1,0,0,1
"Unknown",waunicholscharles4782.xml,80444/xv14190,0,0,1,1
"Unknown",wausatoeddie4586.xml,80444/xv89562,0,1,0,1
"Seattle Parks Construction Projects Photograph Collection",wauseattleparksconstructionprojectsphcoll768.xml,80444/xv35064,1,0,0,1
"Unknown",wauwheelerjeanieshaw3937.xml,80444/xv31356,0,1,0,1
"Unknown",waumcclurehorace4686.xml,80444/xv52291,0,0,1,1
"Unknown",wauunitedcustomersforallamericanhiringatuniversityvillage1328.xml,80444/xv89602,0,0,1,1
"Unknown",wauterryca3234.xml,80444/xv85693,0,1,0,1
"Unknown",wausaveourvalley5293.xml,80444/xv76574,1,0,0,1
"Unknown",wauseattlelakeshoreandeasternrailwaycompany3778.xml,80444/xv02288,0,0,1,1
"Unknown",waubulkleycharless0335.xml,80444/xv19372,0,0,1,1
"Matsuda Family Papers",waumatsudafamily5933.xml,80444/xv90652,0,0,1,1
"Unknown",wauaramakiakira1028.xml,80444/xv72445,1,0,0,1
"Unknown",wauwashingtoncemeteryassociation5391.xml,80444/xv01834,0,0,1,1
"Unknown",wausparkmanidarose0827.xml,80444/xv64169,0,1,0,1
"Unknown",waucookecharlesp4231.xml,80444/xv81066,1,0,0,1
"Unknown",waustevensthomaswood3782.xml,80444/xv59014,1,0,0,1
"Unknown",wauchartiercolleen3635.xml,80444/xv12969,0,1,0,1
"Southern India Photograph Collection",wausouthernindiaphcoll675.xml,80444/xv78669,0,1,0,1
"Unknown",wauleedouglasw3558.xml,80444/xv71765,0,1,0,1
"Unknown",wauthomaston4922.xml,80444/xv93191,0,1,0,1
"Unknown",waukirkpeter0049.xml,80444/xv38302,1,0,0,1
"Unknown",waujohnstondonaldt1437.xml,80444/xv12255,0,1,0,1
"Unknown",wauuwresource07397.xml,80444/xv53121,0,0,1,1
"Herrero (Mario E. Chavez Peon) Linguistic Field Research",wauherreromarioechavezpeon2696.xml,80444/xv15213,1,0,0,1
"Edwards (Myrtle)",wauedwardsmyrtle1391_1717_1766.xml,80444/xv02890,1,0,0,1
"Unknown",waudescaveslucien4644.xml,80444/xv00256,0,0,1,1
"Unknown",waulewisrhodasussman4049.xml,80444/xv32443,0,1,0,1
"Unknown",waudocterraymond5333.xml,80444/xv02633,0,0,1,1
"Unknown",waulawsonmanya2267.xml,80444/xv49496,0,1,0,1
"Unknown",waupennminingcompany3556.xml,80444/xv70788,0,1,0,1
"Unknown",wauschoenfeldherberta1247.xml,80444/xv56286,0,0,1,1
"Unknown",wauhopkinsgeorges1387.xml,80444/xv35174,1,0,0,1
"University of Washington Center for AIDS and Sexually Transmitted Diseases Records",wauuwresource00761.xml,80444/xv17846,0,1,0,1
"University of Washington Office of Government Relations Records",wauuwresource00529.xml,80444/xv53179,1,0,0,1
"Unknown",wauhodgefrederickwebb4079.xml,80444/xv62744,0,1,0,1
"Unknown",wauleedrogerm4559.xml,80444/xv57409,0,1,0,1
"Unknown",wauolsengeorgecarl1672.xml,80444/xv01654,1,0,0,1
"Brand (William L.) Papers",waubrandwilliaml5589.xml,80444/xv50640,1,0,0,1
"Unknown",waukelloggalberthenry4764.xml,80444/xv18222,0,1,0,1
"Unknown",waugaytonleonard4736.xml,80444/xv73687,1,0,0,1
"Unknown",waumartinrobertw4579.xml,80444/xv26965,0,1,0,1
"Unknown",waufisherwilliam3184.xml,80444/xv91769,0,1,0,1
"Unknown",waugreenegeorgewashington0816.xml,80444/xv57470,0,0,1,1
"Unknown",waupeoplessavingsbank0574.xml,80444/xv83908,1,0,0,1
"Unknown",waurindmartin3603.xml,80444/xv03552,0,0,1,1
"Temple Beth Hatfiloh Records",wautemplebethhatfiloh5921.xml,80444/xv16864,1,0,0,1
"Unknown",waugideonrussells1971.xml,80444/xv71249,0,1,0,1
"Unknown",wausalomonherbertj2883.xml,80444/xv04309,0,0,1,1
"Unknown",wauandersoncaroline3153.xml,80444/xv67639,0,0,1,1
"University of Washington. Process Analytical Chemistry Center (CPAC).",wauuwresource00303.xml,80444/xv77056,0,0,1,1
"Hotson (John W.) Papers",wauhotsonjohnua5341.xml,80444/xv86166,0,1,0,1
"Unknown",wausadickida2826.xml,80444/xv39181,1,0,0,1
"Unknown",wauwashingtonadhoccoalitiononcentralamerica4450.xml,80444/xv51455,0,1,0,1
"University of Washington Child Development Research Group Records",wauuwresource06532.xml,80444/xv98291,0,0,1,1
"Unknown",waumercerlyle5147.xml,80444/xv95361,1,0,0,1
"Unknown",waumorganmurraycromwell0147.xml,80444/xv27874,0,1,0,1
"Ensly (Sam) Travel Diary on the Cable Ship Dellwood",wauenslysam5546.xml,80444/xv97546,1,0,0,1
"Seattle Citizens' Committee on Comic Books.",wauseattlecitizenscommitteeoncomicbooks1069.xml,80444/xv05541,0,0,1,1
"Unknown",waupoplackalvinm4402.xml,80444/xv85021,0,1,0,1
"Unknown",waualtarasalbert2562.xml,80444/xv41641,1,0,0,1
"University of Washington Libraries Serials Division",wauuwresource07251.xml,80444/xv72470,0,0,1,1
"Harper Consolidated Mines album",wauharperconsolidatedmines5582.xml,80444/xv02774,1,0,0,1
"Unknown",wauuspublicroadsadvisoryboardsuspensionbridges5887.xml,80444/xv69000,1,0,0,1
"Curtis (Asahel) Mount Rainier Photograph",waucurtisasahelmountrainierphcoll218.xml,80444/xv94882,0,1,0,1
"Unknown",waumothersandfathersagainstthedraft4281.xml,80444/xv65542,0,1,0,1
"Unknown",wauunionlimecompanyrepublicwash1915.xml,80444/xv23724,0,1,0,1
"Unknown",wauunitedstatesdeptoftheinterior3485.xml,80444/xv49142,0,1,0,1
"Unknown",waumeisnestfrederickwilliam0211.xml,80444/xv98052,1,0,0,1
"Unknown",waumanningella3080.xml,80444/xv91888,0,1,0,1
"Unknown",waucrowleygeorgedefensefund1252.xml,80444/xv05990,0,1,0,1
"Unknown",waumatsudairamitch2463.xml,80444/xv91247,0,0,1,1
"Unknown",waubrownnils5106.xml,80444/xv96359,0,0,1,1
"Unknown",wauaxworthydwayne3517.xml,80444/xv55801,1,0,0,1
"Unknown",waufriedmanfanniek3216.xml,80444/xv15731,1,0,0,1
"Unknown",waunormanben5239.xml,80444/xv33627,1,0,0,1
"Western Alaska Mining and Industrial Co.",wauwesternalaskaminingandindustrialco0879.xml,80444/xv29360,1,0,0,1
"Unknown",waufujiihenry0938.xml,80444/xv89782,0,0,1,1
"Unknown",waukingcountybarassociationwash3487.xml,80444/xv92114,1,0,0,1
"Unknown",waufosslaura2608.xml,80444/xv28631,1,0,0,1
"Unknown",waufeinberghelenkosokoff4158.xml,80444/xv07205,1,0,0,1
"Unknown",waufryegeorgefrederick4651.xml,80444/xv05734,1,0,0,1
"Seattle for Fluoridation.",wauseattleforfluoridation4885.xml,80444/xv25839,0,1,0,1
"Unknown",waumetcalfjamesthomas0944.xml,80444/xv91165,1,0,0,1
"Unknown",wauhancocksamuel4744.xml,80444/xv21420,0,1,0,1
"Unknown",wauwrightwilliamt4983.xml,80444/xv66909,0,0,1,1
"Unknown",wausonsofnorwayusdistrict5212.xml,80444/xv44509,0,1,0,1
"Unknown",waumerzfrankjsheetmetal0229.xml,80444/xv77447,1,0,0,1
"Unknown",waupabstmarieb3759.xml,80444/xv85394,1,0,0,1
"Unknown",waurobinsonjeromebenjamin4161.xml,80444/xv62316,0,0,1,1
"New Perspectives on Alcoholism",waunewperspectivesonalcoholismfilmphcoll1271.xml,80444/xv89807,0,1,0,1
"University of Washington. School of Pharmacy. Alumni Association.",wauuwresource00424.xml,80444/xv45236,0,1,0,1
"Steinberg (Samual and Dora) Papers",wausteinbergsamuelanddora5927.xml,80444/xv23953,1,0,0,1
"Unknown",wausylvestercoweninvestmentcompany2086.xml,80444/xv14184,0,0,1,1
"Unknown",waupringlerobertwilliam1344.xml,80444/xv77609,0,1,0,1
"Unknown",waukaminoffmax5334.xml,80444/xv66754,1,0,0,1
"Unknown",wauseattlehistoricalsociety4887.xml,80444/xv83291,0,0,1,1
"Strauss (Louis,)",waustrausslouismrs1243_1931_1932.xml,80444/xv56198,0,1,0,1
"University of California, Berkeley. College of Environmental Design.",wauuniversityofcaliforniaberkeleycollegeofenvironmentaldesign1426.xml,80444/xv36761,0,1,0,1
"University of Washington Vice President for Academic Affairs and Provost records",wauuwresource07686.xml,80444/xv06402,0,0,1,1
"Unknown",wauconantroger0398.xml,80444/xv70751,1,0,0,1
"Wagner (Charles Franklin) University of Washington Photograph Album",wauwagnercharlesfranklinphcoll122.xml,80444/xv14404,0,1,0,1
"Unknown",wauneddermeyerseth4144.xml,80444/xv38357,1,0,0,1
"Unknown",wausnohomishriverbasincitizenscommittee5835.xml,80444/xv60562,1,0,0,1
"Unknown",waupearsonagnes2459.xml,80444/xv10372,0,0,1,1
"Unknown",wauwickpeterd2246.xml,80444/xv92434,1,0,0,1
"Dutch Harbor, Alaska, World War II Photograph Collection",waudutchharborphcoll633.xml,80444/xv23264,0,0,1,1
"Unknown",waushimanakafamily3557.xml,80444/xv54147,0,1,0,1
"Unknown",wausokkappabalrajgnana5416.xml,80444/xv77096,1,0,0,1
"Unknown",waurosenhelengrunbaum3884.xml,80444/xv91174,1,0,0,1
"Unknown",wauroeselgotteried3429.xml,80444/xv12185,1,0,0,1
"Unknown",wauthompsonlucillemildred3757.xml,80444/xv09405,0,1,0,1
"Washington State Chamber of Commerce.",wauwashingtonstatechamberofcommerce0830.xml,80444/xv50881,0,0,1,1
"Nome (Alaska) Photograph Album",waunomephotoalbumph2005_050.xml,80444/xv69351,1,0,0,1
"Unknown",waurosenherberti3506.xml,80444/xv06533,0,0,1,1
"Unknown",waufisherannebannebenson5374.xml,80444/xv64578,0,1,0,1
"Unknown",wauschwartzlouis2685.xml,80444/xv02215,0,1,0,1
"University of Washington. Dept. of Statistics.",wauuwresource00326.xml,80444/xv86157,0,0,1,1
"Unknown",waucrowtherjamesedwin4715.xml,80444/xv49911,1,0,0,1
"Unknown",wauseattlesephardicheritagecommittee3988.xml,80444/xv60873,0,0,1,1
"Unknown",wauseattlegeneralreliefcommitteeseattlewash4886.xml,80444/xv30245,0,1,0,1
"Gutmann (Addis) Papers",waugutmannaddis1902.xml,80444/xv78515,1,0,0,1
"Unknown",wauamesrobertwitt1094.xml,80444/xv11285,0,1,0,1
"University of Washington Center for Commercialization Records",wauuwresource07758.xml,80444/xv31167,0,1,0,1
"University of Washington Office of Public Records",wauuwresource00208.xml,80444/xv08535,1,0,0,1
"Seattle Lighting Company Albums",wauseattlelightingcompanyphcoll050.xml,80444/xv77389,0,0,1,1
"Unknown",waulinddavida2196.xml,80444/xv14187,0,0,1,1
"Johnson (Tanya) Photograph Collection",waujohnsontanyaphcoll402.xml,80444/xv79107,1,0,0,1
"Unknown",waukimurayutaka4769.xml,80444/xv28756,0,0,1,1
"Unknown",waugallemoremelvina0144.xml,80444/xv13986,1,0,0,1
"Washington Territory. School District No. 2 (Kitsap County).",wauwashingtonterritoryschooldistrictno24956.xml,80444/xv71667,1,0,0,1
"Woman's Destiny--Choice or Chance? (1963 : Seattle, Wash.).",wauwomansdestinychoiceorchance5246.xml,80444/xv53060,1,0,0,1
"Unknown",wauandersonalfredh3103.xml,80444/xv14331,1,0,0,1
"Washington Citizens for Abortion Reform Records",wauwacitizensabortionreform1865.xml,80444/xv34209,1,0,0,1
"University of Washington. Disabled Student Services Office.",wauuwresource00155.xml,80444/xv07757,0,1,0,1
"Unknown",wausonsofisraelseattlewash2225.xml,80444/xv85955,0,1,0,1
"Unknown",waupeacheyernestc2167.xml,80444/xv54776,0,0,1,1
"Unknown",waubainbridgeislandnorthkitsapjewishchavurah3279.xml,80444/xv52468,0,0,0,0
"Unknown",waupullendanield5015.xml,80444/xv36196,0,0,0,0
"Unknown",waubanksmary3435.xml,80444/xv82177,0,0,0,0
"University of Washington. Vice Provost for Educational Development.",wauuwresource00180.xml,80444/xv10385,0,0,0,0
"Unknown",waufarrargeraldine0995.xml,80444/xv77899,0,0,0,0
"Unknown",wauuwresource07335.xml,80444/xv79898,0,0,0,0
"Unknown",wauspearmanelihu4904.xml,80444/xv34704,0,0,0,0
"Unknown",wauwilliamstheodoreo4971.xml,80444/xv23162,0,0,0,0
"Unknown",waubipartisancivilrightsnewsletter1067.xml,80444/xv87878,0,0,0,0
"Unknown",waustanforduniversitymuseumofart4296.xml,80444/xv76931,0,0,0,0
"Unknown",wauconnisrichardt2715.xml,80444/xv55953,0,0,0,0
"Unknown",wauyoungzeev4211.xml,80444/xv92123,0,0,0,0
"Unknown",waubushhenry2792.xml,80444/xv52398,0,0,0,0
"Unknown",waueichlerdavid3834.xml,80444/xv61383,0,0,0,0
"Unknown",waulefflerjohncompton1601.xml,80444/xv29745,0,0,0,0
"Unknown",waushapirohelen2518.xml,80444/xv36682,0,0,0,0
"Unknown",wauuwresource07395.xml,80444/xv20538,0,0,0,0
"Unknown",wauflightf3448.xml,80444/xv66821,0,0,0,0
"Unknown",waubrackettdansan1261.xml,80444/xv48190,0,0,0,0
"Unknown",wauunitedstatesarmy5243.xml,80444/xv65008,0,0,0,0
"Unknown",waudilworthhirampowers4717.xml,80444/xv34634,0,0,0,0
"Unknown",wauholzmanlenakleinberg3199.xml,80444/xv04043,0,0,0,0
"Unknown",waurussianstudentassociationinthestateofwashington0626.xml,80444/xv09121,0,0,0,0
"Unknown",wauhartsonclintonh3116.xml,80444/xv59640,0,0,0,0
"Unknown",waulymanjohnc3946.xml,80444/xv26199,0,0,0,0
"Unknown",waupopeandrewj4850.xml,80444/xv78213,0,0,0,0
"Unknown",wauwashingtonstatecommunityactionprogramdirectorsassociationinc1076.xml,80444/xv73983,0,0,0,0
"Unknown",waumabbottmaryjanepease3791.xml,80444/xv13897,0,0,0,0
"Unknown",waupricermel3420.xml,80444/xv76171,0,0,0,0
"Unknown",waurodansusanfeldman2526.xml,80444/xv31295,0,0,0,0
"Unknown",wauoharapatrick2174.xml,80444/xv52459,0,0,0,0
"Unknown",wauhilljamesjerome4756.xml,80444/xv55892,0,0,0,0
"University of Washington Work/Life Records",wauuwresource05744.xml,80444/xv18020,0,0,0,0
"University of Washington. Dept. of Biochemistry.",wauuwresource00400.xml,80444/xv66418,0,0,0,0
"Unknown",wauchurchofjesuschristchristianaryannations4031.xml,80444/xv06448,0,0,0,0
"Unknown",wauphilippineinternmentcampno2825.xml,80444/xv58410,0,0,0,0
"Undergraduate English Association (University of Washington).",wauundergraduateenglishassociation5063.xml,80444/xv36755,0,0,0,0
"Raitt (Effie)",wauraitteffieiua4102.xml,80444/xv00747,0,0,0,0
"Unknown",wauandersondonaldk5103.xml,80444/xv01150,0,0,0,0
"Unknown",wauuwresource00108.xml,80444/xv21343,0,0,0,0
"Unknown",waukoriyamafranklin3274.xml,80444/xv29266,0,0,0,0
"Unknown",waushortwilliamm4891.xml,80444/xv88418,0,0,0,0
"Unknown",wauwoodsidegordon2449.xml,80444/xv07043,0,0,0,0
"Unknown",wauwadakango1590.xml,80444/xv59042,0,0,0,0
"Unknown",waugarfiasrobert2508.xml,80444/xv83575,0,0,0,0
"Unknown",wauthurstonsamuelroyal4924.xml,80444/xv31066,0,0,0,0
"Unknown",waucoopercarl0595.xml,80444/xv13916,0,0,0,0
"University of Washington. Dept. of Surgery.",wauuwresource00388.xml,80444/xv30337,0,0,0,0
"Unknown",wauuwresource07316.xml,80444/xv92672,0,0,0,0
"Unknown",waubainbridgeislandhistoricalsociety5230.xml,80444/xv77844,0,0,0,0
"Unknown",wauwenerfamily2684.xml,80444/xv61605,0,0,0,0
"Seattle (Wash.).",waucensusofseseattle4902.xml,80444/xv30834,0,0,0,0
"Unknown",waulyonscharless3108.xml,80444/xv38436,0,0,0,0
"Unknown",wausternedwardf2969.xml,80444/xv93704,0,0,0,0
"Unknown",waulundmarievognild4077.xml,80444/xv37448,0,0,0,0
"Unknown",wausugarpeterf4160.xml,80444/xv03323,0,0,0,0
"Unknown",wauwestcoastwanda2740.xml,80444/xv39559,0,0,0,0
"University of Washington Department of Applied Mathematics Records",wauuwresource00324.xml,80444/xv90020,0,0,0,0
"Unknown",wauhearstbennie4752.xml,80444/xv56054,0,0,0,0
"University of Washington Business and Economic Development Program Records",wauuwresource07413.xml,80444/xv80590,0,0,0,0
"Unknown",wauligertrauderoth3684.xml,80444/xv97940,0,0,0,0
"Unknown",waudrumhellerdan5238.xml,80444/xv65203,0,0,0,0
"University of Washington. School of Art.",wauuwresource00287.xml,80444/xv60421,0,0,0,0
"Unknown",wauhamerslythomashs4743.xml,80444/xv08111,0,0,0,0
"Unknown",waujonesjones4280.xml,80444/xv37240,0,0,0,0
"Unknown",wauconventofthesacredheartshanghaichina3033.xml,80444/xv36889,0,0,0,0
"Unknown",waustudentscooperativeassociationuw0032.xml,80444/xv41629,0,0,0,0
"University of Washington. Language Learning Center.",wauuwresource00321.xml,80444/xv91253,0,0,0,0
"Unknown",wautaylorcharlesw4785.xml,80444/xv12991,0,0,0,0
"Unknown",wauweissbergmuriel4400.xml,80444/xv50476,0,0,0,0
"Unknown",wauhornrichard2309.xml,80444/xv91665,0,0,0,0
"Unknown",wauchristinalouisehelena2030.xml,80444/xv34304,0,0,0,0
"Unknown",wauricklesjulius0962.xml,80444/xv46377,0,0,0,0
"University of Washington. Physical Plant Dept.",wauuwresource00123.xml,80444/xv90512,0,0,0,0
"Unknown",wauluedersmargaretlouise3565.xml,80444/xv43963,0,0,0,0
"University of Washington. Libraries. Collection Development and Management Office.",wauuwresource01422.xml,80444/xv96270,0,0,0,0
"University of Washington. School of Medicine. Pulmonary and Critical Care Division.",wauuwresource00395.xml,80444/xv72698,0,0,0,0
"Unknown",waunelsonsharley2634.xml,80444/xv77859,0,0,0,0
"University of Washington. Northwest Lipid Research Center.",wauuwresource00397.xml,80444/xv11953,0,0,0,0
"University of Washington. Medical Center. Pharmacy.",wauuwresource00228.xml,80444/xv91928,0,0,0,0
"Cameron (Frank) papers",waucameronfrank5959.xml,80444/xv82919,0,0,0,0
"Unknown",wauverite4802.xml,80444/xv73565,0,0,0,0
"University of Washington. Dept. of Ophthalmology.",wauuwresource00410.xml,80444/xv82073,0,0,0,0
"University of Washington Department of Building Construction Records",wauuwresource00580.xml,80444/xv87860,0,0,0,0
"Unknown",wauwesterndivisionconferenceofdeansofwomen3330.xml,80444/xv23361,0,0,0,0
"Unknown",wauchaluptrene4630.xml,80444/xv37002,0,0,0,0
"Unknown",wauericksonkarlo0386.xml,80444/xv02020,0,0,0,0
"Unknown",wauedwardsharlanhammond3841.xml,80444/xv83261,0,0,0,0
"Unknown",waugilbertjohnn0117.xml,80444/xv94808,0,0,0,0
"Townsend (Jamer R.) Papers",wautownsendjamesua5379.xml,80444/xv22033,0,0,0,0
"Unknown",wauhurwitzsamuel3440.xml,80444/xv39315,0,0,0,0
"Unknown",wauuwresource07303.xml,80444/xv45462,0,0,0,0
"Unknown",waublumbergmary4203.xml,80444/xv21725,0,0,0,0
"Unknown",wauenglishspeakingunionseattlebranch0258.xml,80444/xv40023,0,0,0,0
"Unknown",waumossaferdavid1742.xml,80444/xv14666,0,0,0,0
"Unknown",waugrimesleola4742.xml,80444/xv91305,0,0,0,0
"Seattle (Wash.). Freeholders Board.",wauseattlefreeholdersboard2408.xml,80444/xv08166,0,0,0,0
"Unknown",waudeanluellamary5357.xml,80444/xv19778,0,0,0,0
"Unknown",waucourtadecj0815.xml,80444/xv28790,0,0,0,0
"Unknown",wauparsonsfamily0814.xml,80444/xv38955,0,0,0,0
"Unknown",waumeldsophiek4397.xml,80444/xv13763,0,0,0,0
"Unknown",waucoalproducersassociationofwashington5945.xml,80444/xv75604,0,0,0,0
"University of Washington. Religious Directors Association.",wauuniversityofwashingtonreligiousdirectorsassociation3454.xml,80444/xv07363,0,0,0,0
"University of Washington Library Systems Coordinating Committee. Task Force on Authority Control Records",wauuwresource00583.xml,80444/xv15533,0,0,0,0
"Unknown",waubermannicholas4229.xml,80444/xv42254,0,0,0,0
"University of Washington. Office of Educational Assessment.",wauuwresource00154.xml,80444/xv93917,0,0,0,0
"Unknown",waurileyedithdolan0388.xml,80444/xv58477,0,0,0,0
"Unknown",wauuwresource07370.xml,80444/xv51388,0,0,0,0
"Unknown",wausugimachimiyoshi1017.xml,80444/xv79379,0,0,0,0
"Seattle (Wash.). Engineering Dept.",wauseattleengineeringdept5100.xml,80444/xv30938,0,0,0,0
"Unknown",wauwarshalfamily3582.xml,80444/xv55596,0,0,0,0
"Unknown",wauroederelizabetha4868.xml,80444/xv81466,0,0,0,0
"Isle of Funen",wauisleoffunenphcoll1340.xml,80444/xv81781,0,0,0,0
"University of Washington. Junior Class, 1929.",wauuwresource05408.xml,80444/xv61508,0,0,0,0
"Unknown",wautagamafamily3815.xml,80444/xv80108,0,0,0,0
"Unknown",wauburnettpeterh4698.xml,80444/xv19332,0,0,0,0
"Unknown",wauunitedstatesnavymareislanddepot4937.xml,80444/xv59365,0,0,0,0
"Unknown",wauuwresource07385.xml,80444/xv06332,0,0,0,0
"Unknown",waucarroldawn2537.xml,80444/xv72344,0,0,0,0
"Unknown",wauthorpeberenicedurae0210.xml,80444/xv62915,0,0,0,0
"Unknown",wauibbitsenruthbloom2992.xml,80444/xv89901,0,0,0,0
"Unknown",wauuwresource07381.xml,80444/xv08190,0,0,0,0
"Unknown",waupassbertramr3929.xml,80444/xv06622,0,0,0,0
"Unknown",waumorseemilyhall2640.xml,80444/xv86584,0,0,0,0
"Unknown",wauwescottglenway4961.xml,80444/xv18624,0,0,0,0
"Unknown",waukayiralegson0991.xml,80444/xv51104,0,0,0,0
"Unknown",wauetkincecilie2513.xml,80444/xv08834,0,0,0,0
"Unknown",waujamessbushnellcompany4627.xml,80444/xv51202,0,0,0,0
"Unknown",waubensoncharlest2166.xml,80444/xv95611,0,0,0,0
"Unknown",waumagnussongudrunlindal3482.xml,80444/xv07382,0,0,0,0
"Unknown",waustusserpat2879.xml,80444/xv22189,0,0,0,0
"Unknown",waumaxeycarl3288.xml,80444/xv02700,0,0,0,0
"Unknown",wauwandesfordesmithgeoffrey1149.xml,80444/xv67651,0,0,0,0
"Unknown",waulevinrose2538.xml,80444/xv12673,0,0,0,0
"Moody (Fred) Papers",waumoodyfred5564.xml,80444/xv06433,0,0,0,0
"Unknown",waupathadarlenecamille2859.xml,80444/xv44772,0,0,0,0
"Unknown",wauseattlewashinterstatedesignadvisorycommittee1675.xml,80444/xv80010,0,0,0,0
"Unknown",waustregispapercompany5023.xml,80444/xv23794,0,0,0,0
"Unknown",wauryersondavida4877.xml,80444/xv77554,0,0,0,0
"Unknown",waupugetsoundregionalplanningcommission3632.xml,80444/xv71371,0,0,0,0
"Unknown",wausnyderanita1571.xml,80444/xv69583,0,0,0,0
"Unknown",wauverklerjerryt4382.xml,80444/xv36413,0,0,0,0
"Unknown",waugreenbergwilliamh3253.xml,80444/xv61288,0,0,0,0
"Unknown",waumountainrescueassnoralhistoryproject5984.xml,80444/xv36346,0,0,0,0
"Sidelsky family",wausidelskyfamily3068.xml,80444/xv30535,0,0,0,0
"Unknown",wauherrongeorge5241.xml,80444/xv06304,0,0,0,0
"Unknown",waupoggiclaudine3244.xml,80444/xv76303,0,0,0,0
"Unknown",waustarsofdavidseattlewash4006.xml,80444/xv47805,0,0,0,0
"Unknown",wauscottcharlesm2578.xml,80444/xv35455,0,0,0,0
"Unknown",waumcdonalddavid4687.xml,80444/xv88296,0,0,0,0
"Unknown",waustartwa4907.xml,80444/xv61099,0,0,0,0
"Unknown",wausobeljoanne5037.xml,80444/xv01818,0,0,0,0
"University of Washington. Women's Information Center.",wauuwresource00105.xml,80444/xv09017,0,0,0,0
"Unknown",wauhoadleyedward4662.xml,80444/xv50662,0,0,0,0
"Unknown",waucareyrolandn4197.xml,80444/xv13818,0,0,0,0
"Unknown",waularsenjacklenor2681.xml,80444/xv23336,0,0,0,0
"Unknown",waufisherlouise2522.xml,80444/xv25637,0,0,0,0
"Unknown",wauuwstudentactivitiesoffice.xml,80444/xv14572,0,0,0,0
"Student Opportunity Scholarships, Inc. (University of Washington).",waustudentopportunityscholarshipsinc3351.xml,80444/xv12152,0,0,0,0
"Unknown",wautsutakawamayumi2725.xml,80444/xv98739,0,0,0,0
"Sether (Percy) Photograph Collection",wausetherpercyphcoll1359.xml,80444/xv72711,0,0,0,0
"Unknown",waupugetsoundcooperativecolony0469.xml,80444/xv10824,0,0,0,0
"Unknown",waukapahisatpal5420.xml,80444/xv42608,0,0,0,0
"Unknown",wauschackthor2749.xml,80444/xv95999,0,0,0,0
"University of Washington. Vice Provost for Special Programs. Urban and Regional Affairs Division.",wauuwresource00109.xml,80444/xv72467,0,0,0,0
"Unknown",wauroperjackf2290.xml,80444/xv36791,0,0,0,0
"University of Washington. Campus Mailing Service.",wauuwresource00133.xml,80444/xv56530,0,0,0,0
"Thilberg (Nancy) Scrapbook",wauthilbergnancy5973.xml,80444/xv02551,0,0,0,0
"Sun Dodger Society (University of Washington).",wausundodgersociety4453.xml,80444/xv85668,0,0,0,0
"Unknown",wauoregonbark4778.xml,80444/xv45199,0,0,0,0
"Unknown",wauleejktheodore5227.xml,80444/xv69146,0,0,0,0
"Unknown",wauhughbecketattractions5214.xml,80444/xv72668,0,0,0,0
"Unknown",wauhasenyagerpearl2180.xml,80444/xv58770,0,0,0,0
"Unknown",waurobertsonmyrtlececelia3193.xml,80444/xv74325,0,0,0,0
"Unknown",wauhermanhenryet3111.xml,80444/xv99160,0,0,0,0
"Unknown",wauuwresource07378.xml,80444/xv73245,0,0,0,0
"Unknown",waustowerswilliam4912.xml,80444/xv44320,0,0,0,0
"Unknown",waukirklucy2854.xml,80444/xv38412,0,0,0,0
"Unknown",waunoonanrichardm4336.xml,80444/xv29589,0,0,0,0
"Unknown",wausmitheh5129.xml,80444/xv44393,0,0,0,0
"Willis Drummond letter relating to revisions of the California-Oregon border",waudrummondwillis5547.xml,80444/xv28607,0,0,0,0
"Unknown",waulendathomaso3035.xml,80444/xv01019,0,0,0,0
"Unknown",wautaylorjohnw1260.xml,80444/xv77603,0,0,0,0
"Unknown",waurobbinstom2567.xml,80444/xv56274,0,0,0,0
"Van Ardsol (Ted) Collection of Dam Photographs",wauvanardsoltedph2016_018.xml,80444/xv21322,0,0,0,0
"Unknown",wauzienharriets3854.xml,80444/xv87384,0,0,0,0
"Unknown",waunessverna4035.xml,80444/xv42855,0,0,0,0
"Unknown",waunakashimafamily3229.xml,80444/xv57031,0,0,0,0
"Unknown",waubensussanthomas3449.xml,80444/xv39114,0,0,0,0
"Unknown",waubertramjaspern4215.xml,80444/xv10931,0,0,0,0
"Unknown",waubryntesonjohn2282.xml,80444/xv91744,0,0,0,0
"Unknown",waulongfellowhenrywadsworth3277.xml,80444/xv59423,0,0,0,0
"Unknown",waubutlerml5121.xml,80444/xv27734,0,0,0,0
"Unknown",waunorrisel1904.xml,80444/xv82632,0,0,0,0
"Unknown",waupantojayarriagajuan4838.xml,80444/xv60165,0,0,0,0
"Washington Technology Center",wauuwresource07305.xml,80444/xv93530,0,0,0,0
"Unknown",wautreigerirwinl2440.xml,80444/xv95050,0,0,0,0
"Unknown",wauvolotinisrael3701.xml,80444/xv76153,0,0,0,0
"Unknown",wauowengiffordp3742.xml,80444/xv93240,0,0,0,0
"Unknown",wausloverclarkharris0577.xml,80444/xv68963,0,0,0,0
"Unknown",waubrownpolly4032.xml,80444/xv74285,0,0,0,0
"University of Washington. Dept. of Speech Communication.",wauuwresource00306.xml,80444/xv99057,0,0,0,0
"Unknown",wauwolfejesseb2759.xml,80444/xv79797,0,0,0,0
"Unknown",wauboothclarawallace4343.xml,80444/xv92504,0,0,0,0
"Unknown",wauchattertonthomas0829.xml,80444/xv00250,0,0,0,0
"Unknown",wauwaringgeorgee4948.xml,80444/xv25827,0,0,0,0
"Unknown",waurunnallsharrisboyle4875.xml,80444/xv29641,0,0,0,0
"Unknown",waulucecharles2855.xml,80444/xv27835,0,0,0,0
"Unknown",waurichardsonhollan4931.xml,80444/xv22640,0,0,0,0
"Unknown",waukatayamamayherd2464.xml,80444/xv37301,0,0,0,0
"Unknown",wauutterbackclinton2319.xml,80444/xv50875,0,0,0,0
"Unknown",wauwellsgerald1234.xml,80444/xv34436,0,0,0,0
"Unknown",waurandlauranceb3767.xml,80444/xv66375,0,0,0,0
"Unknown",waupeoplesmemorialassociationseattlewash4842.xml,80444/xv02536,0,0,0,0
"Unknown",waumcgovneyardiswoolery3438.xml,80444/xv82244,0,0,0,0
"Unknown",waugregorychapelarchitects4591.xml,80444/xv03207,0,0,0,0
"Unknown",wauoliveregberts3150.xml,80444/xv98449,0,0,0,0
"Unknown",waumoorebernicestarr3205.xml,80444/xv15930,0,0,0,0
"Unknown",wauhelmichkarin2865.xml,80444/xv35504,0,0,0,0
"Unknown",wauwilcoxruthb2937.xml,80444/xv60226,0,0,0,0
"Unknown",wauamericancanadianfisheriesconference4599.xml,80444/xv82144,0,0,0,0
"Unknown",waumajorrichardl5217.xml,80444/xv77734,0,0,0,0
"Unknown",wauroslynnews1204.xml,80444/xv48419,0,0,0,0
"Unknown",waufelibrige4725.xml,80444/xv98336,0,0,0,0
"Unknown",wauhenryfailingco4723.xml,80444/xv52975,0,0,0,0
"Unknown",wauallendale2311.xml,80444/xv34585,0,0,0,0
"Unknown",wauswedishcharitablesocietyofgreaterboston2259.xml,80444/xv04736,0,0,0,0
"Unknown",wauseattlewashpolllist4888.xml,80444/xv89080,0,0,0,0
"Unknown",waupugetsoundcourier4856.xml,80444/xv27621,0,0,0,0
"Unknown",wausakurahowardshigeru1274.xml,80444/xv23468,0,0,0,0
"Unknown",waupearsongeorgianna1257.xml,80444/xv76968,0,0,0,0
"Unknown",wauwellingtonarthurwellesley4960.xml,80444/xv69653,0,0,0,0
"Unknown",waucoleleroy4638.xml,80444/xv35250,0,0,0,0
"Unknown",waufreemasonsgrandlodgeofwashington4649.xml,80444/xv42309,0,0,0,0
"Unknown",waubryanwilliamjennings0186.xml,80444/xv68313,0,0,0,0
"Snohomish County (Wash.).",wausnohomishcounty0286.xml,80444/xv38729,0,0,0,0
"Washington (State). Governor.",wauwashington4951.xml,80444/xv56747,0,0,0,0
"Unknown",wausinzheimergerhartpaulgustav1473.xml,80444/xv33831,0,0,0,0
"Unknown",wausmithkennethg0196.xml,80444/xv53756,0,0,0,0
"Unknown",waustandenwilliamarthur4906.xml,80444/xv77740,0,0,0,0
"Women's Federation Activity Point System (University of Washington).",wauwomensfederationactivitypointsystem5080.xml,80444/xv20898,0,0,0,0
"Unknown",wauspringmarjorie4362.xml,80444/xv35845,0,0,0,0
"Unknown",waujennerearlebagley3679.xml,80444/xv00109,0,0,0,0
"Unknown",waupacificnorthwestregionalplanningcommission4836.xml,80444/xv30224,0,0,0,0
"Unknown",wautanabebarbara1816.xml,80444/xv83721,0,0,0,0
"Unknown",wauuwresource07366.xml,80444/xv31954,0,0,0,0
"Unknown",wauashleypaulpritchard3503.xml,80444/xv28704,0,0,0,0
"Unknown",waunewbergermeyer3474.xml,80444/xv96490,0,0,0,0
"Unknown",waucarmichaeldanielc4355.xml,80444/xv06091,0,0,0,0
"Unknown",waupolicesupervisorstrainingconference3324.xml,80444/xv63925,0,0,0,0
"University of Washington. Motor Pool.",wauuwresource00131.xml,80444/xv05834,0,0,0,0
"Unknown",wauuwresource07313.xml,80444/xv84530,0,0,0,0
"Unknown",waujensenfamily3572.xml,80444/xv25244,0,0,0,0
"Unknown",wauweyerhaeusertimbercompany1123.xml,80444/xv73031,0,0,0,0
"Unknown",wauchabadlubavitchorganization3222.xml,80444/xv80532,0,0,0,0
"Unknown",wauasotincountywash4692.xml,80444/xv93707,0,0,0,0
"Unknown",waumundtdorothea2534.xml,80444/xv46044,0,0,0,0
"Unknown",waurobertsarthurkitchel1098.xml,80444/xv94866,0,0,0,0
"Unknown",waubodgesamuel4618.xml,80444/xv87887,0,0,0,0
"Unknown",wauoverlandstageline4781.xml,80444/xv16461,0,0,0,0
"Unknown",wauleearthurt4384.xml,80444/xv92898,0,0,0,0
"Unknown",waubeckerpaula5303.xml,80444/xv39852,0,0,0,0
"Unknown",wauatwoodstanley0522.xml,80444/xv28262,0,0,0,0
"Unknown",wausurfusmarymatildapark3846.xml,80444/xv06600,0,0,0,0
"Unknown",wauestepadrianc3680.xml,80444/xv61761,0,0,0,0
"Unknown",wauhearstarmeta4660.xml,80444/xv53067,0,0,0,0
"Unknown",waufabbeelizabethmcconnell3939.xml,80444/xv58642,0,0,0,0
"Velasco (Victorio) Photograph Collection",wauvelascovictoriophcoll1092.xml,80444/xv78659,0,0,0,0
"Unknown",waudruxmanesthermyers5342.xml,80444/xv02014,0,0,0,0
"Unknown",waumooresusan0359.xml,80444/xv43945,0,0,0,0
"Unknown",wauwellsevelyn1343.xml,80444/xv26580,0,0,0,0
"Krebs (Charles) Photograph Collection",waukrebscharlesphcoll224.xml,80444/xv66516,0,0,0,0
"Sigma Epsilon (University of Washington).",wausigmaepsilon3372.xml,80444/xv03152,0,0,0,0
"Stroum Jewish Community Center of Greater Seattle. Northend Branch.",waustroumjewishcommunitycenterofgreaterseattlenorthendbranch3595.xml,80444/xv38186,0,0,0,0
"Unknown",wauswiftjameshenry4916.xml,80444/xv52658,0,0,0,0
"Washington (State). Governor's Conference on Design for Washington.",waugovernorsconferenceondesignforwashington1117.xml,80444/xv46835,0,0,0,0
"Unknown",wauuwresource07328.xml,80444/xv52548,0,0,0,0
"Unknown",waupacificamericanfisheriesinc0729.xml,80444/xv36315,0,0,0,0
"Unknown",wauuwresource07402.xml,80444/xv98526,0,0,0,0
"Unknown",waubockerleonm2082.xml,80444/xv99380,0,0,0,0
"Unknown",waukatsunos2323.xml,80444/xv13809,0,0,0,0
"Unknown",waushawbenjaminfranklin4890.xml,80444/xv78262,0,0,0,0
"Unknown",wauuwresource02054.xml,80444/xv45730,0,0,0,0
"Unknown",waukestenbergtobifaye3718.xml,80444/xv07162,0,0,0,0
"Unknown",waubarnesgeorgea2335.xml,80444/xv60357,0,0,0,0
"Unknown",wausterngustave3053.xml,80444/xv21151,0,0,0,0
"Unknown",waumagidoffisrael3525.xml,80444/xv20309,0,0,0,0
"University of Washington. Molecular and Cellular Biology Department.",wauuwresource00414.xml,80444/xv98727,0,0,0,0
"Unknown",waubringhurstalice4037.xml,80444/xv70257,0,0,0,0
"Unknown",waucastilloobduliarigor3752.xml,80444/xv03286,0,0,0,0
"Unknown",wausmitheverettt2829.xml,80444/xv50695,0,0,0,0
"Unknown",waumakovozdavid4792.xml,80444/xv39767,0,0,0,0
"Unknown",waurhodeshelen3959.xml,80444/xv79553,0,0,0,0
"Unknown",waumooreclintonh1164.xml,80444/xv53488,0,0,0,0
"Unknown",waujacksonroy5099.xml,80444/xv85037,0,0,0,0
"Unknown",waubenetwilliamrose4693.xml,80444/xv05242,0,0,0,0
"Unknown",waurothschildlionelde0107.xml,80444/xv96069,0,0,0,0
"University of Washington Center for Innovation and Entrepreneurship records",wauuwresource07223.xml,80444/xv76397,0,0,0,0
"Washington (State). State Legislative Council.",wauwashingtonstatelegislativecouncil2544.xml,80444/xv88101,0,0,0,0
"Unknown",waunorrisgeorgewilliam2238.xml,80444/xv64727,0,0,0,0
"Unknown",waugilbertsonsigurd3830.xml,80444/xv37582,0,0,0,0
"Unknown",waunorthshorejewishcommunity4209.xml,80444/xv98339,0,0,0,0
"Unknown",wauogdendanielm4773.xml,80444/xv99783,0,0,0,0
"Unknown",waukeppelcharles2029.xml,80444/xv00384,0,0,0,0
"Unknown",wauclancyfrankj0143.xml,80444/xv90151,0,0,0,0
"Unknown",waujohnsonhelensnyder2867.xml,80444/xv04888,0,0,0,0
"Jewish Historical Society of B.C.",waujewishhistoricalsocietyofbc4086.xml,80444/xv59194,0,0,0,0
"Unknown",waubarnettmarthe3074.xml,80444/xv70925,0,0,0,0
"Unknown",wausandpeter5134.xml,80444/xv74600,0,0,0,0
"Unknown",wautsukamakiben2462.xml,80444/xv44769,0,0,0,0
"Unknown",wauschiotzaksel2247.xml,80444/xv68878,0,0,0,0
"University of Washington Nuclear Reactor film",wauuwnuclearreactorfilmphcoll992.xml,80444/xv59796,0,0,0,0
"Unknown",wauswanjohn4915.xml,80444/xv17312,0,0,0,0
"Unknown",wauharveygeorge1278.xml,80444/xv60574,0,0,0,0
"University of Washington. Meany Hall for the Performing Arts.",wauuwresource06091.xml,80444/xv14422,0,0,0,0
"Unknown",wausanominna2862.xml,80444/xv11734,0,0,0,0
"Unknown",wauwhitlockkatholeen5213.xml,80444/xv48693,0,0,0,0
"University of Washington. Vice Provost for Special Programs.",wauuwresource00110.xml,80444/xv25454,0,0,0,0
"Unknown",wautaylorralphs3243.xml,80444/xv43688,0,0,0,0
"Unknown",waufreeburnlaurence2960.xml,80444/xv05532,0,0,0,0
"Unknown",waushallonmichelle3539.xml,80444/xv52258,0,0,0,0
"Unknown",wausmithbernice1778.xml,80444/xv93807,0,0,0,0
"Unknown",wauwaddingtonch5089.xml,80444/xv04504,0,0,0,0
"Unknown",waudambacherkarl3652.xml,80444/xv75833,0,0,0,0
"Unknown",wauuwresource07373.xml,80444/xv24807,0,0,0,0
"Unknown",waucummingseb1265.xml,80444/xv72653,0,0,0,0
"Unknown",waulewiscountyoregonterritorycitizens4803.xml,80444/xv72305,0,0,0,0
"Unknown",waufabiansoningrids5349.xml,80444/xv02209,0,0,0,0
"Unknown",wauthackermabel1051.xml,80444/xv44451,0,0,0,0
"Unknown",waubarrmargaretj3969.xml,80444/xv38934,0,0,0,0
"Unknown",wauandersonew3114.xml,80444/xv86264,0,0,0,0
"Unknown",wauradissonpierreesprit0560.xml,80444/xv03726,0,0,0,0
"Unknown",wauhuntleighsj4667.xml,80444/xv24902,0,0,0,0
"Unknown",wauuwresource07301.xml,80444/xv82391,0,0,0,0
"Unknown",wauuwresource07302.xml,80444/xv66442,0,0,0,0
"Unknown",waukaplancharles3425.xml,80444/xv56732,0,0,0,0
"Washington (State). National Guard.",wauwashingtonnationalguard4955.xml,80444/xv48770,0,0,0,0
"Unknown",wauuwresource07417.xml,80444/xv10110,0,0,0,0
"Unknown",waumalakoffbessie3175.xml,80444/xv92529,0,0,0,0
"Unknown",waukashimatetsuden4333.xml,80444/xv41119,0,0,0,0
"Unknown",wauprogressnewsletter2094.xml,80444/xv44735,0,0,0,0
"Seattle Music Study Club.",wauseattlemusicstudyclub3838.xml,80444/xv53192,0,0,0,0
"Unknown",waumedinatony3146.xml,80444/xv34286,0,0,0,0
"Unknown",waufinlaysonroderick4727.xml,80444/xv05267,0,0,0,0
"Unknown",waubarnesedwardlarrabee4589.xml,80444/xv12097,0,0,0,0
"Washington (State). Dept. of Natural Resources.",wauwashingtondeptnaturalresources3550.xml,80444/xv61978,0,0,0,0
"Unknown",waumoisisann5012.xml,80444/xv48510,0,0,0,0
"Unknown",wauanthesjacob3284.xml,80444/xv57125,0,0,0,0
"Unknown",waulynchthomas0807.xml,80444/xv43893,0,0,0,0
"Unknown",waumatalanleonj4398.xml,80444/xv11376,0,0,0,0
"Unknown",waucanterfrieda3551.xml,80444/xv39669,0,0,0,0
"Unknown",waubryanedgar3478.xml,80444/xv76074,0,0,0,0
"Unknown",wauuwresource07377.xml,80444/xv52352,0,0,0,0
"Unknown",wausidelravella3411.xml,80444/xv79095,0,0,0,0
"Unknown",wausugarmanruby3671.xml,80444/xv23364,0,0,0,0
"Unknown",wauhannahcharlesl4416.xml,80444/xv14904,0,0,0,0
"Unknown",wausmithjosephalliaude1542.xml,80444/xv96643,0,0,0,0
"Women Employees Association (University of Washington).",wauwomenemployeesassociation5046.xml,80444/xv94842,0,0,0,0
"Unknown",waugeermarywells3944.xml,80444/xv40597,0,0,0,0
"Unknown",waurunningcorinne0149.xml,80444/xv73602,0,0,0,0
"Unknown",waucastonjennie2056.xml,80444/xv05130,0,0,0,0
"University of Washington Center for Disability Policy and Research Records",wauuwresource00762.xml,80444/xv20452,0,0,0,0
"Unknown",waucahailalicekellogg0244.xml,80444/xv81393,0,0,0,0
"Unknown",wauhazelsteve2728.xml,80444/xv77963,0,0,0,0
"Unknown",wauhebreweducationandfreeloanassociation3254.xml,80444/xv95693,0,0,0,0
"Unknown",wauhidakaheizo3230.xml,80444/xv29776,0,0,0,0
"Unknown",wauuwresource07374.xml,80444/xv14382,0,0,0,0
"Unknown",waushibata1594.xml,80444/xv05294,0,0,0,0
"Unknown",wauhainsworthconstruction4029.xml,80444/xv91461,0,0,0,0
"International Society For Contemporary Music. Pacific Northwest Chapter.",wauinternationalsocietyforcontemporarymusicpacificnorthwestchapter0495.xml,80444/xv53323,0,0,0,0
"Unknown",waucanellpamela4347.xml,80444/xv02304,0,0,0,0
"Unknown",waubensonevaronald2873.xml,80444/xv50982,0,0,0,0
"University of Washington. Office of Institutional Studies.",wauuwresource00099.xml,80444/xv13790,0,0,0,0
"Unknown",waulivingstonleo1345.xml,80444/xv34347,0,0,0,0
"Unknown",wauhulljs3492.xml,80444/xv24417,0,0,0,0
"Unknown",wauunitedstatesfederalworksagency4936.xml,80444/xv94723,0,0,0,0
"Unknown",waurobinsongordon3072.xml,80444/xv15539,0,0,0,0
"Unknown",wauleemarycustis0080.xml,80444/xv57974,0,0,0,0
"Unknown",waumiessehelenmargaret3936.xml,80444/xv37716,0,0,0,0
"Unknown",waupowellrosalyngale2860.xml,80444/xv31671,0,0,0,0
"Unknown",wauuwresource00485.xml,80444/xv98715,0,0,0,0
"Unknown",wauparrybettyt2972.xml,80444/xv11511,0,0,0,0
"Unknown",waurepublicanpartykingcountywashcentralcommittee4861.xml,80444/xv58154,0,0,0,0
"Unknown",waukoppelmichael2978.xml,80444/xv72293,0,0,0,0
"Unknown",wausmithfredericke1060.xml,80444/xv06762,0,0,0,0
"Unknown",wauamericaninstituteofminingandmetallurgicalengineersnorthpacificsection4600.xml,80444/xv77716,0,0,0,0
"Unknown",wauwerneckechauncy0824.xml,80444/xv49441,0,0,0,0
"Unknown",wauuwresource00294.xml,80444/xv46231,0,0,0,0
"University of Washington Libraries, Circulation Division",wauuwresource07323.xml,80444/xv31689,0,0,0,0
"Unknown",wauhydeanniebucklin1883.xml,80444/xv72555,0,0,0,0
"Unknown",wauresnickbeckyberman2495.xml,80444/xv45468,0,0,0,0
"Washington (State). Forest Advisory Committee.",wauwashingtonstateforestadvisorycommittee3202.xml,80444/xv82797,0,0,0,0
"Unknown",wauportnoffmarguerite4427.xml,80444/xv19119,0,0,0,0
"Unknown",waulougheedsamueld1611.xml,80444/xv62783,0,0,0,0
"Unknown",waugenauersam2817.xml,80444/xv67938,0,0,0,0
"Unknown",waupoundjoyhill5039.xml,80444/xv29983,0,0,0,0
"Omenn (Gilbert)",wauomenngilbertsua4122.xml,80444/xv90142,0,0,0,0
"Unknown",wauriponsociety2019.xml,80444/xv70123,0,0,0,0
"Unknown",wauunitedstatesholocaustmemorialcouncil4009.xml,80444/xv66915,0,0,0,0
"Unknown",waupostedith1461.xml,80444/xv97903,0,0,0,0
"Unknown",waulanderedward4671.xml,80444/xv93185,0,0,0,0
"Unknown",wauvoicesofwashingtonstate3170.xml,80444/xv26782,0,0,0,0
"Unknown",wauwoffortleola4977.xml,80444/xv34799,0,0,0,0
"Unknown",wauhaydenmarylogan2305.xml,80444/xv83328,0,0,0,0
"Unknown",wauhechtedithg3607.xml,80444/xv20111,0,0,0,0
"Unknown",wauthorpefamily4923.xml,80444/xv01425,0,0,0,0
"Unknown",wausymmondsharold4918.xml,80444/xv87609,0,0,0,0
"Unknown",waulibbymcneilllibby4449.xml,80444/xv67791,0,0,0,0
"Unknown",waumcmillanmarcus0527.xml,80444/xv69778,0,0,0,0
"Unknown",waupacificcoastlumbermanufacturersassociation3629.xml,80444/xv84863,0,0,0,0
"Unknown",waumonnahanthomaswilliam5231.xml,80444/xv83090,0,0,0,0
"Unknown",wauunitedstatesfederaltradecommissioncapitalissuescommittee0251.xml,80444/xv45211,0,0,0,0
"University of Washington Libraries, Social Work Library records",wauuwresource07213.xml,80444/xv65414,0,0,0,0
"Unknown",wauklabereugenehenry3427.xml,80444/xv96102,0,0,0,0
"Unknown",waupacificgertrude2690.xml,80444/xv85931,0,0,0,0
"Unknown",waubattlegroundwashcommunitystudygroup4410.xml,80444/xv99362,0,0,0,0
"University of Washington. Equipment Inventory Control Office.",wauuwresource00192.xml,80444/xv55853,0,0,0,0
"Unknown",wauprohibitioncampaignfundforeriecountynewyork4854.xml,80444/xv78845,0,0,0,0
"Unknown",wauyeshivatorhazafonseattlewash3472.xml,80444/xv44631,0,0,0,0
"Unknown",waumcleancorbett4808.xml,80444/xv42144,0,0,0,0
"Unknown",wauwaldbaumnina4409.xml,80444/xv88754,0,0,0,0
"Unknown",waurobinsonrobertmcclure2872.xml,80444/xv52764,0,0,0,0
"Unknown",wauuwresource07274.xml,80444/xv06277,0,0,0,0
"Unknown",waulundinnorman2693.xml,80444/xv54782,0,0,0,0
"Family Photograph Collection from Nome, Alaska",waufamilyphotographsphcoll784.xml,80444/xv75228,0,0,0,0
"Unknown",wauhartbeulah4747.xml,80444/xv59500,0,0,0,0
"Unknown",waubolducjbz4620.xml,80444/xv53228,0,0,0,0
"Unknown",waubrakelhenrylouis3015.xml,80444/xv78894,0,0,0,0
"Unknown",waucarycarl3455.xml,80444/xv75018,0,0,0,0
"Unknown",wauuwresource09071.xml,80444/xv06411,0,0,0,0
"Unknown",waulenfestelmer4676.xml,80444/xv26043,0,0,0,0
"Unknown",wauwalkerelkanah0084.xml,80444/xv03808,0,0,0,0
"Unknown",waupeersjoseph4840.xml,80444/xv24801,0,0,0,0
"Unknown",waudecristoforovioletkazue3971.xml,80444/xv36404,0,0,0,0
"Unknown",waurotmanlena3816.xml,80444/xv61267,0,0,0,0
"Unknown",wautovbinsol3006.xml,80444/xv11477,0,0,0,0
"Unknown",waumorrisonben2491.xml,80444/xv65408,0,0,0,0
"Unknown",waulawpaulw0828.xml,80444/xv30889,0,0,0,0
"Unknown",wauolesfloyd1688.xml,80444/xv85726,0,0,0,0
"Unknown",wauflanaganminingcompany3630.xml,80444/xv67300,0,0,0,0
"Unknown",wauwymancharlesm3082.xml,80444/xv33319,0,0,0,0
"University of Washington. School of Medicine. Management and Finance Office.",wauuwresource00378.xml,80444/xv27777,0,0,0,0
"Unknown",wauuwresource07376.xml,80444/xv39514,0,0,0,0
"University of Washington. Campus Religious Council.",wauuniversityofwashingtoncampusreligiouscouncil3453.xml,80444/xv92681,0,0,0,0
"Unknown",wauschallergilbertsimon2924.xml,80444/xv60464,0,0,0,0
"Social Issues",wausocialissues3768.xml,80444/xv11505,0,0,0,0
"Unknown",wauhaykinsdoris4071.xml,80444/xv88818,0,0,0,0
"Unknown",waufriedmanesther2273.xml,80444/xv85452,0,0,0,0
"Unknown",wauilitowitzjacob1533.xml,80444/xv55291,0,0,0,0
"Unknown",waugesellbrenda3972.xml,80444/xv32037,0,0,0,0
"Unknown",wauwrencharles4982.xml,80444/xv01925,0,0,0,0
"Unknown",waujaffejessiefunk3278.xml,80444/xv02197,0,0,0,0
"University of Washington. Dept. of Otolaryngology.",wauuwresource00405.xml,80444/xv45361,0,0,0,0
"Unknown",wauuwresource07398.xml,80444/xv37728,0,0,0,0
"Unknown",waubanearnest3809.xml,80444/xv04235,0,0,0,0
"Unknown",waulundgunnar4076.xml,80444/xv02331,0,0,0,0
"Bailey-Boushay House Records",waubaileyboushayhouse5567.xml,80444/xv00933,0,0,0,0
"Unknown",waubethlehemlutheranchurchmarysvillewash2422.xml,80444/xv89660,0,0,0,0
"Unknown",waumyersjuliusm3805.xml,80444/xv83694,0,0,0,0
"Turner (James) Photograph Collection",wauturnerjamesphcoll852.xml,80444/xv44683,0,0,0,0
"Hargreaves (Kenneth L.) Papers",wauhargreaveskennethl5936.xml,80444/xv15206,0,0,0,0
"Unknown",wauhawkinsjameswilbur5123.xml,80444/xv30645,0,0,0,0
"Unknown",wausmithhugh4897.xml,80444/xv97998,0,0,0,0
"Unknown",wauuwresource07358.xml,80444/xv36047,0,0,0,0
"Unknown",wauuwresource07393.xml,80444/xv89138,0,0,0,0
"Dabney (Ellen P.) Papers",waudabneyellen5476.xml,80444/xv94418,0,0,0,0
"Unknown",wauringerirenem5088.xml,80444/xv20242,0,0,0,0
"Unknown",waumcmullinfayette4811.xml,80444/xv35821,0,0,0,0
"Unknown",waueastsideminyan4097.xml,80444/xv81295,0,0,0,0
"Unknown",wauzeitlinharry4429.xml,80444/xv21936,0,0,0,0
"Unknown",wauwrightvirginia2569.xml,80444/xv77767,0,0,0,0
"Unknown",waugriffinlillianfernandez3942.xml,80444/xv92248,0,0,0,0
"Unknown",wauuwresource07387.xml,80444/xv75775,0,0,0,0
"Unknown",wauhanscomjohnc3982.xml,80444/xv29577,0,0,0,0
"Unknown",waulofgrenteda3835.xml,80444/xv04971,0,0,0,0
"Unknown",waubarkdullcalvinh4204.xml,80444/xv82754,0,0,0,0
"Unknown",waubrownwilfred5171.xml,80444/xv50613,0,0,0,0
"Unknown",waudehnloism4344.xml,80444/xv10220,0,0,0,0
"Unknown",waubakerjack2841.xml,80444/xv95635,0,0,0,0
"Unknown",waumaimonbension3400.xml,80444/xv07046,0,0,0,0
"University of Washington. Dept. of Epidemiology. Data and Safety Monitoring Committee.",wauuwresource00461.xml,80444/xv59725,0,0,0,0
"Unknown",wauvancouvergeorge4943.xml,80444/xv19070,0,0,0,0
"Unknown",wauhaltemanwa1262.xml,80444/xv79202,0,0,0,0
"Unknown",waukassowitzernst3483.xml,80444/xv60696,0,0,0,0
"Unknown",waufirstnationalbankporttownsendwash3106.xml,80444/xv94094,0,0,0,0
"Unknown",wauharristobyg5304.xml,80444/xv65505,0,0,0,0
"Unknown",wauhorowitzsamuel1477.xml,80444/xv05334,0,0,0,0
"Unknown",wauheywoodeuniceisabel3754.xml,80444/xv93847,0,0,0,0
"Unknown",waualtosesophie1967.xml,80444/xv29531,0,0,0,0
"McCarthy (Joseph)",waumccarthyjosephlepageua3331.xml,80444/xv12973,0,0,0,0
"Unknown",waulufkinfrancisb2308.xml,80444/xv48306,0,0,0,0
"Unknown",waupopejohn4851.xml,80444/xv45736,0,0,0,0
"Unknown",wauhillraymond2651.xml,80444/xv71746,0,0,0,0
"Unknown",wauuwresource07294.xml,80444/xv97262,0,0,0,0
"Unknown",wausigelmary4093.xml,80444/xv80514,0,0,0,0
"Unknown",waulevyclyde4492.xml,80444/xv96493,0,0,0,0
"Unknown",waucreeleyrobert2482.xml,80444/xv96539,0,0,0,0
"B'nai B'rith. Lodge 503 (Seattle, Wash.).",waubnaibrithlodge503_3589.xml,80444/xv79617,0,0,0,0
"Unknown",wausaitojoe2466.xml,80444/xv35977,0,0,0,0
"Unknown",waujonesmavislee3751.xml,80444/xv14501,0,0,0,0
"Save French Pete Committee.",wausavefrenchpetecommittee3853.xml,80444/xv59106,0,0,0,0
"Unknown",wauhalljamesl4163.xml,80444/xv45443,0,0,0,0
"United Nations. Transitional Authority in Cambodia.",wauunitednationstransitionalauthorityincambodia4519.xml,80444/xv44888,0,0,0,0
"Unknown",wauschusterarlene4096.xml,80444/xv67959,0,0,0,0
"Photographs of Seattle Fire Stations and Public Buildings",wauseattlefirestationsph2016_019.xml,80444/xv89251,0,0,0,0
"Seattle Group.",wauseattlegroup3715.xml,80444/xv44174,0,0,0,0
"Unknown",waufriedmanjames5030.xml,80444/xv86605,0,0,0,0
"Unknown",wauschwartzharold4428.xml,80444/xv28698,0,0,0,0
"Unknown",wauhayesedmes0692.xml,80444/xv56915,0,0,0,0
"Unknown",waukitanoharryhl1125.xml,80444/xv94534,0,0,0,0
"Unknown",waugoldsworthypatrickd4193.xml,80444/xv66561,0,0,0,0
"Unknown",wauflaksben2827.xml,80444/xv46292,0,0,0,0
"Unknown",waumoultonellen3963.xml,80444/xv91409,0,0,0,0
"Unknown",wauuwresource07277.xml,80444/xv27676,0,0,0,0
"Unknown",wauaugustanaevangelicallutheranchurchcolumbiaconference0569.xml,80444/xv69638,0,0,0,0
"Unknown",waupaceantonio4383.xml,80444/xv93341,0,0,0,0
"Unknown",wauwilburjamesh4968.xml,80444/xv84109,0,0,0,0
"Unknown",waugorelickharry4162.xml,80444/xv84307,0,0,0,0
"Unknown",waubrooksblanche5050.xml,80444/xv07208,0,0,0,0
"University of Washington. Dept. of Pediatrics.",wauuwresource00386.xml,80444/xv02185,0,0,0,0
"Unknown",waukingjohnl0897.xml,80444/xv18832,0,0,0,0
"Unknown",wauhuntgeorge4666.xml,80444/xv61511,0,0,0,0
"Unknown",wauuwresource07367.xml,80444/xv20132,0,0,0,0
"Unknown",waufosterharryellsworth3117.xml,80444/xv19564,0,0,0,0
"University of Washington. Staff Personnel Office.",wauuwresource07266.xml,80444/xv09234,0,0,0,0
"Music Society Friends (University of Washington).",waumusicsocietyfriends4151.xml,80444/xv90588,0,0,0,0
"Unknown",waubaileyjosiah1122.xml,80444/xv09185,0,0,0,0
"Japanese Photo Album",waujapanesephotoalbumph2005_047.xml,80444/xv90353,0,0,0,0
"Unknown",wauseattlenorwegiandanishevangelicallutheranchurch3764.xml,80444/xv77185,0,0,0,0
"Unknown",waulassiterlukee5242.xml,80444/xv31564,0,0,0,0
"Montana Historical Society Photograph Collection",waumontanahistoricalsocietyphcoll1398.xml,80444/xv07559,0,0,0,0
"University of Washington Office of Technology Transfer Records",wauuwresource00184.xml,80444/xv01068,0,0,0,0
"University of Washington. Dept. of Pathology.",wauuwresource00413.xml,80444/xv74105,0,0,0,0
"University of Washington. School of Medicine. Assistant Dean for Student Affairs.",wauuwresource00375.xml,80444/xv47000,0,0,0,0
"Gary (Menges) photographs of Pike Place Market and Seattle Area",waumengesgarypikeplacephcoll1237.xml,80444/xv18844,0,0,0,0
"Unknown",wauclibbornjoshua4635.xml,80444/xv31311,0,0,0,0
"Miller (Beatrice)",waumillerbeatricediamond5163.xml,80444/xv15548,0,0,0,0
"University of Washington. University Hospital. Safety Committee.",wauuwresource00218.xml,80444/xv47924,0,0,0,0
"Unknown",waurobertslissa2490.xml,80444/xv14001,0,0,0,0
"Unknown",wauposnerfrances2832.xml,80444/xv00918,0,0,0,0
"Unknown",waujohnsnewton1078.xml,80444/xv73367,0,0,0,0
"Unknown",wausulmanbertha2776.xml,80444/xv66192,0,0,0,0
"Women's League (University of Washington).",wauwomensleague5048.xml,80444/xv95947,0,0,0,0
"Unknown",waufaddenharryd1185.xml,80444/xv02703,0,0,0,0
"Unknown",waurobertjohn2157.xml,80444/xv43643,0,0,0,0
"Unknown",wauuwresource07383.xml,80444/xv93334,0,0,0,0
"Unknown",waufactoryofvisualarts2769.xml,80444/xv92700,0,0,0,0
"University of Washington Institute of Forest Products records",wauuwresource07739.xml,80444/xv32696,0,0,0,0
"Unknown",wauokinleo3529.xml,80444/xv00280,0,0,0,0
"Unknown",wauhastingslorenbrown4750.xml,80444/xv27478,0,0,0,0
"Unknown",wauziebelladolphg0341.xml,80444/xv19253,0,0,0,0
"Unknown",waushultzgeorgepratt5216.xml,80444/xv62365,0,0,0,0
"Unknown",waubismarkgoldandsilverminingcompanyseattlewash4609.xml,80444/xv20413,0,0,0,0
"U.S. Army Signal Corps Photographs of the Mount Rainier Ordnance Depot Collection",waumountrainierordnancedepotphcoll1309.xml,80444/xv52136,0,0,0,0
"Unknown",waumathesonwilliam4683.xml,80444/xv14428,0,0,0,0
"Unknown",wauallpersylvia3468.xml,80444/xv24948,0,0,0,0
"Unknown",waukeijaaw1144.xml,80444/xv08471,0,0,0,0
"Unknown",wauchabadlubavitchorganizationnorthwestregionaloffice3700.xml,80444/xv41857,0,0,0,0
"Kelloggs Advertisement Display",waukelloggsdisplaywindowsphcoll1382.xml,80444/xv39892,0,0,0,0
"Unknown",waudigiorgiorobert5219.xml,80444/xv57492,0,0,0,0
"Unknown",wauapplebaumleon2642.xml,80444/xv16693,0,0,0,0
"Unknown",wauoldenkirkcharles4775.xml,80444/xv61767,0,0,0,0
"Unknown",waubalchalberts2774.xml,80444/xv85217,0,0,0,0
"Unknown",waucheimh3480.xml,80444/xv14364,0,0,0,0
"Unknown",waukochadolfd3197.xml,80444/xv05545,0,0,0,0
"Unknown",waumayermelaniej4239.xml,80444/xv79672,0,0,0,0
"Unknown",waublanchardleslief0658.xml,80444/xv44250,0,0,0,0
"Unknown",waufrithiofkarl3436.xml,80444/xv87533,0,0,0,0
"Unknown",wauasiabenjamin4301.xml,80444/xv03451,0,0,0,0
"Unknown",wautazumayuki2473.xml,80444/xv08978,0,0,0,0
"Unknown",waudurhamjeremiahb0162.xml,80444/xv83590,0,0,0,0
"Unknown",wauuwresource07311.xml,80444/xv50900,0,0,0,0
"Unknown",wausingerraida3819.xml,80444/xv58666,0,0,0,0
"Unknown",waudooleyclaraknack3836.xml,80444/xv69897,0,0,0,0
"Unknown",waulewiswilliamr3855.xml,80444/xv97973,0,0,0,0
"University of Washington. International Programs Division.",wauuwresource00178.xml,80444/xv72827,0,0,0,0
"University of Washington. Dept. of Comparative Medicine.",wauuwresource00404.xml,80444/xv62896,0,0,0,0
"Unknown",waucrosierron2448.xml,80444/xv85775,0,0,0,0
"Puget Sound Power and Light Co. Employees Photograph",waupugetsoundpowerlightphcoll577.xml,80444/xv55123,0,0,0,0
"Unknown",waufriedlanderjohn2496.xml,80444/xv18283,0,0,0,0
"Unknown",wauschillerirwin4099.xml,80444/xv02246,0,0,0,0
"Unknown",waubodehenryfred1082.xml,80444/xv36999,0,0,0,0
"Transportation Northwest Regional Center Records",wauuwresource09110.xml,80444/xv27453,0,0,0,0
"Unknown",waumckaycharles1050.xml,80444/xv00619,0,0,0,0
"Unknown",wautorreyharrybeal2921.xml,80444/xv85571,0,0,0,0
"Unknown",waulambfrankhaines0262.xml,80444/xv47125,0,0,0,0
"Unknown",wauwoodsonfredpatterson1039.xml,80444/xv19458,0,0,0,0
"Unknown",wausilverbergdarbyn3606.xml,80444/xv11752,0,0,0,0
"Unknown",wauuwresource07339.xml,80444/xv11840,0,0,0,0
"Unknown",waucooperelizabethann3673.xml,80444/xv42062,0,0,0,0
"Unknown",waumooremarshallf4824.xml,80444/xv18948,0,0,0,0
"Unknown",waujacksonhelen3961.xml,80444/xv51788,0,0,0,0
"Unknown",waubaillargeonfamily5208.xml,80444/xv58731,0,0,0,0
"Unknown",wauschneidersteven4062.xml,80444/xv67291,0,0,0,0
"Unknown",wauuwresource07386.xml,80444/xv20050,0,0,0,0
"Unknown",wauwashingtonstatejewishgenealogicalsociety4377.xml,80444/xv36694,0,0,0,0
"Unknown",waufoxnormanf4530.xml,80444/xv47970,0,0,0,0
"Western Canada Road Trip Photograph Collection",wauwesterncanadaphcoll1303.xml,80444/xv93344,0,0,0,0
"Unknown",waumcmannontimothyj4483.xml,80444/xv68051,0,0,0,0
"Unknown",wauuwresource07391.xml,80444/xv50714,0,0,0,0
"Unknown",waulongfellowmariannepreble2158.xml,80444/xv00262,0,0,0,0
"Unknown",wauraffertythomas4859.xml,80444/xv05111,0,0,0,0
"Unknown",waubannoemi3810.xml,80444/xv84848,0,0,0,0
"Unknown",waubenderbarbaraldrake5040.xml,80444/xv51821,0,0,0,0
"Unknown",waustokesjames4910.xml,80444/xv94857,0,0,0,0
"Unknown",waumarkhamwilliam4682.xml,80444/xv06042,0,0,0,0
"University of Washington Graduate Medical Education Program Assessment and Development Records",wauuwresource02056.xml,80444/xv27764,0,0,0,0
"Swedish Steamship",waupetersenmadsenswedishsteamship1954.xml,80444/xv63735,0,0,0,0
"Unknown",waurileycharlesw4865.xml,80444/xv76782,0,0,0,0
"Unknown",wautindolphedward0130.xml,80444/xv72283,0,0,0,0
"Unknown",waupacifichousehotel0158.xml,80444/xv23471,0,0,0,0
"Unknown",wauhousefrancesm3940.xml,80444/xv41305,0,0,0,0
"Unknown",waucostelloja4710.xml,80444/xv70056,0,0,0,0
"Unknown",waumitchellrobertl1893.xml,80444/xv81765,0,0,0,0
"Unknown",wauspeciallibrariesassociationpugetsoundchapter0021.xml,80444/xv45043,0,0,0,0
"Unknown",waulancasterse1256.xml,80444/xv16931,0,0,0,0
"Unknown",waushulmanleo3405.xml,80444/xv04980,0,0,0,0
"Unknown",waubriteerna2517.xml,80444/xv81991,0,0,0,0
"Unknown",waufreedmanethelmiller3471.xml,80444/xv55950,0,0,0,0
"Unknown",waustarinjoel4010.xml,80444/xv93313,0,0,0,0
"Unknown",wauuwresource07399.xml,80444/xv12643,0,0,0,0
"Unknown",waukeenandruscilla3495.xml,80444/xv16671,0,0,0,0
"Unknown",wauschwartzalissa5118.xml,80444/xv11099,0,0,0,0
"Unknown",waubloomjessies2623.xml,80444/xv15652,0,0,0,0
"Unknown",wauuwresource07418.xml,80444/xv21279,0,0,0,0
"Unknown",waurussakjoseph2669.xml,80444/xv57003,0,0,0,0
"Unknown",waucookeedwinn4708.xml,80444/xv13305,0,0,0,0
"Unknown",waurockefellernelsona4867.xml,80444/xv11227,0,0,0,0
"Unknown",waualexanderpat2727.xml,80444/xv95175,0,0,0,0
"Unknown",waustevenstheodore1575.xml,80444/xv70928,0,0,0,0
"Unknown",wauhedemeta2233.xml,80444/xv11712,0,0,0,0
"Unknown",waufriendsoftheuwlibraries4192.xml,80444/xv36459,0,0,0,0
"Jewish Community Center of Greater Seattle.",waujewishcommunitycenterofgreaterseattle4351.xml,80444/xv80545,0,0,0,0
"Unknown",wausocietyofseattleartists4247.xml,80444/xv46884,0,0,0,0
"Unknown",waugunbypaulc4030.xml,80444/xv70031,0,0,0,0
"Unknown",wauwarrackjane2805.xml,80444/xv38284,0,0,0,0
"Unknown",wausteinbrecheremilie1957.xml,80444/xv25799,0,0,0,0
"Unknown",waumossmyrtle3656.xml,80444/xv16876,0,0,0,0
"University of Washington. Medical Center. Nursing Services Department.",wauuwresource00231.xml,80444/xv89306,0,0,0,0
"Unknown",wausiriwilliame3059.xml,80444/xv43960,0,0,0,0
"Unknown",waumcallisterhelenjudge1394.xml,80444/xv12765,0,0,0,0
"Unknown",waunixonrichardm1020.xml,80444/xv21463,0,0,0,0
"Unknown",waulewissolharris3594.xml,80444/xv86434,0,0,0,0
"Unknown",waukahantoni3668.xml,80444/xv97207,0,0,0,0
"Unknown",wauzimmermanmim2471.xml,80444/xv95706,0,0,0,0
"Unknown",wauhovdejane2673.xml,80444/xv29754,0,0,0,0
"Unknown",wauedensisabeleldridge2958.xml,80444/xv25744,0,0,0,0
"Peabody (Henry G.) Photograph Collection",waupeabodyhenryph2005_065.xml,80444/xv37890,0,0,0,0
"Unknown",waustoreyethelp3756.xml,80444/xv43533,0,0,0,0
"Unknown",waubassharoldj0504.xml,80444/xv81094,0,0,0,0
"Staff Womens Forum",waustaffwomensforumconcernedstaffwomen5061.xml,80444/xv42687,0,0,0,0
"Washington (State). Tax Advisory Council.",wauwashingtontaxadvisorycouncil0441.xml,80444/xv66781,0,0,0,0
"Women's Federation (University of Washington).",wauwomensfederation5047.xml,80444/xv98315,0,0,0,0
"Unknown",wauschultzceciliaaugspurger1011.xml,80444/xv82901,0,0,0,0
"Unknown",wauransomwebsterh4860.xml,80444/xv34072,0,0,0,0
"Unknown",waumackrussellv0242.xml,80444/xv16567,0,0,0,0
"Unknown",wauuwresource07371.xml,80444/xv73831,0,0,0,0
"Unknown",wauswedishfinnishbenevolentaidassociationfinlandofamerica2143.xml,80444/xv99588,0,0,0,0
"Unknown",wauweckwolfgang1057.xml,80444/xv09494,0,0,0,0
"Romans (William P.) Alaska Building Photographs",wauromanswilliampalaskabuildingphcoll592.xml,80444/xv70460,0,0,0,0
"Unknown",waubuggewa3570.xml,80444/xv68411,0,0,0,0
"Washington (State). State Capitol Committee.",wauwashingtonstatecapitolcommittee3011.xml,80444/xv76226,0,0,0,0
"Jewish Welfare Board. (Seattle, Wash.).",waujewishwelfareboard4085.xml,80444/xv65686,0,0,0,0
"Unknown",waurostonjamesa4874.xml,80444/xv55203,0,0,0,0
"Unknown",waucushmanthomasjackson1488.xml,80444/xv94018,0,0,0,0
"Unknown",waulavelleee3948.xml,80444/xv07754,0,0,0,0
"Unknown",waulevyeugene4771.xml,80444/xv11318,0,0,0,0
"Unknown",wauhewittlucile5368.xml,80444/xv74682,0,0,0,0
"Stereoview Photographs of the Philippines",wauphilippinesstereoviewsph2015_023.xml,80444/xv80969,0,0,0,0
"Unknown",waucollierherbertl0601.xml,80444/xv51699,0,0,0,0
"Unknown",waucambrawalterc3780.xml,80444/xv91354,0,0,0,0
"Muller (T.C.) Battleship Photograph Collection",waumullertcbattleshipsphcoll1254.xml,80444/xv78256,0,0,0,0
"Husky Hot Club (University of Washington).",wauhuskyhotclub4788.xml,80444/xv39050,0,0,0,0
"Unknown",waufriedlanderpolly2639.xml,80444/xv55459,0,0,0,0
"Unknown",wauwrighteugenea3826.xml,80444/xv14022,0,0,0,0
"University of Washington. Medical Center. Personnel Department.",wauuwresource00219.xml,80444/xv79733,0,0,0,0
"Unknown",waustallardbruce2333.xml,80444/xv41445,0,0,0,0
"Unknown",wauuwresource07414.xml,80444/xv84573,0,0,0,0
"Unknown",waulevindorothy3540.xml,80444/xv75875,0,0,0,0
"Unknown",wauboydwilliam5079.xml,80444/xv13662,0,0,0,0
"Cheney (Eric S.) Papers",waucheneyericua5369.xml,80444/xv57495,0,0,0,0
"Unknown",wauernstcharlesf0183.xml,80444/xv20565,0,0,0,0
"Unknown",wauchristofersongyda1993.xml,80444/xv20043,0,0,0,0
"Unknown",waumalonedorothy2856.xml,80444/xv63336,0,0,0,0
"Unknown",waubeesonsimeona2312.xml,80444/xv46560,0,0,0,0
"Unknown",wauseattleasphaltcompany0443.xml,80444/xv43231,0,0,0,0
"Unknown",waulafollettewilliaml3511.xml,80444/xv13735,0,0,0,0
"Unknown",waufranklinedward3113.xml,80444/xv44866,0,0,0,0
"Unknown",waujensenray2853.xml,80444/xv13403,0,0,0,0
"Unknown",wauuwresource07310.xml,80444/xv42395,0,0,0,0
"University of Washington. Dept. of Near Eastern Languages and Civilization.",wauuwresource00279.xml,80444/xv22766,0,0,0,0
"Unknown",waudowningalfred2297.xml,80444/xv55786,0,0,0,0
"Unknown",waubergquistivar5236.xml,80444/xv66567,0,0,0,0
"Unknown",waublanchetaugustinemagloirealexander4614.xml,80444/xv20193,0,0,0,0
"Steinbrueck (Victor) film<emph> Comin' Home Baby </emph>",wausteinbrueckvictorvhs52.xml,80444/xv70214,0,0,0,0
"Unknown",wauhughescynthia2895.xml,80444/xv44366,0,0,0,0
"Washington (State). Forest Legislation Commission.",wauwashingtonforestlegislationcommission3631.xml,80444/xv58874,0,0,0,0
"Unknown",wauralkowskihenry2111.xml,80444/xv69595,0,0,0,0
"Unknown",waucarlenathaniela4701.xml,80444/xv08029,0,0,0,0
"Unknown",waulinkf2346.xml,80444/xv83599,0,0,0,0
"Unknown",waublainestatebank0975.xml,80444/xv86746,0,0,0,0
"Unknown",waupheejames1054.xml,80444/xv71850,0,0,0,0
"Unknown",wauwehmeyergladys2306.xml,80444/xv61737,0,0,0,0
"Unknown",wauaroninsam2660.xml,80444/xv09420,0,0,0,0
"Unknown",wauharrisphyllispier2767.xml,80444/xv19601,0,0,0,0
"Unknown",wauuwresource07388.xml,80444/xv13543,0,0,0,0
"Unknown",waucramfrankhugh4179.xml,80444/xv16708,0,0,0,0
"Unknown",wauliebofamily3744.xml,80444/xv20846,0,0,0,0
"Unknown",waulindenbergeredithrosenberg2127.xml,80444/xv56289,0,0,0,0
"Unknown",wauhuttonsolelwood0773.xml,80444/xv74615,0,0,0,0
"Unknown",wauparkedwardsamasa4839.xml,80444/xv92819,0,0,0,0
"Unknown",waumartzallwm3677.xml,80444/xv66336,0,0,0,0
"University of Washington. David C. Hall Health Center.",wauuwresource00222.xml,80444/xv29968,0,0,0,0
"Unknown",wauhodgsonallenh3027.xml,80444/xv85992,0,0,0,0
"Unknown",waumasonjoanleegrant3943.xml,80444/xv13159,0,0,0,0
"Unknown",wauberezowskynicolai4275.xml,80444/xv62451,0,0,0,0
"Gage (Fern) papers",waugagefern0477_1112_1525.xml,80444/xv93545,0,0,0,0
"Unknown",wauanschellrussellf4095.xml,80444/xv71353,0,0,0,0
"Unknown",wauuittijohn2864.xml,80444/xv62487,0,0,0,0
"Unknown",wauuwresource07253.xml,80444/xv70138,0,0,0,0
"Unknown",waudavenportnoahcleveland2543.xml,80444/xv54510,0,0,0,0
"Unknown",waulassmaneva4059.xml,80444/xv65121,0,0,0,0
"Unknown",wauuwresource07309.xml,80444/xv52337,0,0,0,0
"University of Washington. Air Force ROTC.",wauuwresource05677.xml,80444/xv75579,0,0,0,0
"Unknown",waumillerjay5226.xml,80444/xv83959,0,0,0,0
"Unknown",waurepublicanpartykitsapcountywashcentralcommitteeconvention4862.xml,80444/xv45703,0,0,0,0
"Unknown",wauparrothomasj3949.xml,80444/xv84442,0,0,0,0
"Unknown",wauolsenrayl0794.xml,80444/xv32034,0,0,0,0
"Schweidnitz (Paul Kunze) Photograph Collection",wauschweidnitzpaulph2005_060.xml,80444/xv99859,0,0,0,0
"Unknown",waumeuseray2570.xml,80444/xv08239,0,0,0,0
"Unknown",wauraceforlight2413.xml,80444/xv80154,0,0,0,0
"Unknown",wauboardmanelisha4617.xml,80444/xv97232,0,0,0,0
"Unknown",wauholocaustsurvivor3004.xml,80444/xv25802,0,0,0,0
"Unknown",waumalloryvirgilw0357.xml,80444/xv15151,0,0,0,0
"Unknown",waulevyjanet1824.xml,80444/xv24688,0,0,0,0
"Unknown",waukaufmanhoward3269.xml,80444/xv92803,0,0,0,0
"Gould (Florence Jones) Papers",wauua19_13_5203gouldflorencejones.xml,80444/xv61648,0,0,0,0
"Unknown",wauswalwellarline4388.xml,80444/xv16897,0,0,0,0
"Unknown",waumechemcf0662.xml,80444/xv99273,0,0,0,0
"Unknown",waurosenfieldjoseph3987.xml,80444/xv22421,0,0,0,0
"Unknown",waubrintonjoanm2140.xml,80444/xv59573,0,0,0,0
"University of Washington. Physical and Health Education School.",wauuwresource00312.xml,80444/xv50592,0,0,0,0
"B'nai B'rith. Cascade Lodge No. 1822.",waubnaibrithcascadelodgeno1822_3590.xml,80444/xv58184,0,0,0,0
"Unknown",wauswedishtercentenaryassociationofseattleandvicinity3490.xml,80444/xv24163,0,0,0,0
"Unknown",waubrandesthergertrudegarske3792.xml,80444/xv23178,0,0,0,0
"Unknown",waucliffedwardp3289.xml,80444/xv23403,0,0,0,0
"Unknown",waubrinsmeadwilliam3083.xml,80444/xv41540,0,0,0,0
"Unknown",waumoorejanets2400.xml,80444/xv95849,0,0,0,0
"Unknown",waugriffindanielwilliam2747.xml,80444/xv51477,0,0,0,0
"University of Washington. Dept. of Physiology and Biophysics.",wauuwresource00415.xml,80444/xv36386,0,0,0,0
"University of Washington. Research Computer Laboratory.",wauuwresource00339.xml,80444/xv03118,0,0,0,0
"Unknown",waucockerellsydneycarlyle4637.xml,80444/xv48062,0,0,0,0
"Unknown",waustoriesoftheswedishpioneersinnorthamerica1962.xml,80444/xv95526,0,0,0,0
"University of Washington. High School Relations Office.",wauuwresource00114.xml,80444/xv89450,0,0,0,0
"Unknown",wauuwresource07382.xml,80444/xv73120,0,0,0,0
"Unknown",waupearsonmowbrayfrench0209.xml,80444/xv07055,0,0,0,0
"Unknown",waucrockettwalter0037.xml,80444/xv79385,0,0,0,0
"University of Washington. Dept. of Astronomy.",wauuwresource00301.xml,80444/xv50582,0,0,0,0
"Unknown",wauedelbluteluciussamuel4646.xml,80444/xv53509,0,0,0,0
"Unknown",waumerrillricharddwight3617.xml,80444/xv37149,0,0,0,0
"Unknown",waugoldenesther4361.xml,80444/xv17230,0,0,0,0
"Thompson (Alfred G.) Papers",wauthompsonalfredg5941.xml,80444/xv02035,0,0,0,0
"Unknown",waushepherdof3832.xml,80444/xv97174,0,0,0,0
"Unknown",wauhealdwpaul2851.xml,80444/xv11077,0,0,0,0
"Unknown",waurudeneelizabethcornelius0417.xml,80444/xv36401,0,0,0,0
"Unknown",wauburgesswilliamo2304.xml,80444/xv85403,0,0,0,0
"Unknown",wauunitedstatessteelcorporation4939.xml,80444/xv47113,0,0,0,0
"Unknown",wauuwresource07408.xml,80444/xv58682,0,0,0,0
"Unknown",wauprogressivefarmersofamerica1439.xml,80444/xv01538,0,0,0,0
"Unknown",waujacksonelizabeths3758.xml,80444/xv36111,0,0,0,0
"Lewis and Clark Exposition Photograph Collection",waulewisandclarkexpositionphcoll391.xml,80444/xv31008,0,0,0,0
"Unknown",waurutelonisruby3552.xml,80444/xv27212,0,0,0,0
"Unknown",waurepublicannationalcommitteeus2101.xml,80444/xv68560,0,0,0,0
"Unknown",wauholmanmickelwaitmarionblackandperkins2114.xml,80444/xv82070,0,0,0,0
"Unknown",wausmithalbert1258.xml,80444/xv16394,0,0,0,0
"Unknown",waubeckeyfredw1581.xml,80444/xv63757,0,0,0,0
"Unknown",wauuwresource07270.xml,80444/xv39700,0,0,0,0
"Unknown",waufukanoyasuko1768.xml,80444/xv48303,0,0,0,0
"Unknown",waupacificnorthwestcenterforjewisharts4375.xml,80444/xv92764,0,0,0,0
"Unknown",waubrownjanetaskren3941.xml,80444/xv32388,0,0,0,0
"Unknown",wauellenbogenhelenpoplack3699.xml,80444/xv22659,0,0,0,0
"Koepke (Georgia Compton) Photograph Collection",waukoepkegeorgiacomptonph2016_008.xml,80444/xv04702,0,0,0,0
"Unknown",waugainesjohnpollard4734.xml,80444/xv70852,0,0,0,0
"Unknown",waulenzmargaretsylvester2164.xml,80444/xv95910,0,0,0,0
"Unknown",waurivordwilliama2176.xml,80444/xv29788,0,0,0,0
,,Totals,51955,54345,73188,179488
