Title,Document Name,Ark Identifier,July,August,September,Total
"Blonk (Hubert) Papers",wea_spc0060628.xml,80444/xv74981,3,9,5,17
"Expo '74 Folklife Festival Records",weaspc9740020.xml,80444/xv18206,3,6,4,13
"Independent Order of Odd Fellows, Cheney Lodge no. 21 (Cheney, Wash.) Records",wea_spc9920355.xml,80444/xv34234,0,8,4,12
"<?xm-replace_text {Filing title of collection, eg. Adams (Glen R.) Papers; required}?>Gess (Inez) Collection",wea_spc0160729.xml,80444/xv02987,0,12,0,12
"Washington Water Power Company Records",weaspc9720006.xml,80444/xv44732,3,6,3,12
"Evans (Thomas) Letters and Diary",wea_spc9720007.xml,80444/xv23037,9,0,2,11
"Mosby (Beverly Clarke) Papers",wea_spc9720005.xml,80444/xv34078,4,5,1,10
"Lotzenhiser (George W. ) Papers",wea_spc9770038.xml,80444/xv46301,8,2,0,10
"Wylie (E. Burke) Papers",wea_spc9760031.xml,80444/xv76214,0,4,5,9
"Faw Family Papers",wea_spc9760029.xml,80444/xv53399,5,1,3,9
"Trulove (William Thomas) Papers",wea_spc9940362.xml,80444/xv61422,2,3,3,8
"Beaty (Donald) Collection",wea_spc9820165.xml,80444/xv11401,4,0,3,7
"Kalez (Jay J.) Papers",wea_spc9740012.xml,80444/xv21255,2,2,3,7
"Coons, Shotwell, Clark and Associates Expo '74 Records",weaspc9780064.xml,80444/xv59188,3,3,0,6
"Ritzville Federated Women's Club Records",wea_spc9990503.xml,80444/xv79714,0,6,0,6
"Ninety-Nines Intermountain Chapter Records",wea_spc9840221.xml,80444/xv14944,0,3,3,6
"Lucas (Voe) Papers",wea_spc9800016.xml,80444/xv05764,0,0,6,6
"Washington Brick and Lime Company Minute Books",wea_spc9720002.xml,80444/xv88510,0,4,2,6
"Barnes (Donald M.) Collection",wea_spc9950387.xml,80444/xv63235,2,4,0,6
"U.S. Army Ft. Colville Papers",wea_spc9980492.xml,80444/xv21542,0,6,0,6
"Pearce (George H.) Papers",wea_spc9770041.xml,80444/xv89111,0,5,0,5
"Cole (King) Papers",wea_spc9980487.xml,80444/xv96264,5,0,0,5
"<?xm-replace_text {Filing title of collection, eg. Adams (Glen R.) Papers; required}?>Inland Automobile Association Records<?xm-replace_text {Collection title; required}?>",wea_spc9740011.xml,80444/xv11444,0,4,1,5
"<?xm-replace_text {Filing title of collection, eg. Adams (Glen R.) Papers; required}?>Eastern Washington University, Women's Studies Program Records",wea_ewu9840094.xml,80444/xv28311,0,5,0,5
"Washington State Federation of Women's Clubs Records",wea_spc9910339.xml,80444/xv83270,0,5,0,5
"Becher (Edmund T.) Papers",wea_spc9820163.xml,80444/xv08410,3,1,0,4
"O'Brien (Jack) Photograph of Cheney State Normal School",wea_spc9980486.xml,80444/xv09271,2,0,2,4
"Smith (Adolphe) and Gwen Smith Papers",wea_spc9770040.xml,80444/xv60876,0,4,0,4
"Danskin (Floyd and Hannah) Papers",wea_spc9710001.xml,80444/xv74969,2,1,1,4
"Powers (Walter L.) Papers",wea_spc9880288.xml,80444/xv77062,4,0,0,4
"Neils (Allan) Papers",wea_spc9850240.xml,80444/xv71722,4,0,0,4
"<?xm-replace_text {Filing title of collection, eg. Adams (Glen R.) Papers; required}?> <?xm-replace_text {Collection title; required}?>Wolff (James "Jamie") Photographs",wea_spc0130710.xml,80444/xv08441,1,2,1,4
"Ross (John) Papers",wea_spc9820174.xml,80444/xv66534,0,1,3,4
"Campbell (Fred F.) Papers",wea_spc9770037.xml,80444/xv27499,0,2,1,3
"Inland Empire Telephone Company Records",wea_spc9860254.xml,80444/xv68206,0,3,0,3
"Pierce (Donald), Dr. Papers",wea_spc9760034.xml,80444/xv96331,0,3,0,3
"Warden (Cliff) Papers",wea_spc9980490.xml,80444/xv12249,2,0,1,3
"Helsing (Paul) Papers",wea_spc9740013.xml,80444/xv57388,0,3,0,3
"McGovern (Carol) Ledger Collection",wea_spc9740014.xml,80444/xv95321,0,3,0,3
"R.B. Gunderson Papers",wea_spc9970444.xml,80444/xv25045,0,3,0,3
"Fahlgren (Barbara Hamre) Papers",wea_spc0040587.xml,80444/xv67929,3,0,0,3
"Whitehouse (Harold C.) Papers",weaspc9830207.xml,80444/xv44598,3,0,0,3
"Gaines (Xerpha Mae) Photograph Collection",wea_spc9710003.xml,80444/xv33135,3,0,0,3
"Spokane Federation of Social Workers Records",wea_spc9760028.xml,80444/xv44641,0,2,0,2
"Wesseler (May) Letter to A.E. Wesseler",wea_spc9740017.xml,80444/xv20941,0,2,0,2
"Butler (Alfred D.) Memorabilia Collection",wea_spc9780077.xml,80444/xv29653,2,0,0,2
"Adams (Glen Cameron) Correspondence Collection",wea_spc9800123.xml,80444/xv81735,2,0,0,2
"Ball (Milo) Papers",wea_spc9970431.xml,80444/xv56362,0,2,0,2
"Chambers (George) Papers",wea_spc9980489.xml,80444/xv92791,2,0,0,2
"Wyche (J.E.) Papers",wea_spc9970475.xml,80444/xv20895,1,1,0,2
"Martin (Clarence D.) Papers",wea_spc9730009.xml,80444/xv20254,0,2,0,2
"Mutschler (Charles V.) Papers",wea_spc9840223.xml,80444/xv24032,2,0,0,2
"Bernhard (John E.) Photograph Collection",wea_spc9820166.xml,80444/xv77682,2,0,0,2
"Turner (Wayne Ogden) Papers",wea_spc9970476.xml,80444/xv66845,1,0,1,2
"Douglas (David) Papers",wea_spc9970481.xml,80444/xv50189,2,0,0,2
"Oral History Interview with Mr. and Mrs. Earl Coates",wea_spc9800107.xml,80444/xv93408,0,2,0,2
"Farmer's State Bank of Reardan Records",wea_spc9920354.xml,80444/xv47454,0,2,0,2
"Youngs (J. William T.) Papers",wea_spc9980491.xml,80444/xv02273,2,0,0,2
"Bauman (Charles) Papers",wea_spc9910344.xml,80444/xv81759,0,2,0,2
"Confederated Tribes of the Colville Reservation Proposed Law and Order Code of the Colville Indian Tribe",wea_spc9900325.xml,80444/xv74856,0,2,0,2
"Klamath Agency Records",wea_spc9780047.xml,80444/xv95593,0,2,0,2
"Pauling (Connie) Papers",wea_spc9970479.xml,80444/xv56796,2,0,0,2
"Peterson (David) Papers",wea_spc9980488.xml,80444/xv38635,2,0,0,2
"Merriam (Willis B.) Papers",wea_spc9880286.xml,80444/xv99774,0,2,0,2
"Spokane Resource Advocates Records",wea_spc9760032.xml,80444/xv79605,0,2,0,2
"Freeman (Otis) Papers",wea_spc9880293.xml,80444/xv27526,0,0,2,2
"Spokane Community Action Council Records",wea_spc9740015.xml,80444/xv64785,0,2,0,2
"Ames (Lawrence) Photograph Collection",wea_spc9740018.xml,80444/xv27114,0,2,0,2
"American Aid to France, Spokane Unit Records",wea_spc9900319.xml,80444/xv64779,2,0,0,2
"Eells (Cushing) Papers",wea_spc9970480.xml,80444/xv09417,2,0,0,2
"Thur (Vincent) Papers",wea_spc9900329.xml,80444/xv70269,0,1,1,2
"Yates (Keith) Manuscript",wea_spc9970461.xml,80444/xv43807,0,2,0,2
"Lehman (Arthur Philip) Papers",wea_spc9970477.xml,80444/xv85281,2,0,0,2
"Oral History Interview with Donald Rose",wea_spc9800108.xml,80444/xv43725,0,2,0,2
"Oral History Interview with Mrs. Joseph W. Strong",wea_spc9800106.xml,80444/xv00598,0,2,0,2
"Salnave (Cora) Diary",wea_spc9770036.xml,80444/xv25390,0,1,0,1
"Collection on George Washington",wea_spc9780063.xml,80444/xv20220,1,0,0,1
"Smith (Grant W.) Papers",wea_spc9810140.xml,80444/xv52856,0,1,0,1
"Baughman (Marge) Memorabilia Collection",wea_spc9760033.xml,80444/xv99017,0,1,0,1
"Smalley (Eugene V.) Papers",wea_spc9970472.xml,80444/xv71334,1,0,0,1
"Asan (Virginia) Papers",wea_spc9830188.xml,80444/xv64184,0,1,0,1
"Henderson (Anne M.) Papers",wea_spc9970466.xml,80444/xv54415,0,1,0,1
"Spokane International Railroad Records",wea_spc9910347.xml,80444/xv21710,0,0,1,1
"Philips (Nancy Kate Broadnax) Papers",wea_spc9780049.xml,80444/xv20349,0,1,0,1
"McMillan (Alice) Papers",wea_spc9970462.xml,80444/xv00381,0,1,0,1
"Women of Washington Collection on Women's Rights",wea_spc9800133.xml,80444/xv45837,0,0,1,1
"Hayward (Elva) Photograph Collection",wea_spc9770045.xml,80444/xv63729,0,1,0,1
"Bunting (David G.) Testimony and Research Data",wea_spc9780050.xml,80444/xv64978,0,1,0,1
"Walker (William) Papers",wea_spc9970474.xml,80444/xv30392,1,0,0,1
"Ames (Susan Blackwell) Papers",wea_spc9800118.xml,80444/xv18914,0,1,0,1
"Dickelman (Evelyn A.) Class Paper",wea_spc9780058.xml,80444/xv44226,0,1,0,1
"Tieje (Ralph Earl) Papers",wea_spc9780052.xml,80444/xv85018,0,1,0,1
"Pence (Omar) Annotated Copy of the Arrow",wea_spc9780051.xml,80444/xv55899,0,1,0,1
"Rosebush (Waldo Emerson) Papers",wea_spc9970471.xml,80444/xv82711,1,0,0,1
"Graham (Thomas) Papers",wea_spc9970443.xml,80444/xv50616,0,1,0,1
"Colored Men's Business League Minute Book",wea_spc9790097.xml,80444/xv90316,0,0,0,0
"Davis (Homer M.) Reminiscences",wea_spc9950396.xml,80444/xv86019,0,0,0,0
"Whitehill (Patrick) Papers",wea_spc9830187.xml,80444/xv57946,0,0,0,0
"Gravel (Alex) Interview Transcripts",wea_spc9800132.xml,80444/xv16131,0,0,0,0
"Cheney State Normal School Department of Physical Education Scrapbook",wea_spc9810156.xml,80444/xv90661,0,0,0,0
"Moretz (Fred) Papers",wea_spc9750024.xml,80444/xv76855,0,0,0,0
"Suzanne Metzler History of the Cheney United Methodist Church's Pipe Organ",wea_spc9840216.xml,80444/xv28671,0,0,0,0
"Stosolovich (Linda) Papers",wea_spc9780070.xml,80444/xv78851,0,0,0,0
"Citizens State Bank of Tekoa Records",wea_spc9810138.xml,80444/xv93801,0,0,0,0
"Thomason (Edith P.) Papers",wea_spc9950374.xml,80444/xv67123,0,0,0,0
"Moynahan (James) Papers",wea_spc9810150.xml,80444/xv05844,0,0,0,0
"Bash (Cullen) Papers",wea_spc9970436.xml,80444/xv49493,0,0,0,0
"Eastern Washington University Instructional Media Center Records",wea_spc9810153.xml,80444/xv29461,0,0,0,0
"Gardner (Geraldine) Interview and Photograph",wea_spc9780071.xml,80444/xv13638,0,0,0,0
"Saylor (V. Louise) Collection on Women's Studies Symposium at Eastern Washington University",wea_spc9790086.xml,80444/xv44308,0,0,0,0
"Buchanan (Julian E.) Sheet Music and Ballad Collection",wea_spc9820162.xml,80444/xv45053,0,0,0,0
"Wyer (Arthur E.) Papers",wea_spc9870269.xml,80444/xv67471,0,0,0,0
"Kreitz (Mabel) Papers",wea_spc9970447.xml,80444/xv89999,0,0,0,0
"Rice (Michael) Papers",wea_spc9960413.xml,80444/xv72109,0,0,0,0
"Clark (Helen) Collection",wea_spc9790083.xml,80444/xv18246,0,0,0,0
"Lutheran Council of Greater Spokane County Records",wea_spc9870266.xml,80444/xv37670,0,0,0,0
"Schmidt (Norma) Term Paper",wea_spc9850232.xml,80444/xv59121,0,0,0,0
"Leichner (Robert M.) Term Paper",wea_spc9850231.xml,80444/xv09774,0,0,0,0
"Rosenberg-Dishman (Marie B.) Papers",wea_spc9900321.xml,80444/xv54684,0,0,0,0
"Wigen (Barbara) Papers",wea_spc9960409.xml,80444/xv15841,0,0,0,0
"Eastern Washington University University Dames Records",wea_spc9940367.xml,80444/xv00369,0,0,0,0
"McPherson (J. Gordon) Papers",wea_spc9790085.xml,80444/xv08489,0,0,0,0
"Brock (Randall) Papers",wea_spc9850242.xml,80444/xv53671,0,0,0,0
"Alkire (Leland G.) Papers",wea_spc9870278.xml,80444/xv05471,0,0,0,0
"Cheney Land and Water Company Records",wea_spc9780066.xml,80444/xv24847,0,0,0,0
"Deutsch (Herman) Newsclipping and Pamphlet File",wea_spc9800110.xml,80444/xv84317,0,0,0,0
"Bonneville Cultural Resources Group Reports",wea_spc9820161.xml,80444/xv22912,0,0,0,0
"Kabat (George) Papers",wea_spc9950377.xml,80444/xv72915,0,0,0,0
"Davis (Mary Ann Cashup) letter to William A. Davis",wea_spc9800131.xml,80444/xv49957,0,0,0,0
"Robertson (Emma) Scrapbook Collection",wea_spc9780061.xml,80444/xv92941,0,0,0,0
"Herbert Gunderson Collection of Eastern Washington State College Academic Senate Minutes",wea_spc9810155.xml,80444/xv94238,0,0,0,0
"Evangelical Lutheran Church in America, Eastern Washington/Idaho Synod Records",wea_spc9870265.xml,80444/xv85980,0,0,0,0
"Lutheran Campus and Young Adult Ministries Records",wea_spc9970430.xml,80444/xv35131,0,0,0,0
"Bonners Ferry Historical Society Interview Transcripts",wea_spc9780048.xml,80444/xv81707,0,0,0,0
"Christian (George E.) Papers",wea_spc9950385.xml,80444/xv47525,0,0,0,0
"Reimers (Henry L.) Papers",wea_spc9820176.xml,80444/xv83126,0,0,0,0
"Opendack (Byron) Literary Manuscripts",wea_spc9860256.xml,80444/xv42968,0,0,0,0
"Fitzpatrick (Ben) Papers",wea_spc9970041.xml,80444/xv59698,0,0,0,0
"Cheney Pioneer Bridge Club Scrapbook",wea_spc9800115.xml,80444/xv21310,0,0,0,0
"Williamson (Obed) Papers",wea_spc9830202.xml,80444/xv13327,0,0,0,0
"Garner (Frank) Papers",wea_spc9970442.xml,80444/xv31347,0,0,0,0
"Correspondence to George P. Lakin",wea_spc9870276.xml,80444/xv82641,0,0,0,0
"Links Inc. Spokane Chapter Records",wea_spc9790081.xml,80444/xv61053,0,0,0,0
"Maxey (Carl) interview",wea_spc9800112.xml,80444/xv27828,0,0,0,0
"Spangle (J.F.) Papers",wea_spc9970455.xml,80444/xv43359,0,0,0,0
"Bonneville Cultural Resources Group Computer Printout on Cultural Sites",wea_spc9830211.xml,80444/xv42666,0,0,0,0
"Morrell Family Genealogy",wea_spc9810154.xml,80444/xv37924,0,0,0,0
"Ludwig (Albert) Papers",wea_spc9850239.xml,80444/xv55194,0,0,0,0
"Dalling (William) Papers",wea_spc9820182.xml,80444/xv82540,0,0,0,0
"Kingston (Ceylon Samuel) Papers",wea_spc9820169.xml,80444/xv48855,0,0,0,0
"Stowe (Linda) Papers",wea_spc9850235.xml,80444/xv74380,0,0,0,0
"Bankson (Russell Arden) Papers",wea_spc9970434.xml,80444/xv62533,0,0,0,0
"Stafford (Sybil) interview",wea_spc9800111.xml,80444/xv34158,0,0,0,0
"Dryden (Cecil) Papers",wea_spc9790089.xml,80444/xv18734,0,0,0,0
"Watson (William G.) Diaries",wea_spc9750021.xml,80444/xv85400,0,0,0,0
"Parr (Edward) Papers",wea_spc9840218.xml,80444/xv92889,0,0,0,0
"Osborne (Josiah) Papers",wea_spc9970468.xml,80444/xv56918,0,0,0,0
"Lake (Sylvester) and Pauline E. Lake Interview Transcript",wea_spc9800105.xml,80444/xv68121,0,0,0,0
"Low (Eric) Scrapbooks",wea_spc9960417.xml,80444/xv63662,0,0,0,0
"Walton (Susan Gregg) Papers",wea_spc9970459.xml,80444/xv49224,0,0,0,0
"Barrows (Larry) Photograph Collection",wea_spc9780076.xml,80444/xv01779,0,0,0,0
"Christopher (Steven B.) Papers",wea_spc9820172.xml,80444/xv19613,0,0,0,0
"Reimers (Henry) Papers",wea_spc9970454.xml,80444/xv80783,0,0,0,0
"Quillen (Roger) Papers",wea_spc9970453.xml,80444/xv38668,0,0,0,0
"Green (Michael K.) Papers",wea_spc9790094.xml,80444/xv33645,0,0,0,0
"Washington Utilities and Transportation Commission Annual Reports",wea_spc9780165.xml,80444/xv81503,0,0,0,0
"Rea (Jay) Papers",wea_spc9810157.xml,80444/xv50076,0,0,0,0
"Schadegg (Francis) Papers",wea_spc9900334.xml,80444/xv72363,0,0,0,0
"Livingston (Louis) Papers",wea_spc9850234.xml,80444/xv58068,0,0,0,0
"Herold (Robert) Papers",wea_spc9890307.xml,80444/xv32635,0,0,0,0
"Chambers (Andrew Stutz) Papers",wea_spc9970438.xml,80444/xv89526,0,0,0,0
"Kennedy (Kenneth K.) Papers",wea_spc9830185.xml,80444/xv52819,0,0,0,0
"Gomberg (Pamela Bradford) Papers",wea_spc9850229.xml,80444/xv50720,0,0,0,0
"Case Family Genealogical Collection",wea_spc9770039.xml,80444/xv87008,0,0,0,0
"St. Peter Lutheran Church Records",wea_spc9900320.xml,80444/xv24835,0,0,0,0
"Shuck (Emerson) Papers",wea_spc9830208.xml,80444/xv78204,0,0,0,0
"Northwest Angling Center Collection",wea_spc9800130.xml,80444/xv01705,0,0,0,0
"National Association for the Advancement of Colored People, Spokane Branch Records",wea_spc9790092.xml,80444/xv73471,0,0,0,0
"Groenen (Cornelius) Papers",wea_spc9830206.xml,80444/xv67770,0,0,0,0
"Eastern Washington Friends of Music Trust Records",wea_spc9830209.xml,80444/xv81222,0,0,0,0
"Kidd (William) Papers",wea_spc9810146.xml,80444/xv65368,0,0,0,0
"Hansen (Donald A.) Papers",wea_spc9860250.xml,80444/xv82983,0,0,0,0
"Sidmondet (Helen) Papers",wea_spc9860253.xml,80444/xv62454,0,0,0,0
"International Lutheran Marriage Encounter Records",wea_spc9890306.xml,80444/xv50369,0,0,0,0
"Stevens (William) Papers",wea_spc9800121.xml,80444/xv42358,0,0,0,0
"Gates (J.M.) Mrs., Papers",wea_spc9810144.xml,80444/xv72772,0,0,0,0
"Misner Family Collection",wea_spc9790093.xml,80444/xv72024,0,0,0,0
"Eastern Washington University Faculty Wives/Faculty Women Records",wea_spc9910348.xml,80444/xv53414,0,0,0,0
"Odessa High School (Wash.) Papers",wea_spc9840222.xml,80444/xv59075,0,0,0,0
"Battien (Pauline) Papers",wea_spc9800127.xml,80444/xv24270,0,0,0,0
"Oral History Interview with James Ralph Jones",wea_spc9780072.xml,80444/xv95913,0,0,0,0
"Anderson (Louise) Diplomas and Medallion",wea_spc9790096.xml,80444/xv78137,0,0,0,0
"Saylor (Louise) Papers",wea_spc9840224.xml,80444/xv33987,0,0,0,0
"Cushing (Caleb) Papers",wea_spc9970463.xml,80444/xv93606,0,0,0,0
"Sutton (William James) Papers",wea_spc9790098.xml,80444/xv57562,0,0,0,0
"Beal (Bruce Douglas) Diazotype Print Collection",wea_spc9900323.xml,80444/xv29660,0,0,0,0
"Sutherland (George W.) Papers",wea_spc9970456.xml,80444/xv15640,0,0,0,0
"Oakshott (Thomas) Papers",wea_spc9970450.xml,80444/xv08386,0,0,0,0
"Smith (A. Lamont) Papers",wea_spc9840215.xml,80444/xv23577,0,0,0,0
"Newell (Winifred) Papers",wea_spc9970467.xml,80444/xv16329,0,0,0,0
"Ritz (Philip) Papers",wea_spc9970470.xml,80444/xv50524,0,0,0,0
"Barr (William) Papers",wea_spc9810141.xml,80444/xv28314,0,0,0,0
"Emerson (Stephen) Papers",wea_spc9950375.xml,80444/xv18414,0,0,0,0
"Franklin (Joseph) Papers",wea_spc9840226.xml,80444/xv79211,0,0,0,0
"Baldwin (Charles M.) Papers",wea_spc9950389.xml,80444/xv67810,0,0,0,0
"McKereghan (Donna) Papers",wea_spc9920356.xml,80444/xv10348,0,0,0,0
"Leichman (Howard) Papers",wea_spc9900315.xml,80444/xv88647,0,0,0,0
"Northwest Regional Foundation Records",wea_spc9840228.xml,80444/xv65365,0,0,0,0
"Slater (William) Oral History",wea_spc9950401.xml,80444/xv47509,0,0,0,0
"Lauritsen (Frederick) Papers",wea_spc9810145.xml,80444/xv26388,0,0,0,0
"Tracy (Joan I.) Papers",wea_spc9880298.xml,80444/xv34353,0,0,0,0
"Clumpner (Mick) Papers",wea_spc9870277.xml,80444/xv23458,0,0,0,0
"Heinzen (Richard) Photograph Collection",wea_spc9870279.xml,80444/xv97674,0,0,0,0
"Hartman (Sara M.) Papers",wea_spc9970465.xml,80444/xv96023,0,0,0,0
"Reimers (Henry L.) Papers",wea_spc9970469.xml,80444/xv44192,0,0,0,0
"Inland Empire Steam and Gas Buffs Records",wea_spc9810139.xml,80444/xv11575,0,0,0,0
"Winans (W.P.) Papers",wea_spc9970460.xml,80444/xv38162,0,0,0,0
"Patterson (Howard W.) photograph Collection",wea_spc9820179.xml,80444/xv72979,0,0,0,0
"Emmanuel Lutheran Church Records",wea_spc9870283.xml,80444/xv67633,0,0,0,0
"Retired Railway Mail Clerks Records",wea_spc9850236.xml,80444/xv67822,0,0,0,0
"Council of Spokane Area Libraries Records",wea_spc9950383.xml,80444/xv19735,0,0,0,0
"Rowles (William L.) Papers",wea_spc9790090.xml,80444/xv00964,0,0,0,0
"Foreman (Lovinia May) Papers",wea_spc9890313.xml,80444/xv80273,0,0,0,0
"Barry (James Neilson) Papers",wea_spc9970435.xml,80444/xv31503,0,0,0,0
"Patsy Manson Cheney State Normal School Class Ring",wea_spc9830189.xml,80444/xv09744,0,0,0,0
"Oliphant (J. Orin) Papers",wea_spc9970451.xml,80444/xv84921,0,0,0,0
"Giles (Raymond M.) Papers",wea_spc9830196.xml,80444/xv13757,0,0,0,0
"Robertson (George T.) Papers",wea_spc9810148.xml,80444/xv68652,0,0,0,0
"Davis(Lucille) Papers",wea_spc9830204.xml,80444/xv87487,0,0,0,0
"Drake (Elmer) Journal",wea_spc9810134.xml,80444/xv82022,0,0,0,0
"Kingston (Ceylon S.) Papers",wea_spc9800019.xml,80444/xv70498,0,0,0,0
"Gilbert (Reta) Papers",wea_spc9810142.xml,80444/xv38613,0,0,0,0
"Geyer (Charles A.) Papers",wea_spc9970464.xml,80444/xv73297,0,0,0,0
"Crockett (Edwin) Papers",wea_spc9970440.xml,80444/xv52044,0,0,0,0
"Fahey (John) Papers",wea_spc9760030.xml,80444/xv06121,0,0,0,0
"Hossom (H. Kenneth) Papers",wea_spc9760027.xml,80444/xv48184,0,0,0,0
"Brosh (Merle A.) Papers",wea_spc9970437.xml,80444/xv16577,0,0,0,0
"Dustin (H. Antoinette) letter",wea_spc9820158.xml,80444/xv62036,0,0,0,0
"Craig (George E.) Papers",wea_spc9970439.xml,80444/xv04159,0,0,0,0
"Cheney Family Papers",wea_spc9820168.xml,80444/xv49133,0,0,0,0
"Booth Family History",wea_spc9800113.xml,80444/xv95443,0,0,0,0
,,Totals,110,177,63,350
