Title,Document Name,Ark Identifier,July,August,September,Total
"Collection of Aerial Photographs",xoe_cpnws0318aerialphotos.xml,80444/xv13894,178,161,159,498
"Alaska Packers Association records",xoe_cpnws0026apa.xml,80444/xv77299,115,98,172,385
"Pacific American Fisheries Records",xoe_cpnws0021paf.xml,80444/xv45835,90,84,97,271
"Center for Pacific Northwest Studies pamphlet collection",xoe_cpnws0042pamphlet.xml,80444/xv43107,45,65,60,170
"KVOS Channel 12 Film Records",xoe_cpnws0030kvos.xml,80444/xv75590,47,52,70,169
"Northwest Tribal Oral History interviews",xoe_cpnws0067nwtribal.xml,80444/xv03778,46,53,65,164
"Hovde (Jane Hamilton and Annis Jorgen (A.J.)) Papers",xoe_cpnws0016hovde.xml,80444/xv14714,48,68,47,163
"Biery (Galen) Papers and Photographs",xoe_cpnws0027biery.xml,80444/xv09926,38,55,63,156
"Western Washington University Centennial Oral History Project Records",xoe_cpnws0075wwuoralhist.xml,80444/xv66705,67,40,44,151
"Mason (David T. ) Papers",xoe_cpnws0045mason.xml,80444/xv13691,40,56,36,132
"Stimpson Family papers",xoe_cpnws0191stimpson.xml,80444/xv70469,38,49,34,121
"Wells (Oliver) oral history interviews",xoe_cpnws0258wells.xml,80444/xv17288,29,60,26,115
"Northwest Ethnohistory collection",xoe_cpnws0039nwethnohistory.xml,80444/xv99881,31,32,50,113
"Garlick family (George and Lois) papers",xoe_cpnws0137garlick.xml,80444/xv09592,37,49,24,110
"Funk (Wally V.) photographs and papers",xoe_cpnws0041funk.xml,80444/xv37969,36,32,35,103
"Nora Hastie (Year of Birth: 1877) interviewed by: unknown",xoe_cpnws0235skagitohp.xml,80444/xv18371,21,40,40,101
"Higginson (Ella) Papers",xoe_cpnws0007higginson.xml,80444/xv19502,13,36,48,97
"Press Clippings",xoe_cpnws0029swift.xml,80444/xv67051,17,36,42,95
"Unknown",xoe_cpnws0044bcohp.xml,80444/xv00349,22,30,41,93
"Puget Sound Power and Light Company records",xoe_cpnws0004puget.xml,80444/xv03427,28,28,36,92
"Buswell (Howard E.) papers and photographs",xoe_cpnws0017buswell.xml,80444/xv47545,23,22,37,82
"Patterson, Margaret and Rev. J. W. Patterson papers",xoe_cpnws0069patterson.xml,80444/xv52683,25,36,21,82
"Royal Development Company (Trinity Mine) Records",xoe_cpnws0019royaldev.xml,80444/xv36261,20,46,14,80
"Wahl (Ralph E.) Photographs and Papers",xoe_cpnws0024wahl.xml,80444/xv44126,16,31,32,79
"Gay and Lesbian Miscellaneous Manuscript Collection",xoe_cpnws0136glbtmiscman.xml,80444/xv14038,16,30,31,77
"Ashworth, Robert collection on the Union of Sexual Minorities Center of Western Washington University",xoe_cpnws0081ashworth.xml,80444/xv19512,14,38,24,76
"Larrabee family papers",xoe_cpnws0018larrabee.xml,80444/xv80378,24,35,17,76
"Washington Women's Heritage Project Records",xoe_cpnws0025wwhp.xml,80444/xv69091,14,24,36,74
"Burn (June and Farrar) Papers",xoe_cpnws0005burn.xml,80444/xv54045,17,27,29,73
"Unknown",xoe_cpnws0015jeffcott.xml,80444/xv82087,20,24,25,69
"Permanente Cement Company - Bellingham Cement Plant images",xoe_cpnws0329permanente.xml,80444/xv67556,21,30,16,67
"Aberdeen Daily World, The",xoe_cpnws0109cpnwsnewspapercollection.xml,80444/xv05310,10,26,31,67
"Lithographs and Charts of George Vancouver's Expeditions",xoe_cpnws0105bullitt.xml,80444/xv95776,12,29,25,66
"Whatcom Falls Mill Co. Records, George W. Loggie Papers",xoe_cpnws0009wfallsmill.xml,80444/xv85165,13,33,16,62
"Waterfront Oral History Project records",xoe_cpnws0283waterfront.xml,80444/xv47557,13,20,28,61
"Metcalf (Jack) Papers",xoe_cpnws0043metcalf.xml,80444/xv67725,9,24,26,59
"Cole (Robert J.) collection of Lone Jack Mine records",xoe_cpnws0322lonejack.xml,80444/xv99584,22,17,20,59
"Thompson family papers",xoe_cpnws0244thompson.xml,80444/xv95778,13,21,21,55
"Whatcom County Nuclear Arms Freeze records",xoe_cpnws0106whatnukefreeze.xml,80444/xv82441,7,25,22,54
"Georgia-Pacific Corporation, Bellingham Division records",xoe_cpnws0157gp.xml,80444/xv13366,22,16,15,53
"Center for Pacific Northwest Studies Miscellaneous Manuscripts collection",xoe_cpnws0054miscmans.xml,80444/xv15399,11,24,17,52
"Women in the Commercial Fishing Industry Research Collection",xoe_cpnws0133womeninfishing.xml,80444/xv25667,12,21,19,52
"Whatcom County School annuals",xoe_cpnws0271wcsa.xml,80444/xv78336,22,13,16,51
"Olsen (Vic & Mae) Civilian Conservation Corps Collection",xoe_cpnws0003olsen.xml,80444/xv20869,10,19,20,49
"Whatcom County Woman's Christian Temperance Union Records",xoe_cpnws0059wctu.xml,80444/xv46523,20,9,19,48
"Unknown",xoe_cpnws0011rjones.xml,80444/xv50623,18,14,16,48
"Unknown",xoe_cpnws0013bpublishingco.xml,80444/xv16081,20,11,17,48
"Cuthill (John McFarlane)",xoe_cpnws0122johnmcfarlanecuthill.xml,80444/xv15942,16,17,14,47
"Bellingham Bay Improvement Co. Records",xoe_cpnws0002bbic.xml,80444/xv88244,12,15,20,47
"Barrett (Eldon) Papers",xoe_cpnws305barrett.xml,80444/xv65078,5,15,27,47
"Whatcom County Homemade Music Society oral histories",xoe_cpnws0301wchms.xml,80444/xv98605,11,17,18,46
"Morse Hardware Company records",xoe_cpnws0020morsehardware.xml,80444/xv13003,10,18,18,46
"Montgomery (Elizabeth Rider) Papers",xoe_sc0001erm.xml,80444/xv31433,14,23,8,45
"Unknown",xoe_cpnws0014druzea.xml,80444/xv49257,14,14,16,44
"Donovan (J.J.) photographs",xoe_cpnws0127jjdonovanphotographs.xml,80444/xv24462,5,19,20,44
"Hovander Family and Park Papers",xoe_cpnws0022hovander.xml,80444/xv78668,13,15,15,43
"Stimpson (Edward W.) Papers",xoe_cpnws0311stimpsonew.xml,80444/xv77746,14,14,15,43
"VÃ¶lkerkundliche Arbeitsgemeinschaft collection on Native Americans",xoe_cpnws0251volkarbeit.xml,80444/xv08871,6,14,21,41
"Nelsen, Ibsen A. (Ibsen Andreas) papers",xoe_cpnws0057nelsen.xml,80444/xv40709,12,9,19,40
"Smith (Frederick E.) papers",xoe_cpnws0060smithfe.xml,80444/xv23952,11,16,12,39
"Women's Maritime Association",xoe_cpnws0194wma.xml,80444/xv73205,10,12,16,38
"Williamson (James R.) drawings",xoe_cpnws0277williamsonj.xml,80444/xv42085,13,12,12,37
"Hands Off Washington, Whatcom County Coalition Council records",xoe_cpnws0139handsoff.xml,80444/xv10618,4,14,19,37
"Cummins, Nora B.",xoe_cpnws0064cummins.xml,80444/xv25323,2,14,20,36
"Fisher (Charles Henry) Collection",xoe_sc0005fishers.xml,80444/xv43600,12,11,13,36
"Raymond (Steve) Papers",xoe_sc0003raymonds.xml,80444/xv85943,9,13,14,36
"Hinckley, Ted C. Papers",xoe_cpnws0063hinckley.xml,80444/xv33532,10,11,14,35
"American Association of University Women,Washington State Records",xoe_cpnws0032aauw.xml,80444/xv01717,5,9,21,35
"Wahl's Department Store Records",xoe_cpnws0046wahlstore.xml,80444/xv33181,19,6,10,35
"Shiels, Archie W. papers",xoe_cpnws0232shiels.xml,80444/xv68418,7,14,14,35
"Mount Baker Club Records",xoe_cpnws0006mtbaker.xml,80444/xv86875,2,17,16,35
"Center for Pacific Northwest Studies Miscellaneous Scrapbooks collection",xoe_cpnws0065scrapbook.xml,80444/xv80044,4,17,13,34
"American Civil Liberties Union - Whatcom County Chapter Records",xoe_cpnws0035aclu.xml,80444/xv34549,12,10,12,34
"Remembering Whatcom Creek Collection",xoe_cpnws0038rwhatcomcreek.xml,80444/xv72512,14,11,8,33
"Young Women's Christian Association of Bellingham records",xoe_cpnws0193ywcabellingham.xml,80444/xv40377,5,10,18,33
"League of Women Voters of Bellingham/Whatcom County records",xoe_cpnws0155lwv.xml,80444/xv52685,2,17,14,33
"Cheever (Bruce) railroad photographs",xoe_cpnws0028cheever.xml,80444/xv42757,5,15,12,32
"Stangroom, M.L (Marc La Riviere) papers",xoe_cpnws0239stangroom.xml,80444/xv86887,7,17,8,32
"Pulp Friction: Former Georgia-Pacific Employee interviews",xoe_cpnws0221pulpfriction.xml,80444/xv29016,13,8,11,32
"Aftermath Club records",xoe_cpnws0001aftermath.xml,80444/xv55411,5,10,17,32
"Motherlode records",xoe_cpnws0132motherlode.xml,80444/xv75939,8,9,14,31
"Bellingham Woman's Music Club records",xoe_cpnws0051bwmusicclub.xml,80444/xv31473,10,11,10,31
"Allen (Edwin J.), Jr. papers",xoe_cpnws0062allen.xml,80444/xv97122,14,9,8,31
"Tweddell (Colin) collection on Native Americans",xoe_cpnws0248tweddell.xml,80444/xv27035,2,9,19,30
"Whatcom County Chapter of the American National Red Cross Records",xoe_cpnws0079redcross.xml,80444/xv52343,2,11,17,30
"Western Washington University's "The Great Depression and its 50 Year Shadow" Symposium records",xoe_cpnws0040wwudepression.xml,80444/xv05137,0,14,16,30
"Jack (Rand) Papers",xoe_cpnws0169jackpapers.xml,80444/xv56332,11,12,6,29
"Hearsey (Herbert and Laura Beth) Papers",xoe_cpnws0061hearsey.xml,80444/xv96458,5,7,17,29
"Fisheries reports",xoe_cpnws0153fisheriesreports.xml,80444/xv42715,14,9,6,29
"Aiston (Peggy) - Research on Lummi Island History collection",xoe_cpnws0023aiston.xml,80444/xv11293,11,10,8,29
"Gates family papers",xoe_cpnws0050gates.xml,80444/xv48233,9,9,11,29
"Monday Club records",xoe_cpnws0066mondayclub.xml,80444/xv77306,5,12,11,28
"PLF Club Records",xoe_cpnws0058plf.xml,80444/xv13694,5,10,13,28
"Gargett (Gold Run) Mine photographs",xoe_cpnws0156gargettminephotos.xml,80444/xv89932,8,8,12,28
"Hicks (Arthur C.) Papers",xoe_sc0002hicksac.xml,80444/xv00546,16,8,3,27
"Raymond (Steve) Slides of Mount St. Helens",xoe_cpnws0335raymond.xml,80444/xv50732,11,5,11,27
"Morse Family Papers",xoe_cpnws0195morsefamily.xml,80444/xv29087,11,10,6,27
"Bartholick (George R.) Papers",xoe_cpnws0047bartholick.xml,80444/xv41050,5,9,12,26
"Brady (Ferd) photographs",xoe_cpnws0077brady.xml,80444/xv45163,5,9,12,26
"Bowen (Charles) papers",xoe_cpnws0101charlesbowenpapers.xml,80444/xv09097,8,11,6,25
"National Organization for Women Whatcom County Chapter records",xoe_cpnws0134now.xml,80444/xv73888,4,9,12,25
"Bosch (James W.) papers",xoe_cpnws0100jameswboschpapers.xml,80444/xv59887,9,6,10,25
"Mt. Baker Chapter of the Older Women's League records",xoe_cpnws0053owl.xml,80444/xv46521,8,7,10,25
"Droker (Howard) and Keith A. Murray Collection on Native American Fishing Rights",xoe_cpnws0130drokermurraynafr.xml,80444/xv20785,0,12,13,25
"Whatcom Memories Project oral histories",xoe_cpnws0276wmp.xml,80444/xv84674,5,12,8,25
"Blossomtime Festival scrapbooks",xoe_cpnws0098blossomtimefestival.xml,80444/xv53302,9,6,10,25
"Keller (Robert H.) Papers",xoe_cpnws0172kellerr.xml,80444/xv51690,3,9,12,24
"Griffin (Brian L.) papers",xoe_cpnws0288griffinbrian.xml,80444/xv96734,3,10,11,24
"Nesset Farm Environmental Stewardship Project Records",xoe_cpnws0147nesset.xml,80444/xv21221,5,8,11,24
"Hall, Claude C. Papers",xoe_cpnws304hallclaudec.xml,80444/xv69860,1,11,12,24
"Skagit County Abstract Company records",xoe_cpnws0234skagitabstracts.xml,80444/xv61923,8,5,9,22
"Women of Fairhaven records",xoe_cpnws0131womenfairhaven.xml,80444/xv52001,2,8,12,22
"Initiative 256 "Keep America Beautiful" Act of 1970 Records",xoe_cpnws0033initiative256.xml,80444/xv41048,7,9,6,22
"Block (Edward E.) Radio Heritage collection",xoe_cpnws0076block.xml,80444/xv12328,6,14,2,22
"Skagitonians Concerned About Nuclear Plants Records",xoe_cpnws0308scanp.xml,80444/xv41967,9,5,8,22
"Columbia Valley Lumber Company payroll ledger",xoe_cpnws0118columbiavalleylumberrecords.xml,80444/xv09045,3,13,5,21
"Association of Western Pulp and Paper Workers, Everett Kraft Mill Local #10 records",xoe_cpnws0084awppw.xml,80444/xv36608,10,4,7,21
"Gabl (Franz X.) papers",xoe_cpnws0036gabl.xml,80444/xv06505,4,10,5,19
"(no caption--torn) [cofferdam]",xoe_cpnws0321lbdc.xml,80444/xv21008,7,5,7,19
"Bovee (Robert C.) oral history interviews",xoe_cpnws0307bovee.xml,80444/xv78063,0,9,9,18
"Washington State Normal School Off-Campus Housing photographs",xoe_cpnws0092wsnsphotos.xml,80444/xv23284,5,2,11,18
"Bellingham Herald regional development drawings and maps",xoe_cpnws0088bhamheralddrawingsandmaps.xml,80444/xv80102,0,6,12,18
"Sullivan, Michael papers",xoe_cpnws0055michaelsullivan.xml,80444/xv87563,6,4,8,18
"Miller and Sons Records",xoe_cpnws0146millerandsons.xml,80444/xv47554,9,0,9,18
"Washington Pioneers Project: Whatcom County materials",xoe_cpnws0306wapioneerswhatcom.xml,80444/xv17089,1,5,11,17
"Washington State Harbor Line Commission maps",xoe_cpnws0254wastateharborline.xml,80444/xv56449,3,10,4,17
"Collection of Oral History Interviews on Whatcom County (Wash.) and Regional History",xoe_cpnws0289colloforalhistory.xml,80444/xv72207,1,9,7,17
"Northwest Women's Studies Association 1984 conference records",xoe_cpnws0215nwwsconf.xml,80444/xv10620,1,7,9,17
"Southwestern Alaska Cannery logbooks",xoe_cpnws0070swalogbooks.xml,80444/xv99198,0,9,7,16
"Whatcom Family YMCA records",xoe_cpnws0285ymca.xml,80444/xv21223,4,6,6,16
"World War II Carpetbagger Project manuscript",xoe_cpnws0326carpetbagger.xml,80444/xv68533,4,7,5,16
"Whatcom Human Rights Task Force records",xoe_cpnws0286whrtf.xml,80444/xv75605,1,7,8,16
"Bright (Norman) Papers",xoe_sc0009brightn.xml,80444/xv16360,6,3,7,16
"Trillium Corporation appraisal of the future Bellis Fair Mall site",xoe_cpnws0246trillium.xml,80444/xv61236,9,1,6,16
"Herre (Albert W.) Papers",xoe_sc0007herrea.xml,80444/xv48403,0,9,7,16
"Friday (W.R.(Bill))Papers",xoe_cpnws0010friday.xml,80444/xv17793,2,11,3,16
"Ross (Esther Ruth) last will and testament",xoe_cpnws0048ross.xml,80444/xv13082,2,4,10,16
"Edson (Lelah Jackson) scrapbooks",xoe_cpnws0140edson.xml,80444/xv90100,4,6,6,16
"Tjomsland (Blanche Saunders) papers",xoe_cpnws0245tjomsland.xml,80444/xv28407,0,5,10,15
"Boylan (Bernard L. and Marian) papers",xoe_cpnws0102boylanpapers.xml,80444/xv62408,6,6,3,15
"Whatcom Creek Pipeline Explosion: Decade of Healing records",xoe_cpnws0296decadehealing.xml,80444/xv70834,3,6,6,15
"Leopold Hotel records",xoe_cpnws0182leopoldrecords.xml,80444/xv09353,7,0,8,15
"Washington State Good Roads Association",xoe_cpnws0074wagoodroads.xml,80444/xv17115,2,7,6,15
"Washington State Oral/Aural History Program interviews",xoe_cpnws0255waoralhistprog.xml,80444/xv58618,4,6,5,15
"Lake Whatcom Improvement Committee Records",xoe_cpnws0177lwimprovementcomm.xml,80444/xv08912,3,6,5,14
"Women's Recreation Association (Western Washington State College)",xoe_wwuarc3900_001.xml,80444/xv38546,7,3,4,14
"Whatcom County Chapter of the United Nations Association of the United States of America records",xoe_cpnws0148whatcomun.xml,80444/xv07885,2,6,6,14
"Downie (William) maps",xoe_cpnws0129williamdowniemaps.xml,80444/xv07455,2,10,2,14
"Bellingham Herald collection on Charles H. Fisher",xoe_cpnws0332fisher.xml,80444/xv06610,4,5,5,14
"Laurel Community Baptist Church records",xoe_cpnws0178laurelbaptist.xml,80444/xv94692,0,6,8,14
"Collection of publications on Washington State",xoe_cpnws0278wlne.xml,80444/xv85800,3,6,5,14
"McFarland (George and Anna) papers",xoe_cpnws0188mcfarland.xml,80444/xv72640,4,2,7,13
"Point Roberts newspapers",xoe_cpnws0217pointrobnews.xml,80444/xv76629,0,7,6,13
"Mecklem (L. Guy) Collection",xoe_cpnws0037mecklem.xml,80444/xv39338,2,5,6,13
"Bellingham Yacht Club records",xoe_cpnws0096bellinghamyachtclub.xml,80444/xv64190,2,0,11,13
"Sehome History Group records",xoe_cpnws0231sehomehist.xml,80444/xv35589,4,3,6,13
"Koert (Dorothy) papers",xoe_cpnws0175koertd.xml,80444/xv84387,12,0,1,13
"Southeast Washington oral histories",xoe_cpnws0238sewaoralhist.xml,80444/xv31823,0,7,6,13
"Order of the Eastern Star records",xoe_cpnws0196orderoftheeasternstar.xml,80444/xv85175,4,5,4,13
"Central American Refugee Assistance records",xoe_cpnws0310cara.xml,80444/xv30496,0,4,9,13
"Congressional Railroad Survey map",xoe_cpnws0119congressionalrailroadmap.xml,80444/xv62484,10,0,2,12
"Clark (Jane) photographs",xoe_cpnws0117janeclarkphotographs.xml,80444/xv80249,1,7,4,12
"Ladies' Cooperative Society records",xoe_cpnws0298ladiescoop.xml,80444/xv17636,10,0,2,12
"Atwood (R. Frank) Papers",xoe_cpnws0031atwood.xml,80444/xv08215,5,4,3,12
"Radke (August) papers",xoe_cpnws0222radke.xml,80444/xv87280,4,4,4,12
"Keystone Harbor Association Records",xoe_cpnws0333keyston.xml,80444/xv92431,2,2,8,12
"Family of Three Lights Commune records",xoe_cpnws0144threelightscommune.xml,80444/xv01797,3,3,6,12
"Northwest Proud records",xoe_cpnws0213nwproud.xml,80444/xv45166,2,4,6,12
"Dahlgren (Nellie Roberts) papers",xoe_cpnws0123nelliedahlgrenpapers.xml,80444/xv57180,8,1,2,11
"Wirth Family papers",xoe_cpnws0309wirthfamilypapers.xml,80444/xv17349,6,0,5,11
"McGowan Family papers",xoe_cpnws0189mcgowan.xml,80444/xv90594,0,6,5,11
"Harms (A.F.) photographs",xoe_cpnws0162harmsaf.xml,80444/xv65359,10,0,1,11
"Collection of Miscellaneous Diaries",xoe_cpnws0078collofmiscdiaries.xml,80444/xv23229,0,1,10,11
"Snohomish County scrapbooks",xoe_cpnws0237snocoscrapbooks.xml,80444/xv93387,10,0,1,11
"Koons (Fritz) Papers and Komo Kulshan Ski Club Records",xoe_cpnws0052koons.xml,80444/xv81063,2,6,2,10
"Hogg, (James B.) collection on the D-Day Invasion",xoe_cpnws0166hogg.xml,80444/xv07113,0,5,5,10
"Mount St. Helens scrapbook",xoe_cpnws0205mtsthelens.xml,80444/xv17118,9,0,1,10
"North Cascades Audubon Society Records",xoe_cpnws0334ncas.xml,80444/xv94879,4,3,3,10
"Skagit Citizens for Nuclear Disarmament and Skagit Peace Education Fund Records",xoe_cpnws0341.xml,80444/xv54156,3,2,5,10
"Weaver (William) research materials on Washington State",xoe_cpnws0257weaver.xml,80444/xv55083,0,5,5,10
"Eklund (Don) papers",xoe_cpnws0141eklund.xml,80444/xv90069,0,4,6,10
"Western Washington University Centennial collection",xoe_cpnws0263wwucent.xml,80444/xv09390,3,3,4,10
"Brown (Vaughan) papers",xoe_cpnws0104vaughanbrownpapers.xml,80444/xv98016,7,2,1,10
"Collection of photographs on Washington State",xoe_cpnws0279wlp.xml,80444/xv07887,6,2,2,10
"Hegg (Eric A.) photograph album",xoe_cpnws0163hegg.xml,80444/xv67160,4,2,4,10
"Association of Pacific Coast Geographers records",xoe_cpnws0082apcg.xml,80444/xv47903,2,0,7,9
"Puget Sound Freight Lines records",xoe_cpnws0219psfreightline.xml,80444/xv74916,3,0,6,9
"Faulkner (J. Kaye) Papers",xoe_cpnws0145faulkner.xml,80444/xv66760,3,2,4,9
"Bellingham National Bank records",xoe_cpnws0091bellinghamnationalbank.xml,80444/xv97576,2,2,5,9
"Morgan Wheeler Company records",xoe_cpnws0275wheeler.xml,80444/xv09252,6,1,2,9
"Bellingham Chamber of Commerce photographs",xoe_cpnws0085bccp.xml,80444/xv99832,4,0,5,9
"Center for Pacific Northwest Studies publications photographs",xoe_cpnws0112cpnwspublicationphotographs.xml,80444/xv06838,7,0,2,9
"Bellingham Central Labor Council Records",xoe_cpnws0008bclaborc.xml,80444/xv52333,4,0,5,9
"Aldrich (Debbie) collection of League of Women Voters of Washington records",xoe_cpnws0327aldrich.xml,80444/xv14053,1,4,4,9
"Center for Pacific Northwest Studies Conferences collection",xoe_cpnws0108cpnwsconferences.xml,80444/xv61624,8,0,1,9
"Bornstein Seafoods records",xoe_cpnws0099bornsteinseafoods.xml,80444/xv68945,1,0,8,9
"Thomas (Robert B.) papers",xoe_cpnws0243thomasrobert.xml,80444/xv66616,1,3,5,9
"Wernstedt (Lage) photographs",xoe_cpnws0259wernstedt.xml,80444/xv20541,3,2,4,9
"Bellingham Jaycees records",xoe_cpnws0089bellinghamjaycees.xml,80444/xv85787,2,4,2,8
"Arntzen (Edward J.) papers",xoe_cpnws0080arntzen.xml,80444/xv81787,0,4,4,8
"Pacific Northwest Jazz Alliance records",xoe_cpnws0068pnwjazz.xml,80444/xv30110,0,5,3,8
"Oil in Washington Waters: Boon or Bane? conference photographs",xoe_cpnws0216oilwashconf.xml,80444/xv43453,5,2,1,8
"Bellingham Golf and Country Club since 1912 negatives",xoe_cpnws0324bhamgolfandcc.xml,80444/xv47772,0,0,8,8
"British Columbia Provincial Museum annual reports",xoe_cpnws0218bcprovmus.xml,80444/xv59832,0,0,8,8
"Miller (Mike) collection of British Columbia and Whatcom County maps",xoe_cpnws0315millermaps.xml,80444/xv95352,7,0,1,8
"Sumas Roundup Association records",xoe_cpnws0291sumasroundup.xml,80444/xv76846,3,0,5,8
"Hanvey (Les) mining records",xoe_cpnws0299hanveymining.xml,80444/xv98138,7,0,1,8
"Blaine Banner photographs",xoe_cpnws0282bbanner.xml,80444/xv86602,0,5,3,8
"Center for Pacific Northwest Studies postcard collection",xoe_cpnws0111cpnwspostcardcollection.xml,80444/xv59762,6,0,2,8
"Fourth Corner Registry records",xoe_cpnws0154fourthcorner.xml,80444/xv26354,0,0,7,7
"Brown (O. P.) papers",xoe_cpnws0103opbrownpapers.xml,80444/xv40378,1,2,4,7
"Lennart (Ernest Werner) papers",xoe_cpnws0180lennart.xml,80444/xv22042,4,1,2,7
"Thomas (J.E.) photographs",xoe_cpnws0242thomasphotos.xml,80444/xv62950,0,3,4,7
"Bellingham Municipal Dock records",xoe_cpnws0090bellinghammunicipaldock.xml,80444/xv65139,3,2,2,7
"Bacon, Crockett, and Donovan Family Genealogical Histories",xoe_cpnws0049bacon.xml,80444/xv98845,0,3,4,7
"Nelson (Edmund) papers",xoe_cpnws0209nelsoned.xml,80444/xv67868,2,4,1,7
"Railroad Commission of Washington maps",xoe_cpnws0223rrcommaps.xml,80444/xv05835,0,4,3,7
"Engberg (H.C.) photographs",xoe_cpnws0142engberg.xml,80444/xv72497,0,1,6,7
"Leedy family papers",xoe_cpnws0179leedy.xml,80444/xv64694,2,1,4,7
"MacPhail (Donald) papers",xoe_cpnws0184macphail.xml,80444/xv54934,0,6,1,7
"Duff (Nellie Browne) Papers",xoe_cpnws0138duff.xml,80444/xv71774,1,0,6,7
"Union Printing Company records",xoe_cpnws0072unionprintingco.xml,80444/xv16088,0,2,5,7
"Swift (Al) interview",xoe_cpnws0240alswiftinterview.xml,80444/xv97489,0,2,4,6
"Collection of Western Washington State College construction project materials",xoe_cpnws0261wwuconstruction.xml,80444/xv48687,2,2,2,6
"Moen (Einar) Papers",xoe_cpnws0340moen.xml,80444/xv01992,4,1,1,6
"Smith (Elmer) logging and shingle mill photographs",xoe_cpnws0330smithphotos.xml,80444/xv92276,3,0,3,6
"Teshera (Robert) Republican Party Records",xoe_cpnws0241tesherarep.xml,80444/xv83843,0,0,6,6
"Magnuson (Warren G.) 1972 interview materials",xoe_cpnws0186magnuson.xml,80444/xv28860,0,2,4,6
"Teck (Frank) papers",xoe_cpnws0071teck.xml,80444/xv83465,2,0,4,6
"Whatcom County Shoreline Inventory",xoe_cpnws0272wcsi.xml,80444/xv10965,2,0,4,6
"Holcombe family correspondence",xoe_cpnws0167holcombefamily.xml,80444/xv54779,0,1,5,6
"Tremaine (David) collection on the Clamdiggers Association",xoe_cpnws0336cda.xml,80444/xv61022,1,2,3,6
"Unknown",xoe_cpnws0012booker.xml,80444/xv83456,1,0,5,6
"Western Washington University faculty photographs",xoe_cpnws0264wwufphotos.xml,80444/xv90490,0,0,6,6
"Bellingham City Charter collection",xoe_cpnws0087bellinghamcharter.xml,80444/xv61123,0,1,5,6
"McInnis (Ray) typescripts",xoe_cpnws0190mcinnis.xml,80444/xv20959,4,0,1,5
"Kulshan Kiwanis Club records",xoe_cpnws0176kulshankiwanis.xml,80444/xv10690,4,0,1,5
"Gough (Barry M.) articles and papers",xoe_cpnws0159goughb.xml,80444/xv73587,4,0,1,5
"Kitsap Farmers Union Cooperative records",xoe_cpnws0312kitsapfarmers.xml,80444/xv02508,4,0,1,5
"Northwest Washington Fair Association records",xoe_cpnws0214nwwashfair.xml,80444/xv77994,3,0,2,5
"Fish trap location maps",xoe_cpnws0152fishtrap.xml,80444/xv25708,0,0,5,5
"Bellingham Chamber of Commerce records",xoe_cpnws0086bccr.xml,80444/xv92977,0,0,5,5
"Center for Pacific Northwest Studies slides",xoe_cpnws0114cpnwsslides.xml,80444/xv96670,0,0,5,5
"Lyle (Roland C.) map collection",xoe_cpnws0183lylemap.xml,80444/xv62423,3,1,1,5
"American Federation of Teachers Local 2084 records",xoe_cpnws0290aft.xml,80444/xv61270,4,0,1,5
"Washington State Climatological records",xoe_cpnws0252waclimate.xml,80444/xv23620,0,3,2,5
"Hammes (Jean) photographs",xoe_cpnws0160hammesj.xml,80444/xv83081,2,2,1,5
"Minckler (Mark) map collection",xoe_cpnws0199minckler.xml,80444/xv20196,1,2,2,5
"Parent-Teacher Association records for Eureka, Franklin, Roosevelt and Sehome schools",xoe_cpnws0094bhamparentteacherassociation.xml,80444/xv52999,1,1,3,5
"Tikka (Rubin) film footage of Commercial Fishing in Clam Gulch, Alaska",xoe_cpnws0303rubintikka.xml,80444/xv85772,4,0,1,5
"Scott (James W.) collection of Washington: A Centennial Atlas material",xoe_cpnws0228scottcentatlas.xml,80444/xv70128,4,0,1,5
"Hitchman (James) collection",xoe_cpnws0165hitchman.xml,80444/xv13116,3,1,1,5
"Delmont Land Company minute book",xoe_cpnws0125delmontlandminutebook.xml,80444/xv50097,2,0,2,4
"Murray (Keith A.) papers",xoe_cpnws0206murray.xml,80444/xv82782,2,1,1,4
"Western Gallery collection of Washington State images",xoe_cpnws0260westerngallery.xml,80444/xv53370,0,2,2,4
"Institute for Freshwater Studies records",xoe_cpnws0168institutefreshwater.xml,80444/xv97393,0,0,4,4
"Nelson (Oliver) negatives",xoe_cpnws0316nelsonoliver.xml,80444/xv22488,0,1,3,4
"Ferndale Oil Industry research records",xoe_cpnws0150ferndaleoil.xml,80444/xv95117,0,1,3,4
"Bellingham Federal Building photographs",xoe_cpnws0149fedbuilding.xml,80444/xv86999,0,1,3,4
"Mischaikow (Michael K.) papers",xoe_cpnws0203mischaikow.xml,80444/xv51660,0,0,4,4
"Crape (Ila Flowers) photographs and manuscripts",xoe_cpnws0121ilaflowerscrape.xml,80444/xv54663,0,1,3,4
"Whatcom County Weather Observational Data reports",xoe_cpnws0256weatherdata.xml,80444/xv22247,1,1,2,4
"Seeger (M.W.) papers",xoe_cpnws0230seeger.xml,80444/xv67242,0,0,4,4
"Hutchinson (Jack) Papers",xoe_sc0008hutchinsonj.xml,80444/xv56060,0,3,1,4
"Turbeville (Daniel E.) photographs",xoe_cpnws0247turbeville.xml,80444/xv94413,0,0,4,4
"Northwest Hardware Company records",xoe_cpnws0212nwhardware.xml,80444/xv12330,0,1,3,4
"Mangan and Woodcock family papers",xoe_cpnws0297manganwoodcock.xml,80444/xv94580,0,2,2,4
"Puget Sound Mail newspaper photographs",xoe_cpnws0220psmail.xml,80444/xv07542,0,0,3,3
"Mothers of World War Veterans records",xoe_cpnws0287mothersclub.xml,80444/xv58053,0,2,1,3
"Washington State Federation of Democratic Women",xoe_cpnws0300wfdw.xml,80444/xv57788,2,0,1,3
"Fish Industry publications",xoe_cpnws0151fishindustry.xml,80444/xv13323,0,0,3,3
"Jeffcott (Percival R.) and Dorothy Koert scrapbooks",xoe_cpnws0170jeffcottkoertscrapbooks.xml,80444/xv69506,0,2,1,3
"Whatcom Land Trust records",xoe_cpnws0274wltr.xml,80444/xv38946,0,0,3,3
"Hottell (Diana) articles on Methow Valley pioneers",xoe_cpnws0323hottell.xml,80444/xv40295,2,0,1,3
"Democratic Party, Whatcom County Chapter campaign records",xoe_cpnws0126democraticcampaignrecords.xml,80444/xv46600,0,0,3,3
"Macy (James W.) photographs",xoe_cpnws0226macy.xml,80444/xv04463,2,0,1,3
"Center for Pacific Northwest Studies Miscellaneous Photograph Collection",xoe_cpnws0185miscphoto.xml,80444/xv71893,0,0,3,3
"Dotson (Charles) thesis collection",xoe_cpnws0128charlesdotsonthesiscollection.xml,80444/xv17498,0,1,2,3
"National Science Foundation Two Hundred-Mile Boundary Limit conference materials",xoe_cpnws0207natscifound.xml,80444/xv23828,0,1,2,3
"Washington Science Teachers Association Records",xoe_cpnws0034wsta.xml,80444/xv73879,1,0,2,3
"Wetherell family papers",xoe_cpnws0267wetherell.xml,80444/xv83124,2,0,1,3
"Wolcott (Ernest E.) research collection on Washington lakes",xoe_cpnws0280wolcott.xml,80444/xv40715,0,0,3,3
"Sandison (Wilbur J.) photographs",xoe_cpnws0227sandison.xml,80444/xv37299,1,0,2,3
"Twentieth Century Club records",xoe_cpnws0249twentycent.xml,80444/xv35928,0,0,3,3
"Vernon (Manfred C.): International Joint Commission on Point Roberts collection",xoe_cpnws0187vernonijcpr.xml,80444/xv74240,0,0,2,2
"Dassow (John) book collection",xoe_cpnws0124johndassowbookcollection.xml,80444/xv02578,0,0,2,2
"Briggs (C.) photographs",xoe_cpnws0313briggs.xml,80444/xv84909,0,0,2,2
"Nooksack River Bridge photographs",xoe_cpnws0210nooksackbridge.xml,80444/xv46872,0,0,2,2
"Friends of Skagit County records",xoe_cpnws0328fosc.xml,80444/xv32864,0,0,2,2
"Western Washington State College Symposium on Canadian-American Relations records",xoe_cpnws0262wwucanada.xml,80444/xv55929,0,0,2,2
"Center for Pacific Northwest Studies Miscellaneous Map collection",xoe_cpnws0202miscmaps.xml,80444/xv18831,0,0,2,2
"Soine Shoe Store records",xoe_cpnws0320soine.xml,80444/xv39837,0,0,2,2
"Whatcom County Cooperative Hatcheries records",xoe_cpnws0270wcch.xml,80444/xv45503,0,0,2,2
"McIntyre (Larry) collection on Whatcom County politics",xoe_cpnws0198mcintyre.xml,80444/xv54738,1,0,1,2
"Burk (Mary K.) Papers",xoe_sc0004burkmk.xml,80444/xv76101,0,2,0,2
"People for Puget Sound records",xoe_cpnws0337pfps.xml,80444/xv88989,0,0,2,2
"Skinner (Knute) papers",xoe_cpnws0056skinner.xml,80444/xv98847,0,0,1,1
"Whatcom County title abstracts",xoe_cpnws0273wcta.xml,80444/xv76058,0,0,1,1
"Seattle Water Department photographs",xoe_cpnws0116seattlewaterdepartmentphotographs.xml,80444/xv39178,0,0,1,1
"Conyers (Harvey)",xoe_cpnws0120harveyconyersscrapbooks.xml,80444/xv62075,0,0,1,1
"Citizen's Dock photographs",xoe_cpnws0115citizensdockphotographs.xml,80444/xv73150,0,0,1,1
"SAFE Bellingham newspaper clippings",xoe_cpnws0225safebh.xml,80444/xv71841,0,0,1,1
"Smith (Curtis F.) Papers",xoe_cpnws0331smithc.xml,80444/xv43502,0,0,1,1
"Miscellaneous government certificates collection",xoe_cpnws0201miscgovcert.xml,80444/xv86201,0,0,1,1
"Kiphart (Clarence) papers",xoe_cpnws0174kiphartc.xml,80444/xv02011,0,0,1,1
"Fairhaven City Water and Power Company ledger book",xoe_cpnws0143fairhavenwater.xml,80444/xv92892,0,0,1,1
"Terrace (Frank) Memoir and Related Materials",xoe_cpnws0338.xml,80444/xv30764,0,0,1,1
"Scudder (O.C.) photographs",xoe_cpnws0229scudder.xml,80444/xv15722,0,0,1,1
"Western Washington University special events photographs",xoe_cpnws0265wwueventsphotos.xml,80444/xv06390,0,0,1,1
"City Center Development Authority records",xoe_cpnws0314citycenterdevauth.xml,80444/xv34100,0,0,1,1
"Collection of Washington State laws",xoe_cpnws0325walaws.xml,80444/xv09841,0,0,1,1
"Miscellaneous book collection",xoe_cpnws0200miscbooks.xml,80444/xv26040,0,0,1,1
"Cascade Wilderness Club scrapbook",xoe_cpnws0107cascadewildernessclub.xml,80444/xv11956,0,0,1,1
"Wetherell (June) research collection on the Pacific Northwest",xoe_cpnws0268wetherelljune.xml,80444/xv15753,0,0,1,1
"Morgan (Emrys B.) financial ledgers",xoe_cpnws0204emrysmorgan.xml,80444/xv22183,0,0,1,1
"Association of Washington Geographers records",xoe_cpnws0083awg.xml,80444/xv54629,0,0,1,1
"Senour (Grant) Photographs",xoe_cpnws0317senour.xml,80444/xv45602,0,0,1,1
"United States Power Squadrons District 16 records",xoe_cpnws0250uspowersquadron.xml,80444/xv86627,0,0,1,1
"Kibbe (L.A.) papers",xoe_cpnws0173kibbela.xml,80444/xv36965,0,0,1,1
"Henley (Elizabeth A.) papers",xoe_cpnws0164henley.xml,80444/xv53009,0,0,1,1
"Johnson (Dorothy H.) papers",xoe_cpnws0171johnsond.xml,80444/xv18026,0,0,1,1
"Unknown",xoe_cpnws0224roe.xml,80444/xv38664,0,0,0,0
,,Totals,2394,2990,3416,8800
